,year,month,institution_name,population_felons,civil_addict,total_population,designed_capacity,percent_occupied,staffed_capacity
0,1996,1,VSP (VALLEY SP),2294,0,2294,1980,115.9,1980
1,1996,1,SCC (SIERRA CONSERVATION CENTER),322,0,322,320,100.6,320
2,1996,1,NCWF (NO CAL WOMEN'S FACIL),786,4,790,400,197.5,760
3,1996,1,CCWF (CENTRAL CA WOMEN'S FAC),2846,13,2859,2004,142.7,3224
4,1996,1,"CRC (CAL REHAB CTR, WOMEN)",91,703,794,500,158.8,842
5,1996,1,CIW (CA INSTITUTION FOR WOMEN),1690,36,1726,1026,168.2,1646
6,1996,1,WSP (WASCO SP),4475,62,4537,2484,182.6,4484
7,1996,1,SCC (SIERRA CONSERVATION CENTER),6010,0,6010,3606,166.7,5884
8,1996,1,SRTA (SANTA RITA CO. JAIL-RC),811,0,811,395,205.3,750
9,1996,1,RJD (RJ DONOVAN CORRECTIONAL FAC),4577,0,4577,2200,208.0,4566
10,1996,1,PVSP (PLEASANT VALLEY SP),4080,0,4080,2208,184.8,4008
11,1996,1,PBSP (PELICAN BAY SP),3509,1,3510,2280,153.9,3730
12,1996,1,NKSP (NORTH KERN SP),4525,1,4526,2492,181.6,4472
13,1996,1,MCSP (MULE CREEK SP),3530,0,3530,1700,207.6,3562
14,1996,1,ISP (IRONWOOD SP),3874,0,3874,2200,176.1,4000
15,1996,1,HDSP (HIGH DESERT SP),2364,0,2364,1712,138.1,2224
16,1996,1,FOL (FOLSOM SP) (MALE),3757,0,3757,2064,182.0,3710
17,1996,1,DVI (DEUEL VOCATIONAL INSTITUTION),3480,51,3531,1787,197.6,3396
18,1996,1,CTF (CORRECTIONAL TRAINING FAC),6359,3,6362,2981,213.4,6341
19,1996,1,CVSP (CHUCKAWALLA VALLEY SP),3514,0,3514,1738,202.2,3579
20,1996,1,"SOL (CA SP, SOLANO)",4720,0,4720,2110,223.7,4777
21,1996,1,SQ (SAN QUENTIN SP),5604,63,5667,3136,180.7,5412
22,1996,1,"SAC (CA SP, SACRAMENTO)",3147,0,3147,1728,182.1,3204
23,1996,1,"LAC (CA SP, LOS ANGELES COUNTY)",3978,0,3978,2200,180.8,4000
24,1996,1,"COR (CA SP, CORCORAN)",4997,0,4997,2916,171.4,4978
25,1996,1,CEN (CENTINELA SP),4033,0,4033,2208,182.7,4248
26,1996,1,CAL (CALIPATRIA SP),3941,0,3941,2208,178.5,4008
27,1996,1,"CRC (CAL REHAB CTR, MEN)",1776,2201,3977,1814,219.2,3906
28,1996,1,CMC (CA MEN'S COLONY),6454,1,6455,3884,166.2,6474
29,1996,1,CMF (CA MEDICAL FAC),3081,0,3081,2335,131.9,3339
30,1996,1,CIM (CA INSTITUTION FOR MEN),5800,48,5848,2778,210.5,5971
31,1996,1,CCI (CA CORRECTIONAL INSTITUTION),5718,1,5719,2757,207.4,5728
32,1996,1,CCC (CA CORRECTIONAL CENTER),5865,1,5866,3682,159.3,5637
33,1996,1,ASP (AVENAL SP),5704,0,5704,2320,245.9,5793
34,1996,2,VSP (VALLEY SP),2096,0,2096,1980,105.9,2184
35,1996,2,SCC (SIERRA CONSERVATION CENTER),310,0,310,320,96.9,320
36,1996,2,NCWF (NO CAL WOMEN'S FACIL),787,1,788,400,197.0,760
37,1996,2,CCWF (CENTRAL CA WOMEN'S FAC),3171,20,3191,2004,159.2,2999
38,1996,2,"CRC (CAL REHAB CTR, WOMEN)",100,702,802,500,160.4,842
39,1996,2,CIW (CA INSTITUTION FOR WOMEN),1726,34,1760,1026,171.5,1646
40,1996,2,WSP (WASCO SP),4343,29,4372,2484,176.0,4484
41,1996,2,SCC (SIERRA CONSERVATION CENTER),5912,0,5912,3606,163.9,5884
42,1996,2,SRTA (SANTA RITA CO. JAIL-RC),768,0,768,395,194.4,750
43,1996,2,RJD (RJ DONOVAN CORRECTIONAL FAC),4595,0,4595,2200,208.9,4566
44,1996,2,PVSP (PLEASANT VALLEY SP),4363,0,4363,2208,197.6,4008
45,1996,2,PBSP (PELICAN BAY SP),3418,0,3418,2280,149.9,3615
46,1996,2,NKSP (NORTH KERN SP),4370,3,4373,2492,175.5,4472
47,1996,2,MCSP (MULE CREEK SP),3690,0,3690,1700,217.1,3562
48,1996,2,ISP (IRONWOOD SP),3921,0,3921,2200,178.2,4000
49,1996,2,HDSP (HIGH DESERT SP),2885,1,2886,1712,168.6,2224
50,1996,2,FOL (FOLSOM SP) (MALE),3779,1,3780,2064,183.1,3710
51,1996,2,DVI (DEUEL VOCATIONAL INSTITUTION),3351,29,3380,1787,189.1,3396
52,1996,2,CTF (CORRECTIONAL TRAINING FAC),6456,0,6456,2981,216.6,6341
53,1996,2,CVSP (CHUCKAWALLA VALLEY SP),3488,0,3488,1738,200.7,3579
54,1996,2,"SOL (CA SP, SOLANO)",4804,0,4804,2110,227.7,4777
55,1996,2,SQ (SAN QUENTIN SP),5911,58,5969,3127,190.9,5565
56,1996,2,"SAC (CA SP, SACRAMENTO)",3214,0,3214,1728,186.0,3204
57,1996,2,"LAC (CA SP, LOS ANGELES COUNTY)",3919,0,3919,2200,178.1,4000
58,1996,2,"COR (CA SP, CORCORAN)",4919,1,4920,2916,168.7,4978
59,1996,2,CEN (CENTINELA SP),4170,0,4170,2208,188.9,4248
60,1996,2,CAL (CALIPATRIA SP),3778,0,3778,2208,171.1,4008
61,1996,2,"CRC (CAL REHAB CTR, MEN)",1684,2164,3848,1814,212.1,3906
62,1996,2,CMC (CA MEN'S COLONY),6348,1,6349,3884,163.5,6474
63,1996,2,CMF (CA MEDICAL FAC),3004,0,3004,2335,128.7,3339
64,1996,2,CIM (CA INSTITUTION FOR MEN),5908,52,5960,2778,214.5,5971
65,1996,2,CCI (CA CORRECTIONAL INSTITUTION),5680,2,5682,2757,206.1,5767
66,1996,2,CCC (CA CORRECTIONAL CENTER),5839,1,5840,3682,158.6,5637
67,1996,2,ASP (AVENAL SP),5778,0,5778,2320,249.1,5793
68,1996,3,VSP (VALLEY SP),2326,7,2333,2380,98.0,2584
69,1996,3,SCC (SIERRA CONSERVATION CENTER),327,0,327,320,102.2,320
70,1996,3,NCWF (NO CAL WOMEN'S FACIL),770,1,771,400,192.8,760
71,1996,3,CCWF (CENTRAL CA WOMEN'S FAC),3036,7,3043,2004,151.8,2999
72,1996,3,"CRC (CAL REHAB CTR, WOMEN)",85,676,761,500,152.2,842
73,1996,3,CIW (CA INSTITUTION FOR WOMEN),1735,41,1776,1026,173.1,1646
74,1996,3,WSP (WASCO SP),4429,38,4467,2484,179.8,4484
75,1996,3,SCC (SIERRA CONSERVATION CENTER),5912,0,5912,3606,163.9,5884
76,1996,3,SRTA (SANTA RITA CO. JAIL-RC),685,0,685,395,173.4,750
77,1996,3,RJD (RJ DONOVAN CORRECTIONAL FAC),4575,1,4576,2200,208.0,4566
78,1996,3,PVSP (PLEASANT VALLEY SP),4315,0,4315,2208,195.4,4008
79,1996,3,PBSP (PELICAN BAY SP),3492,0,3492,2280,153.2,3615
80,1996,3,NKSP (NORTH KERN SP),4457,1,4458,2492,178.9,4472
81,1996,3,MCSP (MULE CREEK SP),3634,0,3634,1700,213.8,3562
82,1996,3,ISP (IRONWOOD SP),4058,0,4058,2200,184.5,4000
83,1996,3,HDSP (HIGH DESERT SP),3101,1,3102,1712,181.2,2224
84,1996,3,FOL (FOLSOM SP) (MALE),3837,1,3838,2064,185.9,3710
85,1996,3,DVI (DEUEL VOCATIONAL INSTITUTION),3306,18,3324,1787,186.0,3396
86,1996,3,CTF (CORRECTIONAL TRAINING FAC),6483,0,6483,2981,217.5,6341
87,1996,3,CVSP (CHUCKAWALLA VALLEY SP),3522,0,3522,1738,202.6,3579
88,1996,3,"SOL (CA SP, SOLANO)",4799,0,4799,2110,227.4,4777
89,1996,3,SQ (SAN QUENTIN SP),5845,37,5882,3127,188.1,5565
90,1996,3,"SAC (CA SP, SACRAMENTO)",3136,0,3136,1728,181.5,3204
91,1996,3,"LAC (CA SP, LOS ANGELES COUNTY)",3975,0,3975,2200,180.7,4000
92,1996,3,"COR (CA SP, CORCORAN)",4918,0,4918,2916,168.7,4978
93,1996,3,CEN (CENTINELA SP),4317,0,4317,2208,195.5,4248
94,1996,3,CAL (CALIPATRIA SP),3870,0,3870,2208,175.3,4008
95,1996,3,"CRC (CAL REHAB CTR, MEN)",1809,2193,4002,1814,220.6,3906
96,1996,3,CMC (CA MEN'S COLONY),6463,0,6463,3884,166.4,6474
97,1996,3,CMF (CA MEDICAL FAC),3092,0,3092,2335,132.4,3339
98,1996,3,CIM (CA INSTITUTION FOR MEN),5757,40,5797,2778,208.7,5971
99,1996,3,CCI (CA CORRECTIONAL INSTITUTION),5729,2,5731,2757,207.9,5767
100,1996,3,CCC (CA CORRECTIONAL CENTER),5871,1,5872,3682,159.5,5637
101,1996,3,ASP (AVENAL SP),5727,0,5727,2320,246.9,5793
102,1996,4,VSP (VALLEY SP),2498,13,2511,2380,105.5,2584
103,1996,4,SCC (SIERRA CONSERVATION CENTER),312,0,312,320,97.5,320
104,1996,4,NCWF (NO CAL WOMEN'S FACIL),742,2,744,400,186.0,760
105,1996,4,CCWF (CENTRAL CA WOMEN'S FAC),3184,8,3192,2004,159.3,2999
106,1996,4,"CRC (CAL REHAB CTR, WOMEN)",87,682,769,500,153.8,842
107,1996,4,CIW (CA INSTITUTION FOR WOMEN),1618,36,1654,1026,161.2,1646
108,1996,4,WSP (WASCO SP),4424,40,4464,2484,179.7,4484
109,1996,4,SCC (SIERRA CONSERVATION CENTER),5979,0,5979,3606,165.8,5884
110,1996,4,SRTA (SANTA RITA CO. JAIL-RC),776,1,777,395,196.7,750
111,1996,4,RJD (RJ DONOVAN CORRECTIONAL FAC),4630,0,4630,2200,210.5,4566
112,1996,4,PVSP (PLEASANT VALLEY SP),4592,0,4592,2208,208.0,4008
113,1996,4,PBSP (PELICAN BAY SP),3551,0,3551,2280,155.7,3615
114,1996,4,NKSP (NORTH KERN SP),4350,2,4352,2492,174.6,4472
115,1996,4,MCSP (MULE CREEK SP),3457,0,3457,1700,203.4,3562
116,1996,4,ISP (IRONWOOD SP),4390,0,4390,2200,199.5,4000
117,1996,4,HDSP (HIGH DESERT SP),3557,2,3559,1812,196.4,2414
118,1996,4,FOL (FOLSOM SP) (MALE),3748,1,3749,2064,181.6,3710
119,1996,4,DVI (DEUEL VOCATIONAL INSTITUTION),3432,27,3459,1787,193.6,3396
120,1996,4,CTF (CORRECTIONAL TRAINING FAC),6593,0,6593,2981,221.2,6341
121,1996,4,CVSP (CHUCKAWALLA VALLEY SP),3505,0,3505,1738,201.7,3579
122,1996,4,"SOL (CA SP, SOLANO)",4747,0,4747,2110,225.0,4777
123,1996,4,SQ (SAN QUENTIN SP),5579,33,5612,3127,179.5,5565
124,1996,4,"SAC (CA SP, SACRAMENTO)",3145,0,3145,1728,182.0,3204
125,1996,4,"LAC (CA SP, LOS ANGELES COUNTY)",4064,0,4064,2200,184.7,4000
126,1996,4,"COR (CA SP, CORCORAN)",4991,0,4991,2916,171.2,4978
127,1996,4,CEN (CENTINELA SP),4195,0,4195,2208,190.0,4248
128,1996,4,CAL (CALIPATRIA SP),3860,0,3860,2208,174.8,4008
129,1996,4,"CRC (CAL REHAB CTR, MEN)",1834,2118,3952,1814,217.9,3906
130,1996,4,CMC (CA MEN'S COLONY),6437,0,6437,3884,165.7,6474
131,1996,4,CMF (CA MEDICAL FAC),3114,0,3114,2335,133.4,3339
132,1996,4,CIM (CA INSTITUTION FOR MEN),5664,69,5733,2778,206.4,5971
133,1996,4,CCI (CA CORRECTIONAL INSTITUTION),5869,1,5870,2757,212.9,5767
134,1996,4,CCC (CA CORRECTIONAL CENTER),5902,1,5903,3682,160.3,5637
135,1996,4,ASP (AVENAL SP),5758,0,5758,2320,248.2,5793
136,1996,5,VSP (VALLEY SP),2562,9,2571,2380,108.0,2584
137,1996,5,SCC (SIERRA CONSERVATION CENTER),320,0,320,320,100.0,320
138,1996,5,NCWF (NO CAL WOMEN'S FACIL),705,0,705,400,176.3,760
139,1996,5,CCWF (CENTRAL CA WOMEN'S FAC),3176,5,3181,2004,158.7,2999
140,1996,5,"CRC (CAL REHAB CTR, WOMEN)",124,698,822,500,164.4,842
141,1996,5,CIW (CA INSTITUTION FOR WOMEN),1689,26,1715,1026,167.2,1646
142,1996,5,WSP (WASCO SP),4523,21,4544,2484,182.9,4484
143,1996,5,SCC (SIERRA CONSERVATION CENTER),5884,0,5884,3606,163.2,5884
144,1996,5,SRTA (SANTA RITA CO. JAIL-RC),880,0,880,395,222.8,750
145,1996,5,SVSP (SALINAS VALLEY SP),736,0,736,700,105.1,700
146,1996,5,RJD (RJ DONOVAN CORRECTIONAL FAC),4581,0,4581,2200,208.2,4566
147,1996,5,PVSP (PLEASANT VALLEY SP),4546,0,4546,2208,205.9,4008
148,1996,5,PBSP (PELICAN BAY SP),3548,0,3548,2280,155.6,3615
149,1996,5,NKSP (NORTH KERN SP),4474,1,4475,2492,179.6,4472
150,1996,5,MCSP (MULE CREEK SP),3504,0,3504,1700,206.1,3562
151,1996,5,ISP (IRONWOOD SP),4217,0,4217,2200,191.7,4000
152,1996,5,HDSP (HIGH DESERT SP),4011,1,4012,1812,221.4,2414
153,1996,5,FOL (FOLSOM SP) (MALE),3775,1,3776,2064,182.9,3710
154,1996,5,DVI (DEUEL VOCATIONAL INSTITUTION),3585,29,3614,1787,202.2,3396
155,1996,5,CTF (CORRECTIONAL TRAINING FAC),6662,2,6664,2981,223.5,6341
156,1996,5,CVSP (CHUCKAWALLA VALLEY SP),3506,0,3506,1738,201.7,3579
157,1996,5,"SOL (CA SP, SOLANO)",4770,0,4770,2110,226.1,4777
158,1996,5,SQ (SAN QUENTIN SP),5491,33,5524,3127,176.7,5565
159,1996,5,"SAC (CA SP, SACRAMENTO)",3128,0,3128,1728,181.0,3204
160,1996,5,"LAC (CA SP, LOS ANGELES COUNTY)",4012,0,4012,2200,182.4,4000
161,1996,5,"COR (CA SP, CORCORAN)",4847,0,4847,2916,166.2,4978
162,1996,5,CEN (CENTINELA SP),4372,0,4372,2208,198.0,4248
163,1996,5,CAL (CALIPATRIA SP),3885,0,3885,2208,176.0,4008
164,1996,5,"CRC (CAL REHAB CTR, MEN)",1740,2032,3772,1814,207.9,3906
165,1996,5,CMC (CA MEN'S COLONY),6385,0,6385,3884,164.4,6474
166,1996,5,CMF (CA MEDICAL FAC),3148,0,3148,2335,134.8,3339
167,1996,5,CIM (CA INSTITUTION FOR MEN),6063,78,6141,2778,221.1,5971
168,1996,5,CCI (CA CORRECTIONAL INSTITUTION),5837,0,5837,2757,211.7,5767
169,1996,5,CCC (CA CORRECTIONAL CENTER),5785,1,5786,3682,157.1,5637
170,1996,5,ASP (AVENAL SP),5734,0,5734,2320,247.2,5793
171,1996,6,VSP (VALLEY SP),2549,12,2561,1980,129.3,2592
172,1996,6,SCC (SIERRA CONSERVATION CENTER),331,0,331,320,103.4,320
173,1996,6,NCWF (NO CAL WOMEN'S FACIL),752,5,757,400,189.3,760
174,1996,6,CCWF (CENTRAL CA WOMEN'S FAC),3100,6,3106,2004,155.0,2914
175,1996,6,"CRC (CAL REHAB CTR, WOMEN)",195,687,882,500,176.4,842
176,1996,6,CIW (CA INSTITUTION FOR WOMEN),1634,26,1660,1026,161.8,1646
177,1996,6,WSP (WASCO SP),4479,44,4523,2484,182.1,4484
178,1996,6,SCC (SIERRA CONSERVATION CENTER),5993,0,5993,3606,166.2,5884
179,1996,6,SVSP (SALINAS VALLEY SP),1260,0,1260,700,180.0,700
180,1996,6,RJD (RJ DONOVAN CORRECTIONAL FAC),4574,0,4574,2200,207.9,4566
181,1996,6,PVSP (PLEASANT VALLEY SP),4414,0,4414,2208,199.9,4488
182,1996,6,PBSP (PELICAN BAY SP),3514,0,3514,2280,154.1,3711
183,1996,6,NKSP (NORTH KERN SP),4516,1,4517,2492,181.3,4472
184,1996,6,MCSP (MULE CREEK SP),3631,0,3631,1700,213.6,3562
185,1996,6,ISP (IRONWOOD SP),4240,0,4240,2200,192.7,4360
186,1996,6,HDSP (HIGH DESERT SP),4103,1,4104,2224,184.5,4046
187,1996,6,FOL (FOLSOM SP) (MALE),3834,1,3835,2064,185.8,3710
188,1996,6,DVI (DEUEL VOCATIONAL INSTITUTION),3344,38,3382,1787,189.3,3706
189,1996,6,CTF (CORRECTIONAL TRAINING FAC),6482,1,6483,2981,217.5,6461
190,1996,6,CVSP (CHUCKAWALLA VALLEY SP),3519,0,3519,1738,202.5,3579
191,1996,6,"SOL (CA SP, SOLANO)",4646,0,4646,2110,220.2,4777
192,1996,6,SQ (SAN QUENTIN SP),5490,39,5529,3283,168.4,5721
193,1996,6,"SAC (CA SP, SACRAMENTO)",3131,0,3131,1728,181.2,3204
194,1996,6,"LAC (CA SP, LOS ANGELES COUNTY)",4162,0,4162,2200,189.2,4120
195,1996,6,"COR (CA SP, CORCORAN)",4642,0,4642,2916,159.2,5084
196,1996,6,CEN (CENTINELA SP),4387,0,4387,2208,198.7,4368
197,1996,6,CAL (CALIPATRIA SP),3835,0,3835,2208,173.7,4108
198,1996,6,"CRC (CAL REHAB CTR, MEN)",2062,1899,3961,1814,218.4,3906
199,1996,6,CMC (CA MEN'S COLONY),6301,0,6301,3884,162.2,6474
200,1996,6,CMF (CA MEDICAL FAC),3175,0,3175,2315,137.1,3377
201,1996,6,CIM (CA INSTITUTION FOR MEN),5831,44,5875,2778,211.5,5971
202,1996,6,CCI (CA CORRECTIONAL INSTITUTION),5918,0,5918,2781,212.8,5942
203,1996,6,CCC (CA CORRECTIONAL CENTER),5919,1,5920,3682,160.8,5637
204,1996,6,ASP (AVENAL SP),5736,0,5736,2320,247.2,5793
205,1996,7,VSP (VALLEY SP),2789,31,2820,1980,142.4,2592
206,1996,7,SCC (SIERRA CONSERVATION CENTER),329,0,329,320,102.8,320
207,1996,7,NCWF (NO CAL WOMEN'S FACIL),775,5,780,400,195.0,760
208,1996,7,CCWF (CENTRAL CA WOMEN'S FAC),2897,13,2910,2004,145.2,2914
209,1996,7,"CRC (CAL REHAB CTR, WOMEN)",211,651,862,500,172.4,842
210,1996,7,CIW (CA INSTITUTION FOR WOMEN),1709,23,1732,1026,168.8,1646
211,1996,7,WSP (WASCO SP),4470,28,4498,2484,181.1,4484
212,1996,7,SCC (SIERRA CONSERVATION CENTER),5907,0,5907,3606,163.8,5884
213,1996,7,SVSP (SALINAS VALLEY SP),1780,0,1780,700,254.3,700
214,1996,7,RJD (RJ DONOVAN CORRECTIONAL FAC),4526,0,4526,2200,205.7,4566
215,1996,7,PVSP (PLEASANT VALLEY SP),4515,0,4515,2208,204.5,4488
216,1996,7,PBSP (PELICAN BAY SP),3463,0,3463,2280,151.9,3711
217,1996,7,NKSP (NORTH KERN SP),4529,1,4530,2492,181.8,4472
218,1996,7,MCSP (MULE CREEK SP),3618,0,3618,1700,212.8,3562
219,1996,7,ISP (IRONWOOD SP),4315,0,4315,2200,196.1,4360
220,1996,7,HDSP (HIGH DESERT SP),4041,2,4043,2224,181.8,4046
221,1996,7,FOL (FOLSOM SP) (MALE),3842,1,3843,2064,186.2,3710
222,1996,7,DVI (DEUEL VOCATIONAL INSTITUTION),3499,30,3529,1787,197.5,3706
223,1996,7,CTF (CORRECTIONAL TRAINING FAC),6302,2,6304,2981,211.5,6461
224,1996,7,CVSP (CHUCKAWALLA VALLEY SP),3472,0,3472,1738,199.8,3579
225,1996,7,"SOL (CA SP, SOLANO)",4757,0,4757,2110,225.5,4777
226,1996,7,SQ (SAN QUENTIN SP),5703,28,5731,3283,174.6,5721
227,1996,7,"SAC (CA SP, SACRAMENTO)",3225,2,3227,1728,186.7,3204
228,1996,7,"LAC (CA SP, LOS ANGELES COUNTY)",4134,0,4134,2200,187.9,4120
229,1996,7,"COR (CA SP, CORCORAN)",4672,0,4672,2916,160.2,5084
230,1996,7,CEN (CENTINELA SP),4497,0,4497,2208,203.7,4368
231,1996,7,CAL (CALIPATRIA SP),3773,0,3773,2208,170.9,4108
232,1996,7,"CRC (CAL REHAB CTR, MEN)",2171,1797,3968,1814,218.7,3906
233,1996,7,CMC (CA MEN'S COLONY),6254,0,6254,3884,161.0,6474
234,1996,7,CMF (CA MEDICAL FAC),3158,0,3158,2315,136.4,3377
235,1996,7,CIM (CA INSTITUTION FOR MEN),5875,47,5922,2778,213.2,5971
236,1996,7,CCI (CA CORRECTIONAL INSTITUTION),5959,0,5959,2781,214.3,5942
237,1996,7,CCC (CA CORRECTIONAL CENTER),5952,1,5953,3682,161.7,5637
238,1996,7,ASP (AVENAL SP),5733,0,5733,2320,247.1,5793
239,1996,8,VSP (VALLEY SP),2750,8,2758,1980,139.3,2592
240,1996,8,SCC (SIERRA CONSERVATION CENTER),334,0,334,320,104.4,320
241,1996,8,NCWF (NO CAL WOMEN'S FACIL),747,9,756,400,189.0,760
242,1996,8,CCWF (CENTRAL CA WOMEN'S FAC),3113,5,3118,2004,155.6,2914
243,1996,8,"CRC (CAL REHAB CTR, WOMEN)",224,670,894,500,178.8,842
244,1996,8,CIW (CA INSTITUTION FOR WOMEN),1636,23,1659,1026,161.7,1646
245,1996,8,WSP (WASCO SP),4857,50,4907,2484,197.5,4484
246,1996,8,SCC (SIERRA CONSERVATION CENTER),5883,0,5883,3606,163.1,5884
247,1996,8,SVSP (SALINAS VALLEY SP),2221,0,2221,700,317.3,700
248,1996,8,RJD (RJ DONOVAN CORRECTIONAL FAC),4619,0,4619,2200,210.0,4566
249,1996,8,PVSP (PLEASANT VALLEY SP),4506,0,4506,2208,204.1,4488
250,1996,8,PBSP (PELICAN BAY SP),3497,0,3497,2280,153.4,3711
251,1996,8,NKSP (NORTH KERN SP),4581,1,4582,2492,183.9,4472
252,1996,8,MCSP (MULE CREEK SP),3595,0,3595,1700,211.5,3562
253,1996,8,ISP (IRONWOOD SP),4251,0,4251,2200,193.2,4360
254,1996,8,HDSP (HIGH DESERT SP),4067,2,4069,2224,183.0,4046
255,1996,8,FOL (FOLSOM SP) (MALE),3883,0,3883,2064,188.1,3710
256,1996,8,DVI (DEUEL VOCATIONAL INSTITUTION),3525,28,3553,1787,198.8,3706
257,1996,8,CTF (CORRECTIONAL TRAINING FAC),5949,2,5951,2981,199.6,6461
258,1996,8,CVSP (CHUCKAWALLA VALLEY SP),3672,0,3672,1738,211.3,3579
259,1996,8,"SOL (CA SP, SOLANO)",4831,0,4831,2110,229.0,4777
260,1996,8,SQ (SAN QUENTIN SP),5675,47,5722,3283,174.3,5721
261,1996,8,"SAC (CA SP, SACRAMENTO)",3191,0,3191,1728,184.7,3204
262,1996,8,"LAC (CA SP, LOS ANGELES COUNTY)",4145,0,4145,2200,188.4,4120
263,1996,8,"COR (CA SP, CORCORAN)",4763,0,4763,2916,163.3,5084
264,1996,8,CEN (CENTINELA SP),4381,0,4381,2208,198.4,4368
265,1996,8,CAL (CALIPATRIA SP),4129,0,4129,2208,187.0,4108
266,1996,8,"CRC (CAL REHAB CTR, MEN)",2263,1743,4006,1814,220.8,3906
267,1996,8,CMC (CA MEN'S COLONY),6364,0,6364,3884,163.9,6474
268,1996,8,CMF (CA MEDICAL FAC),3181,1,3182,2315,137.5,3377
269,1996,8,CIM (CA INSTITUTION FOR MEN),5859,35,5894,2778,212.2,5971
270,1996,8,CCI (CA CORRECTIONAL INSTITUTION),5906,0,5906,2781,212.4,5942
271,1996,8,CCC (CA CORRECTIONAL CENTER),5840,0,5840,3682,158.6,5637
272,1996,8,ASP (AVENAL SP),5760,0,5760,2320,248.3,5793
273,1996,9,VSP (VALLEY SP),2693,17,2710,1980,136.9,2592
274,1996,9,SCC (SIERRA CONSERVATION CENTER),328,0,328,320,102.5,320
275,1996,9,NCWF (NO CAL WOMEN'S FACIL),751,3,754,400,188.5,760
276,1996,9,CCWF (CENTRAL CA WOMEN'S FAC),3212,12,3224,2004,160.9,2914
277,1996,9,"CRC (CAL REHAB CTR, WOMEN)",202,650,852,500,170.4,842
278,1996,9,CIW (CA INSTITUTION FOR WOMEN),1621,27,1648,1026,160.6,1646
279,1996,9,WSP (WASCO SP),5012,33,5045,2484,203.1,4484
280,1996,9,SCC (SIERRA CONSERVATION CENTER),5933,0,5933,3606,164.5,5884
281,1996,9,SVSP (SALINAS VALLEY SP),2753,0,2753,700,393.3,700
282,1996,9,RJD (RJ DONOVAN CORRECTIONAL FAC),4571,0,4571,2200,207.8,4566
283,1996,9,PVSP (PLEASANT VALLEY SP),4428,0,4428,2208,200.5,4488
284,1996,9,PBSP (PELICAN BAY SP),3592,0,3592,2280,157.5,3711
285,1996,9,NKSP (NORTH KERN SP),4505,1,4506,2492,180.8,4472
286,1996,9,MCSP (MULE CREEK SP),3578,0,3578,1700,210.5,3562
287,1996,9,ISP (IRONWOOD SP),4224,0,4224,2200,192.0,4360
288,1996,9,HDSP (HIGH DESERT SP),3978,2,3980,2224,179.0,4046
289,1996,9,FOL (FOLSOM SP) (MALE),3830,0,3830,2064,185.6,3710
290,1996,9,DVI (DEUEL VOCATIONAL INSTITUTION),3487,41,3528,1787,197.4,3706
291,1996,9,CTF (CORRECTIONAL TRAINING FAC),6446,2,6448,2981,216.3,6461
292,1996,9,CVSP (CHUCKAWALLA VALLEY SP),3609,0,3609,1738,207.7,3579
293,1996,9,"SOL (CA SP, SOLANO)",4758,0,4758,2110,225.5,4777
294,1996,9,SQ (SAN QUENTIN SP),5789,32,5821,3283,177.3,5721
295,1996,9,"SAC (CA SP, SACRAMENTO)",3128,1,3129,1728,181.1,3204
296,1996,9,"LAC (CA SP, LOS ANGELES COUNTY)",4067,0,4067,2200,184.9,4120
297,1996,9,"COR (CA SP, CORCORAN)",4731,0,4731,2916,162.2,5084
298,1996,9,CEN (CENTINELA SP),4431,0,4431,2208,200.7,4368
299,1996,9,CAL (CALIPATRIA SP),3887,0,3887,2208,176.0,4108
300,1996,9,"CRC (CAL REHAB CTR, MEN)",2310,1751,4061,1814,223.9,3906
301,1996,9,CMC (CA MEN'S COLONY),6440,0,6440,3884,165.8,6474
302,1996,9,CMF (CA MEDICAL FAC),3117,0,3117,2315,134.6,3377
303,1996,9,CIM (CA INSTITUTION FOR MEN),5823,38,5861,2778,211.0,5971
304,1996,9,CCI (CA CORRECTIONAL INSTITUTION),5855,0,5855,2781,210.5,5942
305,1996,9,CCC (CA CORRECTIONAL CENTER),5921,0,5921,3682,160.8,5637
306,1996,9,ASP (AVENAL SP),5723,0,5723,2320,246.7,5793
307,1996,10,VSP (VALLEY SP),2751,6,2757,1980,139.2,2592
308,1996,10,SCC (SIERRA CONSERVATION CENTER),333,0,333,320,104.1,320
309,1996,10,NCWF (NO CAL WOMEN'S FACIL),740,1,741,400,185.3,760
310,1996,10,CCWF (CENTRAL CA WOMEN'S FAC),3333,6,3339,2004,166.6,2914
311,1996,10,"CRC (CAL REHAB CTR, WOMEN)",178,664,842,500,168.4,842
312,1996,10,CIW (CA INSTITUTION FOR WOMEN),1672,30,1702,1026,165.9,1646
313,1996,10,WSP (WASCO SP),4770,43,4813,2484,193.8,4484
314,1996,10,SCC (SIERRA CONSERVATION CENTER),6030,0,6030,3606,167.2,5884
315,1996,10,SVSP (SALINAS VALLEY SP),3107,0,3107,700,443.9,700
316,1996,10,RJD (RJ DONOVAN CORRECTIONAL FAC),4651,0,4651,2200,211.4,4566
317,1996,10,PVSP (PLEASANT VALLEY SP),4567,0,4567,2208,206.8,4488
318,1996,10,PBSP (PELICAN BAY SP),3712,0,3712,2280,162.8,3711
319,1996,10,NKSP (NORTH KERN SP),4500,1,4501,2492,180.6,4472
320,1996,10,MCSP (MULE CREEK SP),3584,0,3584,1700,210.8,3562
321,1996,10,ISP (IRONWOOD SP),4473,0,4473,2200,203.3,4360
322,1996,10,HDSP (HIGH DESERT SP),3971,1,3972,2224,178.6,4046
323,1996,10,FOL (FOLSOM SP) (MALE),3764,0,3764,2064,182.4,3710
324,1996,10,DVI (DEUEL VOCATIONAL INSTITUTION),3591,37,3628,1787,203.0,3706
325,1996,10,CTF (CORRECTIONAL TRAINING FAC),6401,3,6404,2981,214.8,6461
326,1996,10,CVSP (CHUCKAWALLA VALLEY SP),3682,0,3682,1738,211.9,3579
327,1996,10,"SOL (CA SP, SOLANO)",4806,0,4806,2110,227.8,4777
328,1996,10,SQ (SAN QUENTIN SP),5667,30,5697,3283,173.5,5721
329,1996,10,"SAC (CA SP, SACRAMENTO)",3274,0,3274,1728,189.5,3204
330,1996,10,"LAC (CA SP, LOS ANGELES COUNTY)",4096,0,4096,2200,186.2,4120
331,1996,10,"COR (CA SP, CORCORAN)",4723,0,4723,2916,162.0,5084
332,1996,10,CEN (CENTINELA SP),4512,0,4512,2208,204.3,4368
333,1996,10,CAL (CALIPATRIA SP),3991,0,3991,2208,180.8,4108
334,1996,10,"CRC (CAL REHAB CTR, MEN)",2309,1707,4016,1814,221.4,3906
335,1996,10,CMC (CA MEN'S COLONY),6416,0,6416,3884,165.2,6474
336,1996,10,CMF (CA MEDICAL FAC),3086,0,3086,2315,133.3,3377
337,1996,10,CIM (CA INSTITUTION FOR MEN),5960,31,5991,2778,215.7,5971
338,1996,10,CCI (CA CORRECTIONAL INSTITUTION),5874,0,5874,2781,211.2,5942
339,1996,10,CCC (CA CORRECTIONAL CENTER),5833,0,5833,3682,158.4,5637
340,1996,10,ASP (AVENAL SP),5726,0,5726,2320,246.8,5793
341,1996,11,VSP (VALLEY SP),2818,15,2833,1980,143.1,2592
342,1996,11,SCC (SIERRA CONSERVATION CENTER),333,0,333,320,104.1,320
343,1996,11,NCWF (NO CAL WOMEN'S FACIL),756,1,757,400,189.3,760
344,1996,11,CCWF (CENTRAL CA WOMEN'S FAC),3240,6,3246,2004,162.0,2914
345,1996,11,"CRC (CAL REHAB CTR, WOMEN)",154,626,780,500,156.0,842
346,1996,11,CIW (CA INSTITUTION FOR WOMEN),1592,29,1621,1026,158.0,1646
347,1996,11,WSP (WASCO SP),4861,56,4917,2484,197.9,4484
348,1996,11,SCC (SIERRA CONSERVATION CENTER),6019,1,6020,3606,166.9,5884
349,1996,11,SVSP (SALINAS VALLEY SP),3289,0,3289,700,469.9,700
350,1996,11,RJD (RJ DONOVAN CORRECTIONAL FAC),4565,1,4566,2200,207.5,4566
351,1996,11,PVSP (PLEASANT VALLEY SP),4572,0,4572,2208,207.1,4488
352,1996,11,PBSP (PELICAN BAY SP),3587,0,3587,2280,157.3,3711
353,1996,11,NKSP (NORTH KERN SP),4464,0,4464,2492,179.1,4472
354,1996,11,MCSP (MULE CREEK SP),3562,0,3562,1700,209.5,3562
355,1996,11,ISP (IRONWOOD SP),4405,0,4405,2200,200.2,4360
356,1996,11,HDSP (HIGH DESERT SP),3993,1,3994,2224,179.6,4046
357,1996,11,FOL (FOLSOM SP) (MALE),3882,1,3883,2064,188.1,3710
358,1996,11,DVI (DEUEL VOCATIONAL INSTITUTION),3688,59,3747,1787,209.7,3706
359,1996,11,CTF (CORRECTIONAL TRAINING FAC),6400,2,6402,2981,214.8,6461
360,1996,11,CVSP (CHUCKAWALLA VALLEY SP),3622,0,3622,1738,208.4,3579
361,1996,11,"SOL (CA SP, SOLANO)",4762,0,4762,2110,225.7,4777
362,1996,11,SQ (SAN QUENTIN SP),5662,28,5690,3283,173.3,5721
363,1996,11,"SAC (CA SP, SACRAMENTO)",3192,1,3193,1728,184.8,3204
364,1996,11,"LAC (CA SP, LOS ANGELES COUNTY)",4265,0,4265,2200,193.9,4120
365,1996,11,"COR (CA SP, CORCORAN)",4702,0,4702,2916,161.2,5084
366,1996,11,CEN (CENTINELA SP),4569,0,4569,1708,267.5,3868
367,1996,11,CAL (CALIPATRIA SP),3964,0,3964,2208,179.5,4108
368,1996,11,"CRC (CAL REHAB CTR, MEN)",2330,1623,3953,1814,217.9,3906
369,1996,11,CMC (CA MEN'S COLONY),6418,1,6419,3884,165.3,6474
370,1996,11,CMF (CA MEDICAL FAC),3137,0,3137,2315,135.5,3377
371,1996,11,CIM (CA INSTITUTION FOR MEN),5502,33,5535,2778,199.2,5971
372,1996,11,CCI (CA CORRECTIONAL INSTITUTION),5987,0,5987,2781,215.3,5942
373,1996,11,CCC (CA CORRECTIONAL CENTER),5896,0,5896,3682,160.1,5637
374,1996,11,ASP (AVENAL SP),5730,0,5730,2320,247.0,5793
375,1996,12,VSP (VALLEY SP),2948,12,2960,1980,149.5,2592
376,1996,12,SCC (SIERRA CONSERVATION CENTER),324,0,324,320,101.3,320
377,1996,12,NCWF (NO CAL WOMEN'S FACIL),718,3,721,400,180.3,760
378,1996,12,CCWF (CENTRAL CA WOMEN'S FAC),3140,7,3147,2004,157.0,2914
379,1996,12,"CRC (CAL REHAB CTR, WOMEN)",157,607,764,500,152.8,842
380,1996,12,CIW (CA INSTITUTION FOR WOMEN),1678,28,1706,1026,166.3,1646
381,1996,12,WSP (WASCO SP),4624,22,4646,2484,187.0,4484
382,1996,12,SCC (SIERRA CONSERVATION CENTER),5905,0,5905,3606,163.8,5884
383,1996,12,SVSP (SALINAS VALLEY SP),3694,0,3694,700,527.7,700
384,1996,12,RJD (RJ DONOVAN CORRECTIONAL FAC),4636,0,4636,2200,210.7,4566
385,1996,12,PVSP (PLEASANT VALLEY SP),4582,0,4582,2208,207.5,4488
386,1996,12,PBSP (PELICAN BAY SP),3678,0,3678,2280,161.3,3711
387,1996,12,NKSP (NORTH KERN SP),4448,0,4448,2492,178.5,4472
388,1996,12,MCSP (MULE CREEK SP),3637,1,3638,1700,214.0,3562
389,1996,12,ISP (IRONWOOD SP),4495,0,4495,2200,204.3,4360
390,1996,12,HDSP (HIGH DESERT SP),4011,1,4012,2224,180.4,4046
391,1996,12,FOL (FOLSOM SP) (MALE),3827,1,3828,2064,185.5,3710
392,1996,12,DVI (DEUEL VOCATIONAL INSTITUTION),3681,52,3733,1787,208.9,3706
393,1996,12,CTF (CORRECTIONAL TRAINING FAC),6501,2,6503,2981,218.1,6461
394,1996,12,CVSP (CHUCKAWALLA VALLEY SP),3686,0,3686,1738,212.1,3579
395,1996,12,"SOL (CA SP, SOLANO)",4767,0,4767,2110,225.9,4777
396,1996,12,SQ (SAN QUENTIN SP),5663,31,5694,3283,173.4,5721
397,1996,12,"SAC (CA SP, SACRAMENTO)",3126,0,3126,1728,180.9,3204
398,1996,12,"LAC (CA SP, LOS ANGELES COUNTY)",4244,0,4244,2200,192.9,4120
399,1996,12,"COR (CA SP, CORCORAN)",4642,0,4642,2916,159.2,5084
400,1996,12,CEN (CENTINELA SP),4367,0,4367,1708,255.7,3868
401,1996,12,CAL (CALIPATRIA SP),4145,0,4145,2208,187.7,4108
402,1996,12,"CRC (CAL REHAB CTR, MEN)",2387,1598,3985,1814,219.7,3906
403,1996,12,CMC (CA MEN'S COLONY),6395,0,6395,3884,164.6,6474
404,1996,12,CMF (CA MEDICAL FAC),3220,0,3220,2315,139.1,3377
405,1996,12,CIM (CA INSTITUTION FOR MEN),5664,31,5695,2778,205.0,5971
406,1996,12,CCI (CA CORRECTIONAL INSTITUTION),5940,0,5940,2781,213.6,5942
407,1996,12,CCC (CA CORRECTIONAL CENTER),5760,0,5760,3682,156.4,5637
408,1996,12,ASP (AVENAL SP),5787,0,5787,2320,249.4,5793
409,1997,1,VSP (VALLEY SP),2864,11,2875,1980,145.2,3330
410,1997,1,SCC (SIERRA CONSERVATION CENTER),335,0,335,320,104.7,320
411,1997,1,NCWF (NO CAL WOMEN'S FACIL),755,2,757,400,189.3,760
412,1997,1,CCWF (CENTRAL CA WOMEN'S FAC),3271,8,3279,2004,163.6,3526
413,1997,1,"CRC (CAL REHAB CTR, WOMEN)",206,599,805,500,161.0,842
414,1997,1,CIW (CA INSTITUTION FOR WOMEN),1714,28,1742,1026,169.8,1747
415,1997,1,WSP (WASCO SP),4998,32,5030,2984,168.6,5812
416,1997,1,SCC (SIERRA CONSERVATION CENTER),5959,0,5959,3606,165.3,5884
417,1997,1,SVSP (SALINAS VALLEY SP),3844,0,3844,2224,172.8,4046
418,1997,1,RJD (RJ DONOVAN CORRECTIONAL FAC),4609,0,4609,2200,209.5,4698
419,1997,1,PVSP (PLEASANT VALLEY SP),4568,0,4568,2208,206.9,4348
420,1997,1,PBSP (PELICAN BAY SP),3692,0,3692,2280,161.9,3711
421,1997,1,NKSP (NORTH KERN SP),4681,1,4682,2692,173.9,5104
422,1997,1,MCSP (MULE CREEK SP),3522,1,3523,1700,207.2,3562
423,1997,1,ISP (IRONWOOD SP),4363,0,4363,2200,198.3,4340
424,1997,1,HDSP (HIGH DESERT SP),3854,1,3855,2224,173.3,4046
425,1997,1,FOL (FOLSOM SP) (MALE),3898,0,3898,2072,188.1,3725
426,1997,1,DVI (DEUEL VOCATIONAL INSTITUTION),3396,54,3450,1787,193.1,3606
427,1997,1,CTF (CORRECTIONAL TRAINING FAC),6517,2,6519,3281,198.7,6941
428,1997,1,CVSP (CHUCKAWALLA VALLEY SP),3591,0,3591,1738,206.6,3679
429,1997,1,"SOL (CA SP, SOLANO)",4802,0,4802,2610,184.0,5552
430,1997,1,SQ (SAN QUENTIN SP),5953,43,5996,3383,177.2,5867
431,1997,1,"SAC (CA SP, SACRAMENTO)",3136,2,3138,1728,181.6,3204
432,1997,1,"LAC (CA SP, LOS ANGELES COUNTY)",4155,0,4155,2200,188.9,4100
433,1997,1,"COR (CA SP, CORCORAN)",4585,0,4585,2516,182.2,3992
434,1997,1,CEN (CENTINELA SP),4464,0,4464,2208,202.2,4468
435,1997,1,CAL (CALIPATRIA SP),4099,0,4099,2208,185.6,4108
436,1997,1,"CRC (CAL REHAB CTR, MEN)",2540,1550,4090,1814,225.5,3906
437,1997,1,CMC (CA MEN'S COLONY),6394,0,6394,3884,164.6,6724
438,1997,1,CMF (CA MEDICAL FAC),3155,0,3155,2315,136.3,3377
439,1997,1,CIM (CA INSTITUTION FOR MEN),5869,12,5881,3078,191.1,6318
440,1997,1,CCI (CA CORRECTIONAL INSTITUTION),5974,0,5974,2781,214.8,5992
441,1997,1,CCC (CA CORRECTIONAL CENTER),5726,0,5726,3682,155.5,5657
442,1997,1,ASP (AVENAL SP),5737,0,5737,2320,247.3,5793
443,1997,2,VSP (VALLEY SP),2814,16,2830,1980,142.9,2950
444,1997,2,SCC (SIERRA CONSERVATION CENTER),332,0,332,320,103.8,320
445,1997,2,NCWF (NO CAL WOMEN'S FACIL),766,0,766,400,191.5,760
446,1997,2,CCWF (CENTRAL CA WOMEN'S FAC),3316,11,3327,2004,166.0,3094
447,1997,2,"CRC (CAL REHAB CTR, WOMEN)",275,597,872,500,174.4,842
448,1997,2,CIW (CA INSTITUTION FOR WOMEN),1748,27,1775,1026,173.0,1663
449,1997,2,WSP (WASCO SP),4989,26,5015,2484,201.9,4812
450,1997,2,SCC (SIERRA CONSERVATION CENTER),5992,0,5992,3606,166.2,5884
451,1997,2,SVSP (SALINAS VALLEY SP),3913,0,3913,2224,175.9,3032
452,1997,2,RJD (RJ DONOVAN CORRECTIONAL FAC),4658,0,4658,2200,211.7,4546
453,1997,2,PVSP (PLEASANT VALLEY SP),4468,0,4468,2208,202.4,4488
454,1997,2,PBSP (PELICAN BAY SP),3697,0,3697,2280,162.1,3711
455,1997,2,NKSP (NORTH KERN SP),5131,0,5131,2492,205.9,4472
456,1997,2,MCSP (MULE CREEK SP),3645,1,3646,1700,214.5,3562
457,1997,2,ISP (IRONWOOD SP),4373,0,4373,2200,198.8,4580
458,1997,2,HDSP (HIGH DESERT SP),4016,1,4017,2224,180.6,4046
459,1997,2,FOL (FOLSOM SP) (MALE),3900,0,3900,2064,189.0,3710
460,1997,2,DVI (DEUEL VOCATIONAL INSTITUTION),3576,63,3639,1787,203.6,3706
461,1997,2,CTF (CORRECTIONAL TRAINING FAC),6564,4,6568,2981,220.3,6561
462,1997,2,CVSP (CHUCKAWALLA VALLEY SP),3667,0,3667,1738,211.0,3679
463,1997,2,"SOL (CA SP, SOLANO)",4800,0,4800,2110,227.5,4777
464,1997,2,SQ (SAN QUENTIN SP),5732,55,5787,3283,176.3,5721
465,1997,2,"SAC (CA SP, SACRAMENTO)",3161,0,3161,1728,182.9,3204
466,1997,2,"LAC (CA SP, LOS ANGELES COUNTY)",4087,0,4087,2200,185.8,4120
467,1997,2,"COR (CA SP, CORCORAN)",4754,0,4754,2916,163.0,5084
468,1997,2,CEN (CENTINELA SP),4422,0,4422,2208,200.3,4588
469,1997,2,CAL (CALIPATRIA SP),4137,0,4137,2208,187.4,4108
470,1997,2,"CRC (CAL REHAB CTR, MEN)",2553,1550,4103,1814,226.2,4001
471,1997,2,CMC (CA MEN'S COLONY),6415,0,6415,3884,165.2,6474
472,1997,2,CMF (CA MEDICAL FAC),3133,0,3133,2315,135.3,3377
473,1997,2,CIM (CA INSTITUTION FOR MEN),5841,17,5858,2778,210.9,5718
474,1997,2,CCI (CA CORRECTIONAL INSTITUTION),5916,1,5917,2781,212.8,5942
475,1997,2,CCC (CA CORRECTIONAL CENTER),5929,0,5929,3682,161.0,5637
476,1997,2,ASP (AVENAL SP),5723,0,5723,2320,246.7,5793
477,1997,3,VSP (VALLEY SP),2847,9,2856,1980,144.2,2950
478,1997,3,SCC (SIERRA CONSERVATION CENTER),323,0,323,320,100.9,320
479,1997,3,NCWF (NO CAL WOMEN'S FACIL),786,0,786,400,196.5,760
480,1997,3,CCWF (CENTRAL CA WOMEN'S FAC),3421,5,3426,2004,171.0,3274
481,1997,3,"CRC (CAL REHAB CTR, WOMEN)",331,587,918,500,183.6,842
482,1997,3,CIW (CA INSTITUTION FOR WOMEN),1744,24,1768,1026,172.3,1663
483,1997,3,WSP (WASCO SP),5674,42,5716,2484,230.1,5044
484,1997,3,SCC (SIERRA CONSERVATION CENTER),5992,0,5992,3606,166.2,5884
485,1997,3,SVSP (SALINAS VALLEY SP),3917,0,3917,2224,176.1,4046
486,1997,3,RJD (RJ DONOVAN CORRECTIONAL FAC),4609,0,4609,2200,209.5,4546
487,1997,3,PVSP (PLEASANT VALLEY SP),4521,0,4521,2208,204.8,4468
488,1997,3,PBSP (PELICAN BAY SP),3647,0,3647,2280,160.0,3711
489,1997,3,NKSP (NORTH KERN SP),5049,0,5049,2592,194.8,4672
490,1997,3,MCSP (MULE CREEK SP),3575,2,3577,1700,210.4,3562
491,1997,3,ISP (IRONWOOD SP),4452,0,4452,2200,202.4,4460
492,1997,3,HDSP (HIGH DESERT SP),4169,4,4173,2224,187.6,4046
493,1997,3,FOL (FOLSOM SP) (MALE),3906,0,3906,2064,189.2,3710
494,1997,3,DVI (DEUEL VOCATIONAL INSTITUTION),3718,52,3770,1787,211.0,3706
495,1997,3,CTF (CORRECTIONAL TRAINING FAC),7095,3,7098,2981,238.1,6461
496,1997,3,CVSP (CHUCKAWALLA VALLEY SP),3598,0,3598,1738,207.0,3679
497,1997,3,"SOL (CA SP, SOLANO)",4791,0,4791,2110,227.1,4777
498,1997,3,SQ (SAN QUENTIN SP),5876,41,5917,3283,180.2,5694
499,1997,3,"SAC (CA SP, SACRAMENTO)",3164,2,3166,1728,183.2,3204
500,1997,3,"LAC (CA SP, LOS ANGELES COUNTY)",4068,0,4068,2200,184.9,4120
501,1997,3,"COR (CA SP, CORCORAN)",4679,0,4679,2916,160.5,4963
502,1997,3,CEN (CENTINELA SP),4507,0,4507,2208,204.1,4468
503,1997,3,CAL (CALIPATRIA SP),4029,0,4029,2208,182.5,4108
504,1997,3,"CRC (CAL REHAB CTR, MEN)",2486,1584,4070,1814,224.4,4001
505,1997,3,CMC (CA MEN'S COLONY),6451,0,6451,3884,166.1,6474
506,1997,3,CMF (CA MEDICAL FAC),3116,0,3116,2315,134.6,3377
507,1997,3,CIM (CA INSTITUTION FOR MEN),6005,23,6028,2778,217.0,5718
508,1997,3,CCI (CA CORRECTIONAL INSTITUTION),5921,0,5921,2781,212.9,5942
509,1997,3,CCC (CA CORRECTIONAL CENTER),5956,0,5956,3682,161.8,5637
510,1997,3,ASP (AVENAL SP),5713,0,5713,2320,246.3,5793
511,1997,4,VSP (VALLEY SP),3022,19,3041,1980,153.6,2950
512,1997,4,SCC (SIERRA CONSERVATION CENTER),330,0,330,320,103.1,320
513,1997,4,NCWF (NO CAL WOMEN'S FACIL),760,4,764,400,191.0,760
514,1997,4,CCWF (CENTRAL CA WOMEN'S FAC),3461,22,3483,2004,173.8,3274
515,1997,4,"CRC (CAL REHAB CTR, WOMEN)",323,587,910,500,182.0,842
516,1997,4,CIW (CA INSTITUTION FOR WOMEN),1801,21,1822,1026,177.6,1663
517,1997,4,WSP (WASCO SP),6128,48,6176,2884,214.1,5844
518,1997,4,SCC (SIERRA CONSERVATION CENTER),5906,0,5906,3606,163.8,5884
519,1997,4,SVSP (SALINAS VALLEY SP),4130,0,4130,2224,185.7,4046
520,1997,4,RJD (RJ DONOVAN CORRECTIONAL FAC),4564,0,4564,2200,207.5,4546
521,1997,4,PVSP (PLEASANT VALLEY SP),4643,0,4643,2208,210.3,4468
522,1997,4,PBSP (PELICAN BAY SP),3636,0,3636,2280,159.5,3711
523,1997,4,NKSP (NORTH KERN SP),5154,0,5154,2692,191.5,4872
524,1997,4,MCSP (MULE CREEK SP),3630,2,3632,1700,213.6,3562
525,1997,4,ISP (IRONWOOD SP),4518,0,4518,2200,205.4,4580
526,1997,4,HDSP (HIGH DESERT SP),4024,7,4031,2224,181.3,4046
527,1997,4,FOL (FOLSOM SP) (MALE),3839,0,3839,2064,186.0,3710
528,1997,4,DVI (DEUEL VOCATIONAL INSTITUTION),3680,46,3726,1787,208.5,3706
529,1997,4,CTF (CORRECTIONAL TRAINING FAC),7231,4,7235,3281,220.5,7061
530,1997,4,CVSP (CHUCKAWALLA VALLEY SP),3608,0,3608,1738,207.6,3679
531,1997,4,"SOL (CA SP, SOLANO)",4759,0,4759,2110,225.5,4777
532,1997,4,SQ (SAN QUENTIN SP),5937,38,5975,3283,182.0,5694
533,1997,4,"SAC (CA SP, SACRAMENTO)",3229,0,3229,1728,186.9,3204
534,1997,4,"LAC (CA SP, LOS ANGELES COUNTY)",4191,0,4191,2200,190.5,4120
535,1997,4,"COR (CA SP, CORCORAN)",4682,0,4682,2916,160.6,4963
536,1997,4,CEN (CENTINELA SP),4660,0,4660,2208,211.1,4588
537,1997,4,CAL (CALIPATRIA SP),4096,0,4096,2208,185.5,4108
538,1997,4,"CRC (CAL REHAB CTR, MEN)",2412,1617,4029,1814,222.1,4001
539,1997,4,CMC (CA MEN'S COLONY),6405,0,6405,3884,164.9,6474
540,1997,4,CMF (CA MEDICAL FAC),3229,0,3229,2315,139.5,3377
541,1997,4,CIM (CA INSTITUTION FOR MEN),6445,27,6472,2978,217.3,6118
542,1997,4,CCI (CA CORRECTIONAL INSTITUTION),5998,2,6000,2781,215.7,5942
543,1997,4,CCC (CA CORRECTIONAL CENTER),5974,0,5974,3682,162.2,5637
544,1997,4,ASP (AVENAL SP),5726,0,5726,2320,246.8,5793
545,1997,5,VSP (VALLEY SP),3087,9,3096,1980,156.4,2950
546,1997,5,SCC (SIERRA CONSERVATION CENTER),324,0,324,320,101.3,320
547,1997,5,NCWF (NO CAL WOMEN'S FACIL),777,3,780,400,195.0,760
548,1997,5,CCWF (CENTRAL CA WOMEN'S FAC),3503,10,3513,2004,175.3,3274
549,1997,5,"CRC (CAL REHAB CTR, WOMEN)",329,541,870,500,174.0,842
550,1997,5,CIW (CA INSTITUTION FOR WOMEN),1792,21,1813,1026,176.7,1663
551,1997,5,WSP (WASCO SP),6055,55,6110,2884,211.9,5844
552,1997,5,SCC (SIERRA CONSERVATION CENTER),6012,0,6012,3606,166.7,5884
553,1997,5,SVSP (SALINAS VALLEY SP),4163,0,4163,2224,187.2,4046
554,1997,5,RJD (RJ DONOVAN CORRECTIONAL FAC),4689,0,4689,2200,213.1,4546
555,1997,5,PVSP (PLEASANT VALLEY SP),4594,0,4594,2208,208.1,4468
556,1997,5,PBSP (PELICAN BAY SP),3660,0,3660,2280,160.5,3711
557,1997,5,NKSP (NORTH KERN SP),5138,0,5138,2692,190.9,4872
558,1997,5,MCSP (MULE CREEK SP),3589,2,3591,1700,211.2,3562
559,1997,5,ISP (IRONWOOD SP),4418,0,4418,2200,200.8,4580
560,1997,5,HDSP (HIGH DESERT SP),4098,2,4100,2224,184.4,4046
561,1997,5,FOL (FOLSOM SP) (MALE),3851,0,3851,2064,186.6,3710
562,1997,5,DVI (DEUEL VOCATIONAL INSTITUTION),3633,43,3676,1787,205.7,3706
563,1997,5,CTF (CORRECTIONAL TRAINING FAC),7221,2,7223,3281,220.1,7061
564,1997,5,CVSP (CHUCKAWALLA VALLEY SP),3643,0,3643,1738,209.6,3679
565,1997,5,"SOL (CA SP, SOLANO)",5143,0,5143,2110,243.7,4777
566,1997,5,SQ (SAN QUENTIN SP),5755,25,5780,3283,176.1,5694
567,1997,5,"SAC (CA SP, SACRAMENTO)",3265,0,3265,1728,188.9,3204
568,1997,5,"LAC (CA SP, LOS ANGELES COUNTY)",4323,0,4323,2200,196.5,4120
569,1997,5,"COR (CA SP, CORCORAN)",4653,0,4653,2916,159.6,4963
570,1997,5,CEN (CENTINELA SP),4582,0,4582,2208,207.5,4588
571,1997,5,CAL (CALIPATRIA SP),3975,0,3975,2208,180.0,4108
572,1997,5,"CRC (CAL REHAB CTR, MEN)",2516,1632,4148,1814,228.7,4001
573,1997,5,CMC (CA MEN'S COLONY),6672,0,6672,3884,171.8,6474
574,1997,5,CMF (CA MEDICAL FAC),3171,0,3171,2315,137.0,3377
575,1997,5,CIM (CA INSTITUTION FOR MEN),6427,32,6459,2978,216.9,6118
576,1997,5,CCI (CA CORRECTIONAL INSTITUTION),5949,1,5950,2781,214.0,5942
577,1997,5,CCC (CA CORRECTIONAL CENTER),5877,0,5877,3682,159.6,5637
578,1997,5,ASP (AVENAL SP),5763,0,5763,2320,248.4,5793
579,1997,6,VSP (VALLEY SP),3230,21,3251,1980,164.2,3090
580,1997,6,SCC (SIERRA CONSERVATION CENTER),332,0,332,320,103.8,320
581,1997,6,NCWF (NO CAL WOMEN'S FACIL),754,4,758,400,189.5,760
582,1997,6,CCWF (CENTRAL CA WOMEN'S FAC),3315,13,3328,2004,166.1,3274
583,1997,6,"CRC (CAL REHAB CTR, WOMEN)",365,528,893,500,178.6,842
584,1997,6,CIW (CA INSTITUTION FOR WOMEN),1812,17,1829,1026,178.3,1663
585,1997,6,WSP (WASCO SP),5847,32,5879,2984,197.0,6044
586,1997,6,SCC (SIERRA CONSERVATION CENTER),5975,0,5975,3606,165.7,5884
587,1997,6,SVSP (SALINAS VALLEY SP),4204,0,4204,2224,189.0,4046
588,1997,6,RJD (RJ DONOVAN CORRECTIONAL FAC),4642,0,4642,2200,211.0,4668
589,1997,6,PVSP (PLEASANT VALLEY SP),4660,0,4660,2208,211.1,4588
590,1997,6,PBSP (PELICAN BAY SP),3731,1,3732,2280,163.7,3711
591,1997,6,NKSP (NORTH KERN SP),5095,0,5095,2692,189.3,5104
592,1997,6,MCSP (MULE CREEK SP),3658,2,3660,1700,215.3,3562
593,1997,6,ISP (IRONWOOD SP),4606,0,4606,2200,209.4,4580
594,1997,6,HDSP (HIGH DESERT SP),4289,9,4298,2224,193.3,4166
595,1997,6,FOL (FOLSOM SP) (MALE),3781,0,3781,2071,182.6,3723
596,1997,6,DVI (DEUEL VOCATIONAL INSTITUTION),3457,42,3499,1787,195.8,3706
597,1997,6,CTF (CORRECTIONAL TRAINING FAC),7187,2,7189,3281,219.1,7061
598,1997,6,CVSP (CHUCKAWALLA VALLEY SP),3579,0,3579,1738,205.9,3679
599,1997,6,"SOL (CA SP, SOLANO)",5735,0,5735,2110,271.8,4777
600,1997,6,SQ (SAN QUENTIN SP),5737,26,5763,3283,175.5,5694
601,1997,6,"SAC (CA SP, SACRAMENTO)",3271,0,3271,1728,189.3,3204
602,1997,6,"LAC (CA SP, LOS ANGELES COUNTY)",4272,0,4272,2200,194.2,4120
603,1997,6,"COR (CA SP, CORCORAN)",4955,0,4955,2916,169.9,4963
604,1997,6,CEN (CENTINELA SP),4377,0,4377,2208,198.2,4588
605,1997,6,CAL (CALIPATRIA SP),4054,0,4054,2208,183.6,4108
606,1997,6,"CRC (CAL REHAB CTR, MEN)",2461,1644,4105,1814,226.3,4001
607,1997,6,CMC (CA MEN'S COLONY),6580,0,6580,3884,169.4,6474
608,1997,6,CMF (CA MEDICAL FAC),3087,0,3087,2315,133.3,3377
609,1997,6,CIM (CA INSTITUTION FOR MEN),6422,38,6460,3078,209.9,6318
610,1997,6,CCI (CA CORRECTIONAL INSTITUTION),5917,1,5918,2781,212.8,5992
611,1997,6,CCC (CA CORRECTIONAL CENTER),5920,0,5920,3682,160.8,5637
612,1997,6,ASP (AVENAL SP),5699,0,5699,2320,245.6,5793
613,1997,7,VSP (VALLEY SP),3289,15,3304,1980,166.9,3090
614,1997,7,SCC (SIERRA CONSERVATION CENTER),324,0,324,320,101.3,320
615,1997,7,NCWF (NO CAL WOMEN'S FACIL),739,1,740,400,185.0,760
616,1997,7,CCWF (CENTRAL CA WOMEN'S FAC),3443,9,3452,2004,172.3,3274
617,1997,7,"CRC (CAL REHAB CTR, WOMEN)",371,528,899,500,179.8,842
618,1997,7,CIW (CA INSTITUTION FOR WOMEN),1774,20,1794,1026,174.9,1663
619,1997,7,WSP (WASCO SP),5726,48,5774,2984,193.5,6044
620,1997,7,SCC (SIERRA CONSERVATION CENTER),5991,1,5992,3606,166.2,5884
621,1997,7,SVSP (SALINAS VALLEY SP),4235,0,4235,2224,190.4,4046
622,1997,7,RJD (RJ DONOVAN CORRECTIONAL FAC),4586,0,4586,2200,208.5,4668
623,1997,7,PVSP (PLEASANT VALLEY SP),4697,0,4697,2208,212.7,4588
624,1997,7,PBSP (PELICAN BAY SP),3785,0,3785,2280,166.0,3711
625,1997,7,NKSP (NORTH KERN SP),5092,0,5092,2692,189.2,5104
626,1997,7,MCSP (MULE CREEK SP),3680,0,3680,1700,216.5,3562
627,1997,7,ISP (IRONWOOD SP),4580,0,4580,2200,208.2,4580
628,1997,7,HDSP (HIGH DESERT SP),4282,1,4283,2224,192.6,4166
629,1997,7,FOL (FOLSOM SP) (MALE),3854,0,3854,2071,186.1,3723
630,1997,7,DVI (DEUEL VOCATIONAL INSTITUTION),3856,33,3889,1787,217.6,3706
631,1997,7,CTF (CORRECTIONAL TRAINING FAC),7021,2,7023,3281,214.1,7061
632,1997,7,CVSP (CHUCKAWALLA VALLEY SP),3568,0,3568,1738,205.3,3679
633,1997,7,"SOL (CA SP, SOLANO)",5857,0,5857,2110,277.6,4777
634,1997,7,SQ (SAN QUENTIN SP),5763,30,5793,3283,176.5,5694
635,1997,7,"SAC (CA SP, SACRAMENTO)",3276,2,3278,1728,189.7,3204
636,1997,7,"LAC (CA SP, LOS ANGELES COUNTY)",4167,0,4167,2200,189.4,4120
637,1997,7,"COR (CA SP, CORCORAN)",5052,0,5052,2916,173.3,4963
638,1997,7,CEN (CENTINELA SP),4350,0,4350,2208,197.0,4588
639,1997,7,CAL (CALIPATRIA SP),4054,0,4054,2208,183.6,4108
640,1997,7,"CRC (CAL REHAB CTR, MEN)",2438,1670,4108,1814,226.5,4001
641,1997,7,CMC (CA MEN'S COLONY),6681,0,6681,3884,172.0,6474
642,1997,7,CMF (CA MEDICAL FAC),3122,0,3122,2315,134.9,3377
643,1997,7,CIM (CA INSTITUTION FOR MEN),6484,48,6532,3078,212.2,6318
644,1997,7,CCI (CA CORRECTIONAL INSTITUTION),5942,1,5943,2781,213.7,5992
645,1997,7,CCC (CA CORRECTIONAL CENTER),5920,0,5920,3682,160.8,5637
646,1997,7,ASP (AVENAL SP),5727,0,5727,2320,246.9,5793
647,1997,8,VSP (VALLEY SP),3223,14,3237,1980,163.5,3090
648,1997,8,SCC (SIERRA CONSERVATION CENTER),330,0,330,320,103.1,320
649,1997,8,NCWF (NO CAL WOMEN'S FACIL),762,5,767,400,191.8,760
650,1997,8,CCWF (CENTRAL CA WOMEN'S FAC),3503,7,3510,2004,175.1,3274
651,1997,8,"CRC (CAL REHAB CTR, WOMEN)",390,529,919,500,183.8,842
652,1997,8,CIW (CA INSTITUTION FOR WOMEN),1730,17,1747,1026,170.3,1663
653,1997,8,WSP (WASCO SP),5790,30,5820,2984,195.0,6044
654,1997,8,SCC (SIERRA CONSERVATION CENTER),5970,1,5971,3606,165.6,5884
655,1997,8,SVSP (SALINAS VALLEY SP),4161,0,4161,2224,187.1,4046
656,1997,8,RJD (RJ DONOVAN CORRECTIONAL FAC),4522,0,4522,2200,205.5,4668
657,1997,8,PVSP (PLEASANT VALLEY SP),4650,0,4650,2208,210.6,4588
658,1997,8,PBSP (PELICAN BAY SP),3769,0,3769,2280,165.3,3711
659,1997,8,NKSP (NORTH KERN SP),5142,0,5142,2692,191.0,5104
660,1997,8,MCSP (MULE CREEK SP),3507,0,3507,1700,206.3,3562
661,1997,8,ISP (IRONWOOD SP),4640,0,4640,2200,210.9,4580
662,1997,8,HDSP (HIGH DESERT SP),4219,1,4220,2224,189.7,4166
663,1997,8,FOL (FOLSOM SP) (MALE),3909,0,3909,2071,188.7,3723
664,1997,8,DVI (DEUEL VOCATIONAL INSTITUTION),3725,50,3775,1787,211.2,3706
665,1997,8,CTF (CORRECTIONAL TRAINING FAC),7109,2,7111,3281,216.7,7061
666,1997,8,CVSP (CHUCKAWALLA VALLEY SP),3665,0,3665,1738,210.9,3679
667,1997,8,SATF (CA SUBSTANCE ABUSE TREAT FAC),491,0,491,500,98.2,500
668,1997,8,"SOL (CA SP, SOLANO)",5828,0,5828,2110,276.2,4777
669,1997,8,SQ (SAN QUENTIN SP),5800,39,5839,3283,177.9,5694
670,1997,8,"SAC (CA SP, SACRAMENTO)",3173,0,3173,1728,183.6,3204
671,1997,8,"LAC (CA SP, LOS ANGELES COUNTY)",4240,0,4240,2200,192.7,4120
672,1997,8,"COR (CA SP, CORCORAN)",4949,0,4949,2916,169.7,4963
673,1997,8,CEN (CENTINELA SP),4457,0,4457,2208,201.9,4588
674,1997,8,CAL (CALIPATRIA SP),3993,0,3993,2208,180.8,4108
675,1997,8,"CRC (CAL REHAB CTR, MEN)",2469,1681,4150,1814,228.8,4001
676,1997,8,CMC (CA MEN'S COLONY),6694,0,6694,3884,172.3,6474
677,1997,8,CMF (CA MEDICAL FAC),3124,0,3124,2315,134.9,3377
678,1997,8,CIM (CA INSTITUTION FOR MEN),6439,36,6475,3078,210.4,6318
679,1997,8,CCI (CA CORRECTIONAL INSTITUTION),5995,1,5996,2781,215.6,5992
680,1997,8,CCC (CA CORRECTIONAL CENTER),5930,0,5930,3682,161.1,5637
681,1997,8,ASP (AVENAL SP),5689,0,5689,2320,245.2,5793
682,1997,9,VSP (VALLEY SP),3146,18,3164,1980,159.8,3090
683,1997,9,SCC (SIERRA CONSERVATION CENTER),319,0,319,320,99.7,320
684,1997,9,NCWF (NO CAL WOMEN'S FACIL),727,5,732,400,183.0,760
685,1997,9,CCWF (CENTRAL CA WOMEN'S FAC),3598,6,3604,2004,179.8,3274
686,1997,9,"CRC (CAL REHAB CTR, WOMEN)",363,536,899,500,179.8,842
687,1997,9,CIW (CA INSTITUTION FOR WOMEN),1803,14,1817,1026,177.1,1663
688,1997,9,WSP (WASCO SP),5717,26,5743,2984,192.5,6044
689,1997,9,SCC (SIERRA CONSERVATION CENTER),5981,1,5982,3606,165.9,5884
690,1997,9,SVSP (SALINAS VALLEY SP),4113,0,4113,2224,184.9,4046
691,1997,9,RJD (RJ DONOVAN CORRECTIONAL FAC),4716,0,4716,2200,214.4,4668
692,1997,9,PVSP (PLEASANT VALLEY SP),4721,0,4721,2208,213.8,4588
693,1997,9,PBSP (PELICAN BAY SP),3823,0,3823,2280,167.7,3711
694,1997,9,NKSP (NORTH KERN SP),4962,1,4963,2692,184.4,5104
695,1997,9,MCSP (MULE CREEK SP),3640,0,3640,1700,214.1,3562
696,1997,9,ISP (IRONWOOD SP),4544,0,4544,2200,206.5,4580
697,1997,9,HDSP (HIGH DESERT SP),4114,4,4118,2224,185.2,4166
698,1997,9,FOL (FOLSOM SP) (MALE),3810,0,3810,2071,184.0,3723
699,1997,9,DVI (DEUEL VOCATIONAL INSTITUTION),3549,56,3605,1787,201.7,3706
700,1997,9,CTF (CORRECTIONAL TRAINING FAC),7080,2,7082,3281,215.8,7061
701,1997,9,CVSP (CHUCKAWALLA VALLEY SP),3624,0,3624,1738,208.5,3679
702,1997,9,SATF (CA SUBSTANCE ABUSE TREAT FAC),959,0,959,500,191.8,500
703,1997,9,"SOL (CA SP, SOLANO)",5841,0,5841,2110,276.8,4777
704,1997,9,SQ (SAN QUENTIN SP),5955,15,5970,3183,187.6,5494
705,1997,9,"SAC (CA SP, SACRAMENTO)",3187,0,3187,1728,184.4,3204
706,1997,9,"LAC (CA SP, LOS ANGELES COUNTY)",4210,0,4210,2200,191.4,4120
707,1997,9,"COR (CA SP, CORCORAN)",5039,1,5040,2916,172.8,4963
708,1997,9,CEN (CENTINELA SP),4419,0,4419,2208,200.1,4588
709,1997,9,CAL (CALIPATRIA SP),3979,0,3979,2208,180.2,4108
710,1997,9,"CRC (CAL REHAB CTR, MEN)",2435,1679,4114,1814,226.8,4001
711,1997,9,CMC (CA MEN'S COLONY),6751,0,6751,3884,173.8,6474
712,1997,9,CMF (CA MEDICAL FAC),3216,0,3216,2315,138.9,3377
713,1997,9,CIM (CA INSTITUTION FOR MEN),6493,39,6532,3078,212.2,6318
714,1997,9,CCI (CA CORRECTIONAL INSTITUTION),5915,2,5917,2781,212.8,5992
715,1997,9,CCC (CA CORRECTIONAL CENTER),5874,0,5874,3682,159.5,5637
716,1997,9,ASP (AVENAL SP),5695,0,5695,2320,245.5,5793
717,1997,10,VSP (VALLEY SP),3206,16,3222,1980,162.7,3090
718,1997,10,SCC (SIERRA CONSERVATION CENTER),335,0,335,320,104.7,320
719,1997,10,NCWF (NO CAL WOMEN'S FACIL),756,2,758,400,189.5,760
720,1997,10,CCWF (CENTRAL CA WOMEN'S FAC),3571,11,3582,2004,178.7,3274
721,1997,10,"CRC (CAL REHAB CTR, WOMEN)",347,540,887,500,177.4,842
722,1997,10,CIW (CA INSTITUTION FOR WOMEN),1854,14,1868,1026,182.1,1663
723,1997,10,WSP (WASCO SP),5951,30,5981,2984,200.4,6044
724,1997,10,SCC (SIERRA CONSERVATION CENTER),5918,0,5918,3606,164.1,5884
725,1997,10,SVSP (SALINAS VALLEY SP),4149,0,4149,2224,186.6,4046
726,1997,10,RJD (RJ DONOVAN CORRECTIONAL FAC),4744,0,4744,2200,215.6,4668
727,1997,10,PVSP (PLEASANT VALLEY SP),4631,0,4631,2208,209.7,4588
728,1997,10,PBSP (PELICAN BAY SP),3776,0,3776,2280,165.6,3711
729,1997,10,NKSP (NORTH KERN SP),4981,0,4981,2692,185.0,5104
730,1997,10,MCSP (MULE CREEK SP),3615,0,3615,1700,212.6,3562
731,1997,10,ISP (IRONWOOD SP),4608,0,4608,2200,209.5,4580
732,1997,10,HDSP (HIGH DESERT SP),4133,4,4137,2224,186.0,4166
733,1997,10,FOL (FOLSOM SP) (MALE),3875,0,3875,2071,187.1,3723
734,1997,10,DVI (DEUEL VOCATIONAL INSTITUTION),3720,88,3808,1787,213.1,3706
735,1997,10,CTF (CORRECTIONAL TRAINING FAC),7013,2,7015,3281,213.8,7061
736,1997,10,CVSP (CHUCKAWALLA VALLEY SP),3629,0,3629,1738,208.8,3679
737,1997,10,SATF (CA SUBSTANCE ABUSE TREAT FAC),1455,0,1455,500,291.0,500
738,1997,10,"SOL (CA SP, SOLANO)",5745,0,5745,2110,272.3,4777
739,1997,10,SQ (SAN QUENTIN SP),6010,15,6025,3183,189.3,5494
740,1997,10,"SAC (CA SP, SACRAMENTO)",3165,1,3166,1728,183.2,3204
741,1997,10,"LAC (CA SP, LOS ANGELES COUNTY)",4259,0,4259,2200,193.6,4120
742,1997,10,"COR (CA SP, CORCORAN)",5303,1,5304,2916,181.9,4963
743,1997,10,CEN (CENTINELA SP),4534,0,4534,2208,205.3,4588
744,1997,10,CAL (CALIPATRIA SP),4013,0,4013,2208,181.7,4108
745,1997,10,"CRC (CAL REHAB CTR, MEN)",2417,1625,4042,1814,222.8,4001
746,1997,10,CMC (CA MEN'S COLONY),6626,0,6626,3884,170.6,6474
747,1997,10,CMF (CA MEDICAL FAC),3195,0,3195,2315,138.0,3377
748,1997,10,CIM (CA INSTITUTION FOR MEN),6363,42,6405,3078,208.1,6318
749,1997,10,CCI (CA CORRECTIONAL INSTITUTION),5856,2,5858,2781,210.6,5992
750,1997,10,CCC (CA CORRECTIONAL CENTER),5901,0,5901,3682,160.3,5637
751,1997,10,ASP (AVENAL SP),5655,0,5655,2320,243.8,5793
752,1997,11,VSP (VALLEY SP),3302,16,3318,1980,167.6,3090
753,1997,11,SCC (SIERRA CONSERVATION CENTER),335,0,335,320,104.7,320
754,1997,11,NCWF (NO CAL WOMEN'S FACIL),775,5,780,400,195.0,760
755,1997,11,CCWF (CENTRAL CA WOMEN'S FAC),3447,8,3455,2004,172.4,3274
756,1997,11,"CRC (CAL REHAB CTR, WOMEN)",351,525,876,500,175.2,842
757,1997,11,CIW (CA INSTITUTION FOR WOMEN),1796,19,1815,1026,176.9,1663
758,1997,11,WSP (WASCO SP),5884,31,5915,2984,198.2,6044
759,1997,11,SCC (SIERRA CONSERVATION CENTER),5856,0,5856,3606,162.4,5884
760,1997,11,SVSP (SALINAS VALLEY SP),4129,0,4129,2224,185.7,4046
761,1997,11,RJD (RJ DONOVAN CORRECTIONAL FAC),4646,0,4646,2200,211.2,4668
762,1997,11,PVSP (PLEASANT VALLEY SP),4576,0,4576,2208,207.2,4588
763,1997,11,PBSP (PELICAN BAY SP),3776,0,3776,2280,165.6,3711
764,1997,11,NKSP (NORTH KERN SP),5014,1,5015,2692,186.3,5104
765,1997,11,MCSP (MULE CREEK SP),3616,0,3616,1700,212.7,3562
766,1997,11,ISP (IRONWOOD SP),4542,1,4543,2200,206.5,4580
767,1997,11,HDSP (HIGH DESERT SP),4113,2,4115,2224,185.0,4166
768,1997,11,FOL (FOLSOM SP) (MALE),3838,0,3838,2071,185.3,3723
769,1997,11,DVI (DEUEL VOCATIONAL INSTITUTION),3605,43,3648,1787,204.1,3706
770,1997,11,CTF (CORRECTIONAL TRAINING FAC),7020,2,7022,3281,214.0,7061
771,1997,11,CVSP (CHUCKAWALLA VALLEY SP),3642,0,3642,1738,209.6,3679
772,1997,11,SATF (CA SUBSTANCE ABUSE TREAT FAC),1947,0,1947,500,389.4,500
773,1997,11,"SOL (CA SP, SOLANO)",5756,0,5756,2110,272.8,4777
774,1997,11,SQ (SAN QUENTIN SP),5818,23,5841,3183,183.5,5494
775,1997,11,"SAC (CA SP, SACRAMENTO)",3162,1,3163,1728,183.0,3204
776,1997,11,"LAC (CA SP, LOS ANGELES COUNTY)",4227,0,4227,2200,192.1,4120
777,1997,11,"COR (CA SP, CORCORAN)",5275,0,5275,2916,180.9,4963
778,1997,11,CEN (CENTINELA SP),4612,0,4612,2208,208.9,4588
779,1997,11,CAL (CALIPATRIA SP),3963,0,3963,2208,179.5,4108
780,1997,11,"CRC (CAL REHAB CTR, MEN)",2472,1631,4103,1814,226.2,4001
781,1997,11,CMC (CA MEN'S COLONY),6711,0,6711,3884,172.8,6474
782,1997,11,CMF (CA MEDICAL FAC),3161,0,3161,2315,136.5,3377
783,1997,11,CIM (CA INSTITUTION FOR MEN),6154,37,6191,3078,201.1,6318
784,1997,11,CCI (CA CORRECTIONAL INSTITUTION),5843,3,5846,2781,210.2,5992
785,1997,11,CCC (CA CORRECTIONAL CENTER),5900,0,5900,3682,160.2,5637
786,1997,11,ASP (AVENAL SP),5716,0,5716,2320,246.4,5793
787,1997,12,VSP (VALLEY SP),3287,15,3302,1980,166.8,3090
788,1997,12,SCC (SIERRA CONSERVATION CENTER),332,0,332,320,103.8,320
789,1997,12,NCWF (NO CAL WOMEN'S FACIL),796,2,798,400,199.5,760
790,1997,12,CCWF (CENTRAL CA WOMEN'S FAC),3339,5,3344,2004,166.9,3274
791,1997,12,"CRC (CAL REHAB CTR, WOMEN)",347,513,860,500,172.0,842
792,1997,12,CIW (CA INSTITUTION FOR WOMEN),1792,25,1817,1026,177.1,1663
793,1997,12,WSP (WASCO SP),5772,27,5799,2984,194.3,6044
794,1997,12,SCC (SIERRA CONSERVATION CENTER),5777,1,5778,3606,160.2,5884
795,1997,12,SVSP (SALINAS VALLEY SP),4090,0,4090,2224,183.9,4046
796,1997,12,RJD (RJ DONOVAN CORRECTIONAL FAC),4701,0,4701,2200,213.7,4668
797,1997,12,PVSP (PLEASANT VALLEY SP),4662,0,4662,2208,211.1,4588
798,1997,12,PBSP (PELICAN BAY SP),3765,0,3765,2280,165.1,3711
799,1997,12,NKSP (NORTH KERN SP),4869,1,4870,2692,180.9,5104
800,1997,12,MCSP (MULE CREEK SP),3467,0,3467,1700,203.9,3562
801,1997,12,ISP (IRONWOOD SP),4496,1,4497,2200,204.4,4580
802,1997,12,HDSP (HIGH DESERT SP),4014,5,4019,2224,180.7,4166
803,1997,12,FOL (FOLSOM SP) (MALE),3830,0,3830,2071,184.9,3723
804,1997,12,DVI (DEUEL VOCATIONAL INSTITUTION),3580,32,3612,1787,202.1,3706
805,1997,12,CTF (CORRECTIONAL TRAINING FAC),7047,0,7047,3281,214.8,7061
806,1997,12,CVSP (CHUCKAWALLA VALLEY SP),3673,0,3673,1738,211.3,3679
807,1997,12,SATF (CA SUBSTANCE ABUSE TREAT FAC),2527,0,2527,500,505.4,500
808,1997,12,"SOL (CA SP, SOLANO)",5720,0,5720,2110,271.1,4777
809,1997,12,SQ (SAN QUENTIN SP),5922,16,5938,3183,186.6,5494
810,1997,12,"SAC (CA SP, SACRAMENTO)",3262,0,3262,1728,188.8,3204
811,1997,12,"LAC (CA SP, LOS ANGELES COUNTY)",4213,0,4213,2200,191.5,4120
812,1997,12,"COR (CA SP, CORCORAN)",5114,0,5114,2916,175.4,4963
813,1997,12,CEN (CENTINELA SP),4618,0,4618,2208,209.1,4588
814,1997,12,CAL (CALIPATRIA SP),4040,0,4040,2208,183.0,4108
815,1997,12,"CRC (CAL REHAB CTR, MEN)",2554,1602,4156,1814,229.1,4001
816,1997,12,CMC (CA MEN'S COLONY),6616,0,6616,3884,170.3,6474
817,1997,12,CMF (CA MEDICAL FAC),3128,0,3128,2315,135.1,3377
818,1997,12,CIM (CA INSTITUTION FOR MEN),6274,29,6303,3078,204.8,6318
819,1997,12,CCI (CA CORRECTIONAL INSTITUTION),5905,1,5906,2781,212.4,5992
820,1997,12,CCC (CA CORRECTIONAL CENTER),5751,0,5751,3682,156.2,5637
821,1997,12,ASP (AVENAL SP),5696,0,5696,2320,245.5,5793
822,1998,1,VSP (VALLEY SP),3253,18,3271,1980,165.2,3510
823,1998,1,SCC (SIERRA CONSERVATION CENTER),333,0,333,320,104.1,320
824,1998,1,NCWF (NO CAL WOMEN'S FACIL),748,5,753,400,188.3,760
825,1998,1,CCWF (CENTRAL CA WOMEN'S FAC),3405,4,3409,2004,170.1,3526
826,1998,1,"CRC (CAL REHAB CTR, WOMEN)",353,496,849,500,169.8,842
827,1998,1,CIW (CA INSTITUTION FOR WOMEN),1810,21,1831,1026,178.5,1747
828,1998,1,WSP (WASCO SP),5982,34,6016,2984,201.6,5812
829,1998,1,SCC (SIERRA CONSERVATION CENTER),5557,0,5557,3606,154.1,5884
830,1998,1,SVSP (SALINAS VALLEY SP),4074,0,4074,2224,183.2,4166
831,1998,1,RJD (RJ DONOVAN CORRECTIONAL FAC),4651,1,4652,2200,211.5,4698
832,1998,1,PVSP (PLEASANT VALLEY SP),4436,0,4436,2208,200.9,4588
833,1998,1,PBSP (PELICAN BAY SP),3702,0,3702,2280,162.4,3871
834,1998,1,NKSP (NORTH KERN SP),4989,2,4991,2692,185.4,4872
835,1998,1,MCSP (MULE CREEK SP),3548,0,3548,1700,208.7,3562
836,1998,1,ISP (IRONWOOD SP),4470,1,4471,2200,203.2,4460
837,1998,1,HDSP (HIGH DESERT SP),3935,8,3943,2224,177.3,4166
838,1998,1,FOL (FOLSOM SP) (MALE),3779,0,3779,2072,182.4,3725
839,1998,1,DVI (DEUEL VOCATIONAL INSTITUTION),3581,38,3619,1787,202.5,3706
840,1998,1,CTF (CORRECTIONAL TRAINING FAC),6695,1,6696,3281,204.1,7061
841,1998,1,CVSP (CHUCKAWALLA VALLEY SP),3583,0,3583,1738,206.2,3679
842,1998,1,SATF (CA SUBSTANCE ABUSE TREAT FAC),2932,0,2932,2434,120.5,2572
843,1998,1,"SOL (CA SP, SOLANO)",5668,0,5668,2610,217.2,5777
844,1998,1,SQ (SAN QUENTIN SP),5928,20,5948,3283,181.2,5667
845,1998,1,"SAC (CA SP, SACRAMENTO)",3233,0,3233,1728,187.1,3204
846,1998,1,"LAC (CA SP, LOS ANGELES COUNTY)",4168,0,4168,2200,189.5,4340
847,1998,1,"COR (CA SP, CORCORAN)",4928,0,4928,3016,163.4,5063
848,1998,1,CEN (CENTINELA SP),4441,0,4441,2208,201.1,4588
849,1998,1,CAL (CALIPATRIA SP),4071,0,4071,2208,184.4,4108
850,1998,1,"CRC (CAL REHAB CTR, MEN)",2621,1549,4170,1814,229.9,4001
851,1998,1,CMC (CA MEN'S COLONY),6596,0,6596,3884,169.8,6724
852,1998,1,CMF (CA MEDICAL FAC),3108,1,3109,2315,134.3,3377
853,1998,1,CIM (CA INSTITUTION FOR MEN),6457,38,6495,3078,211.0,6318
854,1998,1,CCI (CA CORRECTIONAL INSTITUTION),6002,0,6002,2781,215.8,5992
855,1998,1,CCC (CA CORRECTIONAL CENTER),5873,1,5874,3682,159.5,5657
856,1998,1,ASP (AVENAL SP),5614,0,5614,2320,242.0,5793
857,1998,2,VSP (VALLEY SP),3189,13,3202,1980,161.7,3330
858,1998,2,SCC (SIERRA CONSERVATION CENTER),339,0,339,320,105.9,320
859,1998,2,NCWF (NO CAL WOMEN'S FACIL),781,3,784,400,196.0,760
860,1998,2,CCWF (CENTRAL CA WOMEN'S FAC),3513,4,3517,2004,175.5,3526
861,1998,2,"CRC (CAL REHAB CTR, WOMEN)",392,506,898,500,179.6,842
862,1998,2,CIW (CA INSTITUTION FOR WOMEN),1718,27,1745,1026,170.1,1747
863,1998,2,WSP (WASCO SP),5527,36,5563,2984,186.4,5812
864,1998,2,SCC (SIERRA CONSERVATION CENTER),6064,0,6064,3606,168.2,5884
865,1998,2,SVSP (SALINAS VALLEY SP),3998,0,3998,2224,179.8,4046
866,1998,2,RJD (RJ DONOVAN CORRECTIONAL FAC),4667,0,4667,2200,212.1,4698
867,1998,2,PVSP (PLEASANT VALLEY SP),4526,0,4526,2208,205.0,4468
868,1998,2,PBSP (PELICAN BAY SP),3603,0,3603,2280,158.0,3871
869,1998,2,NKSP (NORTH KERN SP),5120,4,5124,2692,190.3,5104
870,1998,2,MCSP (MULE CREEK SP),3472,0,3472,1700,204.2,3562
871,1998,2,ISP (IRONWOOD SP),4299,1,4300,2200,195.5,4460
872,1998,2,HDSP (HIGH DESERT SP),3926,4,3930,2224,176.7,4046
873,1998,2,FOL (FOLSOM SP) (MALE),3726,0,3726,2072,179.8,3725
874,1998,2,DVI (DEUEL VOCATIONAL INSTITUTION),3605,27,3632,1787,203.2,3706
875,1998,2,CTF (CORRECTIONAL TRAINING FAC),6878,0,6878,3281,209.6,7061
876,1998,2,CVSP (CHUCKAWALLA VALLEY SP),3630,0,3630,1738,208.9,3679
877,1998,2,SATF (CA SUBSTANCE ABUSE TREAT FAC),3579,0,3579,2434,147.0,2572
878,1998,2,"SOL (CA SP, SOLANO)",5330,1,5331,2610,204.3,5552
879,1998,2,SQ (SAN QUENTIN SP),5884,12,5896,3283,179.6,5667
880,1998,2,"SAC (CA SP, SACRAMENTO)",3165,0,3165,1728,183.2,3204
881,1998,2,"LAC (CA SP, LOS ANGELES COUNTY)",4139,0,4139,2200,188.1,4100
882,1998,2,"COR (CA SP, CORCORAN)",4862,0,4862,3016,161.2,5063
883,1998,2,CEN (CENTINELA SP),4376,0,4376,2208,198.2,4468
884,1998,2,CAL (CALIPATRIA SP),4025,0,4025,2208,182.3,4108
885,1998,2,"CRC (CAL REHAB CTR, MEN)",2533,1550,4083,1814,225.1,4001
886,1998,2,CMC (CA MEN'S COLONY),6621,0,6621,3884,170.5,6724
887,1998,2,CMF (CA MEDICAL FAC),3072,1,3073,2315,132.7,3377
888,1998,2,CIM (CA INSTITUTION FOR MEN),6249,44,6293,3078,204.5,6318
889,1998,2,CCI (CA CORRECTIONAL INSTITUTION),5934,0,5934,2781,213.4,5992
890,1998,2,CCC (CA CORRECTIONAL CENTER),5674,0,5674,3682,154.1,5657
891,1998,2,ASP (AVENAL SP),5762,0,5762,2320,248.4,5793
892,1998,3,VSP (VALLEY SP),3220,13,3233,1980,163.3,3330
893,1998,3,SCC (SIERRA CONSERVATION CENTER),334,0,334,320,104.4,320
894,1998,3,NCWF (NO CAL WOMEN'S FACIL),753,7,760,400,190.0,760
895,1998,3,CCWF (CENTRAL CA WOMEN'S FAC),3554,2,3556,2004,177.4,3526
896,1998,3,"CRC (CAL REHAB CTR, WOMEN)",375,482,857,500,171.4,842
897,1998,3,CIW (CA INSTITUTION FOR WOMEN),1696,29,1725,1026,168.1,1747
898,1998,3,WSP (WASCO SP),5807,19,5826,2984,195.2,5812
899,1998,3,SCC (SIERRA CONSERVATION CENTER),5863,0,5863,3606,162.6,5884
900,1998,3,SVSP (SALINAS VALLEY SP),4125,0,4125,2224,185.5,4046
901,1998,3,RJD (RJ DONOVAN CORRECTIONAL FAC),4648,0,4648,2200,211.3,4698
902,1998,3,PVSP (PLEASANT VALLEY SP),4601,0,4601,2208,208.4,4468
903,1998,3,PBSP (PELICAN BAY SP),3552,0,3552,2280,155.8,3871
904,1998,3,NKSP (NORTH KERN SP),5170,1,5171,2692,192.1,5104
905,1998,3,MCSP (MULE CREEK SP),3601,0,3601,1700,211.8,3562
906,1998,3,ISP (IRONWOOD SP),4273,0,4273,2200,194.2,4460
907,1998,3,HDSP (HIGH DESERT SP),3960,4,3964,2224,178.2,4046
908,1998,3,FOL (FOLSOM SP) (MALE),3843,0,3843,2072,185.5,3725
909,1998,3,DVI (DEUEL VOCATIONAL INSTITUTION),3521,24,3545,1787,198.4,3706
910,1998,3,CTF (CORRECTIONAL TRAINING FAC),7076,0,7076,3281,215.7,6941
911,1998,3,CVSP (CHUCKAWALLA VALLEY SP),3546,0,3546,1738,204.0,3679
912,1998,3,SATF (CA SUBSTANCE ABUSE TREAT FAC),3690,0,3690,3324,111.0,4022
913,1998,3,"SOL (CA SP, SOLANO)",5496,1,5497,2610,210.6,5552
914,1998,3,SQ (SAN QUENTIN SP),5795,25,5820,3283,177.3,5667
915,1998,3,"SAC (CA SP, SACRAMENTO)",3225,4,3229,1728,186.9,3204
916,1998,3,"LAC (CA SP, LOS ANGELES COUNTY)",4158,0,4158,2200,189.0,4100
917,1998,3,"COR (CA SP, CORCORAN)",4755,0,4755,3016,157.7,5063
918,1998,3,CEN (CENTINELA SP),4277,0,4277,2208,193.7,4468
919,1998,3,CAL (CALIPATRIA SP),4109,0,4109,2208,186.1,4108
920,1998,3,"CRC (CAL REHAB CTR, MEN)",2482,1510,3992,1814,220.1,3952
921,1998,3,CMC (CA MEN'S COLONY),6638,0,6638,3884,170.9,6724
922,1998,3,CMF (CA MEDICAL FAC),3035,0,3035,2315,131.1,3377
923,1998,3,CIM (CA INSTITUTION FOR MEN),6263,50,6313,3078,205.1,6318
924,1998,3,CCI (CA CORRECTIONAL INSTITUTION),5943,1,5944,2781,213.7,5992
925,1998,3,CCC (CA CORRECTIONAL CENTER),5706,0,5706,3682,155.0,5657
926,1998,3,ASP (AVENAL SP),5757,0,5757,2320,248.1,5793
927,1998,4,VSP (VALLEY SP),3244,25,3269,1980,165.1,3330
928,1998,4,SCC (SIERRA CONSERVATION CENTER),319,0,319,320,99.7,320
929,1998,4,NCWF (NO CAL WOMEN'S FACIL),758,5,763,400,190.8,760
930,1998,4,CCWF (CENTRAL CA WOMEN'S FAC),3651,3,3654,2004,182.3,3526
931,1998,4,"CRC (CAL REHAB CTR, WOMEN)",309,479,788,500,157.6,842
932,1998,4,CIW (CA INSTITUTION FOR WOMEN),1772,27,1799,1026,175.3,1747
933,1998,4,WSP (WASCO SP),5785,36,5821,2984,195.1,5812
934,1998,4,SCC (SIERRA CONSERVATION CENTER),5994,0,5994,3606,166.2,5884
935,1998,4,SVSP (SALINAS VALLEY SP),4161,0,4161,2224,187.1,4046
936,1998,4,RJD (RJ DONOVAN CORRECTIONAL FAC),4664,0,4664,2200,212.0,4698
937,1998,4,PVSP (PLEASANT VALLEY SP),4477,0,4477,2208,202.8,4468
938,1998,4,PBSP (PELICAN BAY SP),3541,0,3541,2280,155.3,3871
939,1998,4,NKSP (NORTH KERN SP),4799,0,4799,2692,178.3,5104
940,1998,4,MCSP (MULE CREEK SP),3598,0,3598,1700,211.6,3562
941,1998,4,ISP (IRONWOOD SP),4315,0,4315,2200,196.1,4460
942,1998,4,HDSP (HIGH DESERT SP),3974,7,3981,2224,179.0,4046
943,1998,4,FOL (FOLSOM SP) (MALE),3832,0,3832,2072,184.9,3725
944,1998,4,DVI (DEUEL VOCATIONAL INSTITUTION),3665,16,3681,1787,206.0,3706
945,1998,4,CTF (CORRECTIONAL TRAINING FAC),7064,0,7064,3281,215.3,6941
946,1998,4,CVSP (CHUCKAWALLA VALLEY SP),3638,0,3638,1738,209.3,3679
947,1998,4,SATF (CA SUBSTANCE ABUSE TREAT FAC),4410,0,4410,3324,132.7,4022
948,1998,4,"SOL (CA SP, SOLANO)",5488,1,5489,2610,210.3,5552
949,1998,4,SQ (SAN QUENTIN SP),5772,13,5785,3283,176.2,5667
950,1998,4,"SAC (CA SP, SACRAMENTO)",3152,0,3152,1728,182.4,3204
951,1998,4,"LAC (CA SP, LOS ANGELES COUNTY)",4142,0,4142,2200,188.3,4100
952,1998,4,"COR (CA SP, CORCORAN)",4824,0,4824,3016,159.9,5063
953,1998,4,CEN (CENTINELA SP),4491,0,4491,2208,203.4,4468
954,1998,4,CAL (CALIPATRIA SP),3973,0,3973,2208,179.9,4108
955,1998,4,"CRC (CAL REHAB CTR, MEN)",2558,1500,4058,1814,223.7,3952
956,1998,4,CMC (CA MEN'S COLONY),6598,1,6599,3884,169.9,6724
957,1998,4,CMF (CA MEDICAL FAC),3133,0,3133,2315,135.3,3377
958,1998,4,CIM (CA INSTITUTION FOR MEN),6222,44,6266,3078,203.6,6318
959,1998,4,CCI (CA CORRECTIONAL INSTITUTION),5843,0,5843,2781,210.1,5992
960,1998,4,CCC (CA CORRECTIONAL CENTER),5840,0,5840,3682,158.6,5657
961,1998,4,ASP (AVENAL SP),5730,0,5730,2320,247.0,5793
962,1998,5,VSP (VALLEY SP),3287,23,3310,1980,167.2,3330
963,1998,5,SCC (SIERRA CONSERVATION CENTER),333,0,333,320,104.1,320
964,1998,5,NCWF (NO CAL WOMEN'S FACIL),773,5,778,400,194.5,760
965,1998,5,CCWF (CENTRAL CA WOMEN'S FAC),3575,4,3579,2004,178.6,3526
966,1998,5,"CRC (CAL REHAB CTR, WOMEN)",328,491,819,500,163.8,842
967,1998,5,CIW (CA INSTITUTION FOR WOMEN),1784,23,1807,1026,176.1,1747
968,1998,5,WSP (WASCO SP),5930,20,5950,2984,199.4,5812
969,1998,5,SCC (SIERRA CONSERVATION CENTER),5978,1,5979,3606,165.8,5884
970,1998,5,SVSP (SALINAS VALLEY SP),4034,0,4034,2224,181.4,4046
971,1998,5,RJD (RJ DONOVAN CORRECTIONAL FAC),4690,0,4690,2200,213.2,4698
972,1998,5,PVSP (PLEASANT VALLEY SP),4389,0,4389,2208,198.8,4468
973,1998,5,PBSP (PELICAN BAY SP),3528,0,3528,2280,154.7,3871
974,1998,5,NKSP (NORTH KERN SP),4857,0,4857,2692,180.4,5104
975,1998,5,MCSP (MULE CREEK SP),3478,0,3478,1700,204.6,3562
976,1998,5,ISP (IRONWOOD SP),4249,0,4249,2200,193.1,4460
977,1998,5,HDSP (HIGH DESERT SP),3900,2,3902,2224,175.4,4046
978,1998,5,FOL (FOLSOM SP) (MALE),3852,0,3852,2072,185.9,3725
979,1998,5,DVI (DEUEL VOCATIONAL INSTITUTION),3560,25,3585,1787,200.6,3706
980,1998,5,CTF (CORRECTIONAL TRAINING FAC),7082,0,7082,3281,215.8,6941
981,1998,5,CVSP (CHUCKAWALLA VALLEY SP),3564,0,3564,1738,205.1,3679
982,1998,5,SATF (CA SUBSTANCE ABUSE TREAT FAC),4893,0,4893,3324,147.2,4022
983,1998,5,"SOL (CA SP, SOLANO)",5551,1,5552,2610,212.7,5552
984,1998,5,SQ (SAN QUENTIN SP),5813,13,5826,3283,177.5,5667
985,1998,5,"SAC (CA SP, SACRAMENTO)",3190,0,3190,1728,184.6,3204
986,1998,5,"LAC (CA SP, LOS ANGELES COUNTY)",4014,0,4014,2200,182.5,4100
987,1998,5,"COR (CA SP, CORCORAN)",4932,0,4932,3016,163.5,5063
988,1998,5,CEN (CENTINELA SP),4443,0,4443,2208,201.2,4468
989,1998,5,CAL (CALIPATRIA SP),3976,0,3976,2208,180.1,4108
990,1998,5,"CRC (CAL REHAB CTR, MEN)",2541,1493,4034,1814,222.4,3952
991,1998,5,CMC (CA MEN'S COLONY),6563,0,6563,3884,169.0,6724
992,1998,5,CMF (CA MEDICAL FAC),3089,0,3089,2315,133.4,3377
993,1998,5,CIM (CA INSTITUTION FOR MEN),6113,42,6155,3078,200.0,6318
994,1998,5,CCI (CA CORRECTIONAL INSTITUTION),5920,0,5920,2781,212.9,5992
995,1998,5,CCC (CA CORRECTIONAL CENTER),5878,0,5878,3682,159.6,5657
996,1998,5,ASP (AVENAL SP),5746,0,5746,2320,247.7,5793
997,1998,6,VSP (VALLEY SP),3297,21,3318,1980,167.6,3330
998,1998,6,SCC (SIERRA CONSERVATION CENTER),338,0,338,320,105.6,320
999,1998,6,NCWF (NO CAL WOMEN'S FACIL),784,3,787,400,196.8,760
1000,1998,6,CCWF (CENTRAL CA WOMEN'S FAC),3649,7,3656,2004,182.4,3526
1001,1998,6,"CRC (CAL REHAB CTR, WOMEN)",352,508,860,500,172.0,842
1002,1998,6,CIW (CA INSTITUTION FOR WOMEN),1761,23,1784,1026,173.9,1747
1003,1998,6,WSP (WASCO SP),5565,32,5597,2984,187.6,5812
1004,1998,6,SCC (SIERRA CONSERVATION CENTER),5959,1,5960,3606,165.3,5884
1005,1998,6,SVSP (SALINAS VALLEY SP),4108,0,4108,2224,184.7,4046
1006,1998,6,RJD (RJ DONOVAN CORRECTIONAL FAC),4716,0,4716,2200,214.4,4698
1007,1998,6,PVSP (PLEASANT VALLEY SP),4459,0,4459,2208,201.9,4348
1008,1998,6,PBSP (PELICAN BAY SP),3495,0,3495,2280,153.3,3711
1009,1998,6,NKSP (NORTH KERN SP),4781,1,4782,2692,177.6,5104
1010,1998,6,MCSP (MULE CREEK SP),3554,0,3554,1700,209.1,3562
1011,1998,6,ISP (IRONWOOD SP),4287,0,4287,2200,194.9,4340
1012,1998,6,HDSP (HIGH DESERT SP),3997,1,3998,2224,179.8,4046
1013,1998,6,FOL (FOLSOM SP) (MALE),3856,0,3856,2072,186.1,3725
1014,1998,6,DVI (DEUEL VOCATIONAL INSTITUTION),3411,19,3430,1787,191.9,3606
1015,1998,6,CTF (CORRECTIONAL TRAINING FAC),7135,0,7135,3281,217.5,6941
1016,1998,6,CVSP (CHUCKAWALLA VALLEY SP),3615,0,3615,1738,208.0,3679
1017,1998,6,SATF (CA SUBSTANCE ABUSE TREAT FAC),5232,3,5235,3324,157.5,4883
1018,1998,6,"SOL (CA SP, SOLANO)",5536,1,5537,2610,212.1,5552
1019,1998,6,SQ (SAN QUENTIN SP),5862,12,5874,3283,178.9,5667
1020,1998,6,"SAC (CA SP, SACRAMENTO)",3184,3,3187,1728,184.4,3204
1021,1998,6,"LAC (CA SP, LOS ANGELES COUNTY)",4030,0,4030,2200,183.2,4100
1022,1998,6,"COR (CA SP, CORCORAN)",5050,0,5050,3016,167.4,5063
1023,1998,6,CEN (CENTINELA SP),4371,0,4371,2208,198.0,4468
1024,1998,6,CAL (CALIPATRIA SP),4097,0,4097,2208,185.6,4108
1025,1998,6,"CRC (CAL REHAB CTR, MEN)",2503,1437,3940,1814,217.2,3906
1026,1998,6,CMC (CA MEN'S COLONY),6734,0,6734,3884,173.4,6724
1027,1998,6,CMF (CA MEDICAL FAC),3130,0,3130,2315,135.2,3377
1028,1998,6,CIM (CA INSTITUTION FOR MEN),6255,34,6289,3078,204.3,6318
1029,1998,6,CCI (CA CORRECTIONAL INSTITUTION),5889,0,5889,2781,211.8,5992
1030,1998,6,CCC (CA CORRECTIONAL CENTER),5981,0,5981,3682,162.4,5657
1031,1998,6,ASP (AVENAL SP),5738,0,5738,2320,247.3,5793
1032,1998,7,VSP (VALLEY SP),3466,12,3478,1980,175.7,3330
1033,1998,7,SCC (SIERRA CONSERVATION CENTER),338,0,338,320,105.6,320
1034,1998,7,NCWF (NO CAL WOMEN'S FACIL),771,6,777,400,194.3,760
1035,1998,7,CCWF (CENTRAL CA WOMEN'S FAC),3699,3,3702,2004,184.7,3526
1036,1998,7,"CRC (CAL REHAB CTR, WOMEN)",363,526,889,500,177.8,842
1037,1998,7,CIW (CA INSTITUTION FOR WOMEN),1832,20,1852,1026,180.5,1747
1038,1998,7,WSP (WASCO SP),5395,35,5430,2984,182.0,5812
1039,1998,7,SCC (SIERRA CONSERVATION CENTER),5780,1,5781,3606,160.3,5884
1040,1998,7,SVSP (SALINAS VALLEY SP),4118,0,4118,2224,185.2,4046
1041,1998,7,RJD (RJ DONOVAN CORRECTIONAL FAC),4688,1,4689,2200,213.1,4698
1042,1998,7,PVSP (PLEASANT VALLEY SP),4384,0,4384,2208,198.6,4348
1043,1998,7,PBSP (PELICAN BAY SP),3519,1,3520,2280,154.4,3711
1044,1998,7,NKSP (NORTH KERN SP),4701,3,4704,2692,174.7,5104
1045,1998,7,MCSP (MULE CREEK SP),3664,0,3664,1700,215.5,3562
1046,1998,7,ISP (IRONWOOD SP),4312,0,4312,2200,196.0,4340
1047,1998,7,HDSP (HIGH DESERT SP),3931,1,3932,2224,176.8,4046
1048,1998,7,FOL (FOLSOM SP) (MALE),3831,0,3831,2072,184.9,3725
1049,1998,7,DVI (DEUEL VOCATIONAL INSTITUTION),3626,39,3665,1787,205.1,3606
1050,1998,7,CTF (CORRECTIONAL TRAINING FAC),7161,0,7161,3281,218.3,6941
1051,1998,7,CVSP (CHUCKAWALLA VALLEY SP),3632,0,3632,1738,209.0,3679
1052,1998,7,SATF (CA SUBSTANCE ABUSE TREAT FAC),6227,4,6231,3324,187.5,4883
1053,1998,7,"SOL (CA SP, SOLANO)",5544,1,5545,2610,212.5,5552
1054,1998,7,SQ (SAN QUENTIN SP),5809,20,5829,3283,177.6,5667
1055,1998,7,"SAC (CA SP, SACRAMENTO)",3193,0,3193,1728,184.8,3204
1056,1998,7,"LAC (CA SP, LOS ANGELES COUNTY)",4098,0,4098,2200,186.3,4100
1057,1998,7,"COR (CA SP, CORCORAN)",4890,0,4890,3016,162.1,5063
1058,1998,7,CEN (CENTINELA SP),4406,1,4407,2208,199.6,4468
1059,1998,7,CAL (CALIPATRIA SP),4061,0,4061,2208,183.9,4108
1060,1998,7,"CRC (CAL REHAB CTR, MEN)",2570,1400,3970,1814,218.9,3906
1061,1998,7,CMC (CA MEN'S COLONY),6661,0,6661,3884,171.5,6724
1062,1998,7,CMF (CA MEDICAL FAC),3217,0,3217,2315,139.0,3377
1063,1998,7,CIM (CA INSTITUTION FOR MEN),6443,32,6475,3078,210.4,6318
1064,1998,7,CCI (CA CORRECTIONAL INSTITUTION),5956,1,5957,2781,214.2,5992
1065,1998,7,CCC (CA CORRECTIONAL CENTER),5977,0,5977,3682,162.3,5657
1066,1998,7,ASP (AVENAL SP),5738,0,5738,2320,247.3,5793
1067,1998,8,VSP (VALLEY SP),3540,16,3556,1980,179.6,3330
1068,1998,8,SCC (SIERRA CONSERVATION CENTER),336,0,336,320,105.0,320
1069,1998,8,NCWF (NO CAL WOMEN'S FACIL),752,5,757,400,189.3,760
1070,1998,8,CCWF (CENTRAL CA WOMEN'S FAC),3739,2,3741,2004,186.7,3526
1071,1998,8,"CRC (CAL REHAB CTR, WOMEN)",340,544,884,500,176.8,842
1072,1998,8,CIW (CA INSTITUTION FOR WOMEN),1767,14,1781,1026,173.6,1747
1073,1998,8,WSP (WASCO SP),5579,32,5611,2984,188.0,5812
1074,1998,8,SCC (SIERRA CONSERVATION CENTER),6019,1,6020,3606,166.9,5884
1075,1998,8,SVSP (SALINAS VALLEY SP),4102,0,4102,2224,184.4,4046
1076,1998,8,RJD (RJ DONOVAN CORRECTIONAL FAC),4630,1,4631,2200,210.5,4698
1077,1998,8,PVSP (PLEASANT VALLEY SP),4467,0,4467,2208,202.3,4348
1078,1998,8,PBSP (PELICAN BAY SP),3531,2,3533,2280,155.0,3711
1079,1998,8,NKSP (NORTH KERN SP),4580,3,4583,2692,170.2,5104
1080,1998,8,MCSP (MULE CREEK SP),3591,0,3591,1700,211.2,3562
1081,1998,8,ISP (IRONWOOD SP),4403,0,4403,2200,200.1,4340
1082,1998,8,HDSP (HIGH DESERT SP),4058,3,4061,2224,182.6,4046
1083,1998,8,FOL (FOLSOM SP) (MALE),3859,0,3859,2072,186.2,3725
1084,1998,8,DVI (DEUEL VOCATIONAL INSTITUTION),3556,16,3572,1787,199.9,3606
1085,1998,8,CTF (CORRECTIONAL TRAINING FAC),7149,0,7149,3281,217.9,6941
1086,1998,8,CVSP (CHUCKAWALLA VALLEY SP),3614,0,3614,1738,207.9,3679
1087,1998,8,SATF (CA SUBSTANCE ABUSE TREAT FAC),6018,4,6022,3324,181.2,5295
1088,1998,8,"SOL (CA SP, SOLANO)",5664,1,5665,2610,217.0,5552
1089,1998,8,SQ (SAN QUENTIN SP),5969,22,5991,3283,182.5,5667
1090,1998,8,"SAC (CA SP, SACRAMENTO)",3182,0,3182,1728,184.1,3204
1091,1998,8,"LAC (CA SP, LOS ANGELES COUNTY)",4205,0,4205,2200,191.1,4100
1092,1998,8,"COR (CA SP, CORCORAN)",4801,0,4801,3016,159.2,5063
1093,1998,8,CEN (CENTINELA SP),4520,0,4520,2208,204.7,4468
1094,1998,8,CAL (CALIPATRIA SP),4060,0,4060,2208,183.9,4108
1095,1998,8,"CRC (CAL REHAB CTR, MEN)",2571,1397,3968,1814,218.7,3906
1096,1998,8,CMC (CA MEN'S COLONY),6689,0,6689,3884,172.2,6724
1097,1998,8,CMF (CA MEDICAL FAC),3057,0,3057,2315,132.1,3377
1098,1998,8,CIM (CA INSTITUTION FOR MEN),6142,30,6172,3078,200.5,6318
1099,1998,8,CCI (CA CORRECTIONAL INSTITUTION),5993,1,5994,2781,215.5,5992
1100,1998,8,CCC (CA CORRECTIONAL CENTER),5944,0,5944,3682,161.4,5657
1101,1998,8,ASP (AVENAL SP),5736,0,5736,2320,247.2,5793
1102,1998,9,VSP (VALLEY SP),3717,12,3729,1980,188.3,3330
1103,1998,9,SCC (SIERRA CONSERVATION CENTER),328,0,328,320,102.5,320
1104,1998,9,NCWF (NO CAL WOMEN'S FACIL),783,3,786,400,196.5,760
1105,1998,9,CCWF (CENTRAL CA WOMEN'S FAC),3660,3,3663,2004,182.8,3526
1106,1998,9,"CRC (CAL REHAB CTR, WOMEN)",330,543,873,500,174.6,842
1107,1998,9,CIW (CA INSTITUTION FOR WOMEN),1747,16,1763,1026,171.8,1747
1108,1998,9,WSP (WASCO SP),5513,29,5542,2984,185.7,5812
1109,1998,9,SCC (SIERRA CONSERVATION CENTER),5957,1,5958,3606,165.2,5884
1110,1998,9,SVSP (SALINAS VALLEY SP),4198,0,4198,2224,188.8,4046
1111,1998,9,RJD (RJ DONOVAN CORRECTIONAL FAC),4687,1,4688,2200,213.1,4698
1112,1998,9,PVSP (PLEASANT VALLEY SP),4626,0,4626,2208,209.5,4348
1113,1998,9,PBSP (PELICAN BAY SP),3451,2,3453,2280,151.4,3711
1114,1998,9,NKSP (NORTH KERN SP),4608,3,4611,2692,171.3,5104
1115,1998,9,MCSP (MULE CREEK SP),3526,0,3526,1700,207.4,3562
1116,1998,9,ISP (IRONWOOD SP),4249,0,4249,2200,193.1,4340
1117,1998,9,HDSP (HIGH DESERT SP),4118,1,4119,2224,185.2,4046
1118,1998,9,FOL (FOLSOM SP) (MALE),3772,0,3772,2072,182.0,3725
1119,1998,9,DVI (DEUEL VOCATIONAL INSTITUTION),3686,15,3701,1787,207.1,3606
1120,1998,9,CTF (CORRECTIONAL TRAINING FAC),7196,9,7205,3281,219.6,6941
1121,1998,9,CVSP (CHUCKAWALLA VALLEY SP),3604,0,3604,1738,207.4,3679
1122,1998,9,SATF (CA SUBSTANCE ABUSE TREAT FAC),6219,3,6222,3324,187.2,5295
1123,1998,9,"SOL (CA SP, SOLANO)",5734,1,5735,2610,219.7,5552
1124,1998,9,SQ (SAN QUENTIN SP),5939,18,5957,3283,181.4,5667
1125,1998,9,"SAC (CA SP, SACRAMENTO)",3166,0,3166,1728,183.2,3204
1126,1998,9,"LAC (CA SP, LOS ANGELES COUNTY)",4204,0,4204,2200,191.1,4100
1127,1998,9,"COR (CA SP, CORCORAN)",5011,0,5011,3016,166.1,5063
1128,1998,9,CEN (CENTINELA SP),4403,0,4403,2208,199.4,4468
1129,1998,9,CAL (CALIPATRIA SP),3965,0,3965,2208,179.6,4108
1130,1998,9,"CRC (CAL REHAB CTR, MEN)",2694,1374,4068,1814,224.3,3906
1131,1998,9,CMC (CA MEN'S COLONY),6669,1,6670,3884,171.7,6724
1132,1998,9,CMF (CA MEDICAL FAC),3076,0,3076,2315,132.9,3377
1133,1998,9,CIM (CA INSTITUTION FOR MEN),6156,32,6188,3078,201.0,6318
1134,1998,9,CCI (CA CORRECTIONAL INSTITUTION),5924,2,5926,2781,213.1,5992
1135,1998,9,CCC (CA CORRECTIONAL CENTER),5874,0,5874,3682,159.5,5657
1136,1998,9,ASP (AVENAL SP),5718,0,5718,2320,246.5,5793
1137,1998,10,VSP (VALLEY SP),3728,13,3741,1980,188.9,3330
1138,1998,10,SCC (SIERRA CONSERVATION CENTER),335,0,335,320,104.7,320
1139,1998,10,NCWF (NO CAL WOMEN'S FACIL),751,4,755,400,188.8,760
1140,1998,10,CCWF (CENTRAL CA WOMEN'S FAC),3668,4,3672,2004,183.2,3526
1141,1998,10,"CRC (CAL REHAB CTR, WOMEN)",313,540,853,500,170.6,842
1142,1998,10,CIW (CA INSTITUTION FOR WOMEN),1780,13,1793,1026,174.8,1747
1143,1998,10,WSP (WASCO SP),5570,37,5607,2984,187.9,5812
1144,1998,10,SCC (SIERRA CONSERVATION CENTER),5997,1,5998,3606,166.3,5884
1145,1998,10,SVSP (SALINAS VALLEY SP),4257,0,4257,2224,191.4,4046
1146,1998,10,RJD (RJ DONOVAN CORRECTIONAL FAC),4747,1,4748,2200,215.8,4698
1147,1998,10,PVSP (PLEASANT VALLEY SP),4597,0,4597,2208,208.2,4348
1148,1998,10,PBSP (PELICAN BAY SP),3395,1,3396,2280,148.9,3711
1149,1998,10,NKSP (NORTH KERN SP),4921,2,4923,2692,182.9,5104
1150,1998,10,MCSP (MULE CREEK SP),3562,0,3562,1700,209.5,3562
1151,1998,10,ISP (IRONWOOD SP),4403,0,4403,2200,200.1,4340
1152,1998,10,HDSP (HIGH DESERT SP),4194,0,4194,2224,188.6,4046
1153,1998,10,FOL (FOLSOM SP) (MALE),3827,0,3827,2072,184.7,3725
1154,1998,10,DVI (DEUEL VOCATIONAL INSTITUTION),3782,21,3803,1787,212.8,3606
1155,1998,10,CTF (CORRECTIONAL TRAINING FAC),7286,0,7286,3281,222.1,6941
1156,1998,10,CVSP (CHUCKAWALLA VALLEY SP),3643,0,3643,1738,209.6,3679
1157,1998,10,SATF (CA SUBSTANCE ABUSE TREAT FAC),6024,3,6027,3324,181.3,5295
1158,1998,10,"SOL (CA SP, SOLANO)",5745,1,5746,2610,220.2,5552
1159,1998,10,SQ (SAN QUENTIN SP),5838,14,5852,3283,178.3,5667
1160,1998,10,"SAC (CA SP, SACRAMENTO)",3028,0,3028,1728,175.2,3204
1161,1998,10,"LAC (CA SP, LOS ANGELES COUNTY)",4211,0,4211,2200,191.4,4100
1162,1998,10,"COR (CA SP, CORCORAN)",4886,0,4886,3016,162.0,5063
1163,1998,10,CEN (CENTINELA SP),4547,0,4547,2208,205.9,4468
1164,1998,10,CAL (CALIPATRIA SP),3976,0,3976,2208,180.1,4108
1165,1998,10,"CRC (CAL REHAB CTR, MEN)",2691,1357,4048,1814,223.2,3906
1166,1998,10,CMC (CA MEN'S COLONY),6633,0,6633,3884,170.8,6724
1167,1998,10,CMF (CA MEDICAL FAC),3106,0,3106,2315,134.2,3377
1168,1998,10,CIM (CA INSTITUTION FOR MEN),6291,32,6323,3078,205.4,6318
1169,1998,10,CCI (CA CORRECTIONAL INSTITUTION),5904,1,5905,2781,212.3,5992
1170,1998,10,CCC (CA CORRECTIONAL CENTER),5838,0,5838,3682,158.6,5657
1171,1998,10,ASP (AVENAL SP),5757,0,5757,2320,248.1,5793
1172,1998,11,VSP (VALLEY SP),3726,10,3736,1980,188.7,3330
1173,1998,11,SCC (SIERRA CONSERVATION CENTER),329,0,329,320,102.8,320
1174,1998,11,NCWF (NO CAL WOMEN'S FACIL),768,5,773,400,193.3,760
1175,1998,11,CCWF (CENTRAL CA WOMEN'S FAC),3630,4,3634,2004,181.3,3526
1176,1998,11,"CRC (CAL REHAB CTR, WOMEN)",313,563,876,500,175.2,842
1177,1998,11,CIW (CA INSTITUTION FOR WOMEN),1702,16,1718,1026,167.4,1747
1178,1998,11,WSP (WASCO SP),5882,39,5921,2984,198.4,5812
1179,1998,11,SCC (SIERRA CONSERVATION CENTER),5850,1,5851,3606,162.3,5884
1180,1998,11,SVSP (SALINAS VALLEY SP),4206,0,4206,2224,189.1,4046
1181,1998,11,RJD (RJ DONOVAN CORRECTIONAL FAC),4637,1,4638,2200,210.8,4698
1182,1998,11,PVSP (PLEASANT VALLEY SP),4643,0,4643,2208,210.3,4348
1183,1998,11,PBSP (PELICAN BAY SP),3399,0,3399,2280,149.1,3711
1184,1998,11,NKSP (NORTH KERN SP),4919,1,4920,2692,182.8,5104
1185,1998,11,MCSP (MULE CREEK SP),3535,0,3535,1700,207.9,3562
1186,1998,11,ISP (IRONWOOD SP),4351,0,4351,2200,197.8,4340
1187,1998,11,HDSP (HIGH DESERT SP),4158,3,4161,2224,187.1,4166
1188,1998,11,FOL (FOLSOM SP) (MALE),3828,0,3828,2072,184.7,3725
1189,1998,11,DVI (DEUEL VOCATIONAL INSTITUTION),3673,21,3694,1787,206.7,3706
1190,1998,11,CTF (CORRECTIONAL TRAINING FAC),7074,0,7074,3281,215.6,7161
1191,1998,11,CVSP (CHUCKAWALLA VALLEY SP),3611,0,3611,1738,207.8,3679
1192,1998,11,SATF (CA SUBSTANCE ABUSE TREAT FAC),5872,3,5875,3324,176.7,5295
1193,1998,11,"SOL (CA SP, SOLANO)",5685,1,5686,2610,217.9,5777
1194,1998,11,SQ (SAN QUENTIN SP),5896,15,5911,3281,180.2,5679
1195,1998,11,"SAC (CA SP, SACRAMENTO)",3131,0,3131,1728,181.2,3204
1196,1998,11,"LAC (CA SP, LOS ANGELES COUNTY)",4229,0,4229,2200,192.2,4100
1197,1998,11,"COR (CA SP, CORCORAN)",4808,1,4809,3016,159.4,5062
1198,1998,11,CEN (CENTINELA SP),4385,0,4385,2208,198.6,4588
1199,1998,11,CAL (CALIPATRIA SP),3986,0,3986,2208,180.5,4108
1200,1998,11,"CRC (CAL REHAB CTR, MEN)",2760,1360,4120,1814,227.1,4001
1201,1998,11,CMC (CA MEN'S COLONY),6682,0,6682,3884,172.0,6724
1202,1998,11,CMF (CA MEDICAL FAC),3163,0,3163,2315,136.6,3377
1203,1998,11,CIM (CA INSTITUTION FOR MEN),6412,31,6443,3078,209.3,6318
1204,1998,11,CCI (CA CORRECTIONAL INSTITUTION),5856,1,5857,2781,210.6,5992
1205,1998,11,CCC (CA CORRECTIONAL CENTER),5763,0,5763,3682,156.5,5657
1206,1998,11,ASP (AVENAL SP),5673,0,5673,2320,244.5,5793
1207,1998,12,VSP (VALLEY SP),3734,8,3742,1980,189.0,3741
1208,1998,12,SCC (SIERRA CONSERVATION CENTER),327,0,327,320,102.2,320
1209,1998,12,NCWF (NO CAL WOMEN'S FACIL),764,1,765,400,191.3,760
1210,1998,12,CCWF (CENTRAL CA WOMEN'S FAC),3616,3,3619,2004,180.6,3757
1211,1998,12,"CRC (CAL REHAB CTR, WOMEN)",290,552,842,500,168.4,842
1212,1998,12,CIW (CA INSTITUTION FOR WOMEN),1763,14,1777,1026,173.2,1747
1213,1998,12,WSP (WASCO SP),5817,44,5861,2984,196.4,5580
1214,1998,12,SCC (SIERRA CONSERVATION CENTER),5978,1,5979,3606,165.8,5884
1215,1998,12,SVSP (SALINAS VALLEY SP),4226,0,4226,2224,190.0,4266
1216,1998,12,RJD (RJ DONOVAN CORRECTIONAL FAC),4652,1,4653,2200,211.5,4698
1217,1998,12,PVSP (PLEASANT VALLEY SP),4527,0,4527,2208,205.0,4588
1218,1998,12,PBSP (PELICAN BAY SP),3374,2,3376,2280,148.1,3711
1219,1998,12,NKSP (NORTH KERN SP),4638,2,4640,2692,172.4,4872
1220,1998,12,MCSP (MULE CREEK SP),3640,0,3640,1700,214.1,3562
1221,1998,12,ISP (IRONWOOD SP),4142,0,4142,2200,188.3,4460
1222,1998,12,HDSP (HIGH DESERT SP),4051,2,4053,2224,182.2,4166
1223,1998,12,FOL (FOLSOM SP) (MALE),3828,0,3828,2072,184.7,3725
1224,1998,12,DVI (DEUEL VOCATIONAL INSTITUTION),3628,16,3644,1787,203.9,3706
1225,1998,12,CTF (CORRECTIONAL TRAINING FAC),7169,0,7169,3281,218.5,7161
1226,1998,12,CVSP (CHUCKAWALLA VALLEY SP),3606,0,3606,1738,207.5,3679
1227,1998,12,SATF (CA SUBSTANCE ABUSE TREAT FAC),6127,3,6130,3324,184.4,6225
1228,1998,12,"SOL (CA SP, SOLANO)",5709,1,5710,2610,218.8,5777
1229,1998,12,SQ (SAN QUENTIN SP),5868,19,5887,3281,179.4,5679
1230,1998,12,"SAC (CA SP, SACRAMENTO)",3148,0,3148,1728,182.2,3204
1231,1998,12,"LAC (CA SP, LOS ANGELES COUNTY)",4221,0,4221,2200,191.9,4220
1232,1998,12,"COR (CA SP, CORCORAN)",4765,0,4765,3016,158.0,5063
1233,1998,12,CEN (CENTINELA SP),4252,0,4252,2208,192.6,4588
1234,1998,12,CAL (CALIPATRIA SP),4112,0,4112,2208,186.2,4108
1235,1998,12,"CRC (CAL REHAB CTR, MEN)",2746,1306,4052,1814,223.4,4001
1236,1998,12,CMC (CA MEN'S COLONY),6650,0,6650,3884,171.2,6724
1237,1998,12,CMF (CA MEDICAL FAC),3168,0,3168,2315,136.8,3377
1238,1998,12,CIM (CA INSTITUTION FOR MEN),6302,42,6344,3078,206.1,6318
1239,1998,12,CCI (CA CORRECTIONAL INSTITUTION),5997,1,5998,2781,215.7,5992
1240,1998,12,CCC (CA CORRECTIONAL CENTER),5817,0,5817,3682,158.0,5657
1241,1998,12,ASP (AVENAL SP),5765,0,5765,2320,248.5,5793
1242,1999,1,VSP (VALLEY SP),3732,14,3746,1980,189.2,3741
1243,1999,1,SCC (SIERRA CONSERVATION CENTER),321,0,321,320,100.3,320
1244,1999,1,NCWF (NO CAL WOMEN'S FACIL),762,2,764,400,191.0,760
1245,1999,1,CCWF (CENTRAL CA WOMEN'S FAC),3553,3,3556,2004,177.4,3757
1246,1999,1,"CRC (CAL REHAB CTR, WOMEN)",274,523,797,500,159.4,842
1247,1999,1,CIW (CA INSTITUTION FOR WOMEN),1760,14,1774,1026,172.9,1747
1248,1999,1,WSP (WASCO SP),6079,36,6115,2984,204.9,5580
1249,1999,1,SCC (SIERRA CONSERVATION CENTER),5986,1,5987,3606,166.0,5884
1250,1999,1,SVSP (SALINAS VALLEY SP),4206,0,4206,2224,189.1,4266
1251,1999,1,RJD (RJ DONOVAN CORRECTIONAL FAC),4654,1,4655,2200,211.6,4698
1252,1999,1,PVSP (PLEASANT VALLEY SP),4591,0,4591,2208,207.9,4588
1253,1999,1,PBSP (PELICAN BAY SP),3318,0,3318,2280,145.5,3711
1254,1999,1,NKSP (NORTH KERN SP),4749,1,4750,2692,176.4,4872
1255,1999,1,MCSP (MULE CREEK SP),3590,0,3590,1700,211.2,3562
1256,1999,1,ISP (IRONWOOD SP),4192,0,4192,2200,190.5,4460
1257,1999,1,HDSP (HIGH DESERT SP),4129,5,4134,2224,185.9,4166
1258,1999,1,FOL (FOLSOM SP) (MALE),3784,0,3784,2072,182.6,3725
1259,1999,1,DVI (DEUEL VOCATIONAL INSTITUTION),3581,23,3604,1787,201.7,3706
1260,1999,1,CTF (CORRECTIONAL TRAINING FAC),7080,0,7080,3281,215.8,7161
1261,1999,1,CVSP (CHUCKAWALLA VALLEY SP),3621,0,3621,1738,208.3,3679
1262,1999,1,SATF (CA SUBSTANCE ABUSE TREAT FAC),5948,3,5951,3324,179.0,6225
1263,1999,1,"SOL (CA SP, SOLANO)",5699,1,5700,2610,218.4,5777
1264,1999,1,SQ (SAN QUENTIN SP),5707,13,5720,3281,174.3,5679
1265,1999,1,"SAC (CA SP, SACRAMENTO)",3089,0,3089,1728,178.8,3204
1266,1999,1,"LAC (CA SP, LOS ANGELES COUNTY)",4200,0,4200,2200,190.9,4220
1267,1999,1,"COR (CA SP, CORCORAN)",4579,0,4579,3016,151.8,5063
1268,1999,1,CEN (CENTINELA SP),4043,0,4043,2208,183.1,4588
1269,1999,1,CAL (CALIPATRIA SP),4147,0,4147,2208,187.8,4108
1270,1999,1,"CRC (CAL REHAB CTR, MEN)",2714,1289,4003,1814,220.7,4001
1271,1999,1,CMC (CA MEN'S COLONY),6606,0,6606,3884,170.1,6724
1272,1999,1,CMF (CA MEDICAL FAC),3077,0,3077,2315,132.9,3377
1273,1999,1,CIM (CA INSTITUTION FOR MEN),6269,52,6321,3078,205.4,6318
1274,1999,1,CCI (CA CORRECTIONAL INSTITUTION),5851,0,5851,2781,210.4,5992
1275,1999,1,CCC (CA CORRECTIONAL CENTER),5801,1,5802,3682,157.6,5657
1276,1999,1,ASP (AVENAL SP),5723,0,5723,2320,246.7,5793
1277,1999,2,VSP (VALLEY SP),3648,15,3663,1980,185.0,3741
1278,1999,2,SCC (SIERRA CONSERVATION CENTER),327,0,327,320,102.2,320
1279,1999,2,NCWF (NO CAL WOMEN'S FACIL),740,2,742,400,185.5,760
1280,1999,2,CCWF (CENTRAL CA WOMEN'S FAC),3625,5,3630,2004,181.1,3757
1281,1999,2,"CRC (CAL REHAB CTR, WOMEN)",310,518,828,500,165.6,842
1282,1999,2,CIW (CA INSTITUTION FOR WOMEN),1744,14,1758,1026,171.3,1747
1283,1999,2,WSP (WASCO SP),5952,31,5983,2984,200.5,5580
1284,1999,2,SCC (SIERRA CONSERVATION CENTER),5942,2,5944,3606,164.8,5884
1285,1999,2,SVSP (SALINAS VALLEY SP),4247,0,4247,2224,191.0,4266
1286,1999,2,RJD (RJ DONOVAN CORRECTIONAL FAC),4657,0,4657,2200,211.7,4698
1287,1999,2,PVSP (PLEASANT VALLEY SP),4639,0,4639,2208,210.1,4588
1288,1999,2,PBSP (PELICAN BAY SP),3266,1,3267,2280,143.3,3711
1289,1999,2,NKSP (NORTH KERN SP),5115,2,5117,2692,190.1,4872
1290,1999,2,MCSP (MULE CREEK SP),3587,0,3587,1700,211.0,3562
1291,1999,2,ISP (IRONWOOD SP),4155,0,4155,2200,188.9,4460
1292,1999,2,HDSP (HIGH DESERT SP),4090,3,4093,2224,184.0,4166
1293,1999,2,FOL (FOLSOM SP) (MALE),3826,0,3826,2072,184.7,3725
1294,1999,2,DVI (DEUEL VOCATIONAL INSTITUTION),3743,27,3770,1787,211.0,3706
1295,1999,2,CTF (CORRECTIONAL TRAINING FAC),7038,0,7038,3281,214.5,7161
1296,1999,2,CVSP (CHUCKAWALLA VALLEY SP),3602,0,3602,1738,207.2,3679
1297,1999,2,SATF (CA SUBSTANCE ABUSE TREAT FAC),5843,3,5846,3324,175.9,6225
1298,1999,2,"SOL (CA SP, SOLANO)",5696,1,5697,2610,218.3,5777
1299,1999,2,SQ (SAN QUENTIN SP),5880,19,5899,3281,179.8,5679
1300,1999,2,"SAC (CA SP, SACRAMENTO)",3043,0,3043,1728,176.1,3204
1301,1999,2,"LAC (CA SP, LOS ANGELES COUNTY)",4171,0,4171,2200,189.6,4220
1302,1999,2,"COR (CA SP, CORCORAN)",4518,0,4518,3016,149.8,5063
1303,1999,2,CEN (CENTINELA SP),4288,0,4288,2208,194.2,4588
1304,1999,2,CAL (CALIPATRIA SP),4045,0,4045,2208,183.2,4108
1305,1999,2,"CRC (CAL REHAB CTR, MEN)",2808,1261,4069,1814,224.3,4001
1306,1999,2,CMC (CA MEN'S COLONY),6563,0,6563,3884,169.0,6724
1307,1999,2,CMF (CA MEDICAL FAC),3013,0,3013,2315,130.2,3377
1308,1999,2,CIM (CA INSTITUTION FOR MEN),6242,47,6289,3078,204.3,6318
1309,1999,2,CCI (CA CORRECTIONAL INSTITUTION),5989,0,5989,2781,215.4,5992
1310,1999,2,CCC (CA CORRECTIONAL CENTER),5745,0,5745,3682,156.0,5657
1311,1999,2,ASP (AVENAL SP),5690,0,5690,2320,245.3,5793
1312,1999,3,VSP (VALLEY SP),3659,8,3667,1980,185.2,3741
1313,1999,3,SCC (SIERRA CONSERVATION CENTER),295,0,295,320,92.2,320
1314,1999,3,NCWF (NO CAL WOMEN'S FACIL),765,1,766,400,191.5,760
1315,1999,3,CCWF (CENTRAL CA WOMEN'S FAC),3689,6,3695,2004,184.4,3757
1316,1999,3,"CRC (CAL REHAB CTR, WOMEN)",327,493,820,500,164.0,842
1317,1999,3,CIW (CA INSTITUTION FOR WOMEN),1756,16,1772,1026,172.7,1747
1318,1999,3,WSP (WASCO SP),6086,28,6114,2984,204.9,5580
1319,1999,3,SCC (SIERRA CONSERVATION CENTER),6077,0,6077,3606,168.5,5884
1320,1999,3,SVSP (SALINAS VALLEY SP),4187,0,4187,2224,188.3,4266
1321,1999,3,RJD (RJ DONOVAN CORRECTIONAL FAC),4638,2,4640,2200,210.9,4698
1322,1999,3,PVSP (PLEASANT VALLEY SP),4626,0,4626,2208,209.5,4588
1323,1999,3,PBSP (PELICAN BAY SP),3174,0,3174,2280,139.2,3711
1324,1999,3,NKSP (NORTH KERN SP),5161,4,5165,2692,191.9,4872
1325,1999,3,MCSP (MULE CREEK SP),3591,0,3591,1700,211.2,3562
1326,1999,3,ISP (IRONWOOD SP),4304,0,4304,2200,195.6,4460
1327,1999,3,HDSP (HIGH DESERT SP),4078,1,4079,2224,183.4,4166
1328,1999,3,FOL (FOLSOM SP) (MALE),3865,0,3865,2072,186.5,3725
1329,1999,3,DVI (DEUEL VOCATIONAL INSTITUTION),3674,22,3696,1787,206.8,3706
1330,1999,3,CTF (CORRECTIONAL TRAINING FAC),7109,1,7110,3281,216.7,7161
1331,1999,3,CVSP (CHUCKAWALLA VALLEY SP),3631,0,3631,1738,208.9,3679
1332,1999,3,SATF (CA SUBSTANCE ABUSE TREAT FAC),5604,3,5607,3324,168.7,6225
1333,1999,3,"SOL (CA SP, SOLANO)",5750,1,5751,2610,220.3,5777
1334,1999,3,SQ (SAN QUENTIN SP),5847,15,5862,3281,178.7,5679
1335,1999,3,"SAC (CA SP, SACRAMENTO)",3082,0,3082,1728,178.4,3204
1336,1999,3,"LAC (CA SP, LOS ANGELES COUNTY)",4186,0,4186,2200,190.3,4220
1337,1999,3,"COR (CA SP, CORCORAN)",4624,0,4624,3016,153.3,5063
1338,1999,3,CEN (CENTINELA SP),4586,0,4586,2208,207.7,4588
1339,1999,3,CAL (CALIPATRIA SP),4134,0,4134,2208,187.2,4108
1340,1999,3,"CRC (CAL REHAB CTR, MEN)",2798,1244,4042,1814,222.8,4001
1341,1999,3,CMC (CA MEN'S COLONY),6666,0,6666,3884,171.6,6724
1342,1999,3,CMF (CA MEDICAL FAC),3037,0,3037,2315,131.2,3377
1343,1999,3,CIM (CA INSTITUTION FOR MEN),6293,45,6338,3078,205.9,6318
1344,1999,3,CCI (CA CORRECTIONAL INSTITUTION),5972,1,5973,2781,214.8,5992
1345,1999,3,CCC (CA CORRECTIONAL CENTER),5936,0,5936,3682,161.2,5657
1346,1999,3,ASP (AVENAL SP),5746,0,5746,2320,247.7,5793
1347,1999,4,VSP (VALLEY SP),3632,10,3642,1980,183.9,3664
1348,1999,4,SCC (SIERRA CONSERVATION CENTER),302,0,302,320,94.4,320
1349,1999,4,NCWF (NO CAL WOMEN'S FACIL),758,1,759,400,189.8,760
1350,1999,4,CCWF (CENTRAL CA WOMEN'S FAC),3671,2,3673,2004,183.3,3680
1351,1999,4,"CRC (CAL REHAB CTR, WOMEN)",335,466,801,500,160.2,842
1352,1999,4,CIW (CA INSTITUTION FOR WOMEN),1827,17,1844,1026,179.7,1747
1353,1999,4,WSP (WASCO SP),6062,29,6091,2984,204.1,5580
1354,1999,4,SCC (SIERRA CONSERVATION CENTER),5983,0,5983,3606,165.9,5884
1355,1999,4,SVSP (SALINAS VALLEY SP),4223,0,4223,2224,189.9,4266
1356,1999,4,RJD (RJ DONOVAN CORRECTIONAL FAC),4500,0,4500,2200,204.5,4698
1357,1999,4,PVSP (PLEASANT VALLEY SP),4657,0,4657,2208,210.9,4588
1358,1999,4,PBSP (PELICAN BAY SP),3193,1,3194,2280,140.1,3605
1359,1999,4,NKSP (NORTH KERN SP),5134,4,5138,2692,190.9,4872
1360,1999,4,MCSP (MULE CREEK SP),3543,0,3543,1700,208.4,3562
1361,1999,4,ISP (IRONWOOD SP),4525,0,4525,2200,205.7,4340
1362,1999,4,HDSP (HIGH DESERT SP),4171,3,4174,2224,187.7,4046
1363,1999,4,FOL (FOLSOM SP) (MALE),3825,0,3825,2072,184.6,3725
1364,1999,4,DVI (DEUEL VOCATIONAL INSTITUTION),3742,27,3769,1787,210.9,3706
1365,1999,4,CTF (CORRECTIONAL TRAINING FAC),7076,0,7076,3281,215.7,7161
1366,1999,4,CVSP (CHUCKAWALLA VALLEY SP),3578,0,3578,1738,205.9,3679
1367,1999,4,SATF (CA SUBSTANCE ABUSE TREAT FAC),6030,0,6030,3324,181.4,6105
1368,1999,4,"SOL (CA SP, SOLANO)",5755,1,5756,2610,220.5,5777
1369,1999,4,SQ (SAN QUENTIN SP),5842,23,5865,3279,178.9,5634
1370,1999,4,"SAC (CA SP, SACRAMENTO)",3039,0,3039,1728,175.9,3204
1371,1999,4,"LAC (CA SP, LOS ANGELES COUNTY)",4219,0,4219,2200,191.8,4220
1372,1999,4,"COR (CA SP, CORCORAN)",4595,0,4595,3016,152.4,5063
1373,1999,4,CEN (CENTINELA SP),4597,0,4597,2208,208.2,4588
1374,1999,4,CAL (CALIPATRIA SP),4182,0,4182,2208,189.4,4108
1375,1999,4,"CRC (CAL REHAB CTR, MEN)",2880,1222,4102,1814,226.1,4001
1376,1999,4,CMC (CA MEN'S COLONY),6683,0,6683,3884,172.1,6724
1377,1999,4,CMF (CA MEDICAL FAC),3131,0,3131,2315,135.2,3401
1378,1999,4,CIM (CA INSTITUTION FOR MEN),6467,40,6507,3078,211.4,6318
1379,1999,4,CCI (CA CORRECTIONAL INSTITUTION),5943,1,5944,2781,213.7,5992
1380,1999,4,CCC (CA CORRECTIONAL CENTER),5837,0,5837,3682,158.5,5657
1381,1999,4,ASP (AVENAL SP),5758,0,5758,2320,248.2,5793
1382,1999,5,VSP (VALLEY SP),3585,20,3605,1980,182.1,3664
1383,1999,5,SCC (SIERRA CONSERVATION CENTER),307,0,307,320,95.9,320
1384,1999,5,NCWF (NO CAL WOMEN'S FACIL),757,2,759,400,189.8,760
1385,1999,5,CCWF (CENTRAL CA WOMEN'S FAC),3659,2,3661,2004,182.7,3676
1386,1999,5,"CRC (CAL REHAB CTR, WOMEN)",347,462,809,500,161.8,842
1387,1999,5,CIW (CA INSTITUTION FOR WOMEN),1806,17,1823,1026,177.7,1747
1388,1999,5,WSP (WASCO SP),5969,27,5996,2984,200.9,5580
1389,1999,5,SCC (SIERRA CONSERVATION CENTER),6039,0,6039,3606,167.5,5884
1390,1999,5,SVSP (SALINAS VALLEY SP),4159,0,4159,2224,187.0,4266
1391,1999,5,RJD (RJ DONOVAN CORRECTIONAL FAC),4313,0,4313,2200,196.0,4698
1392,1999,5,PVSP (PLEASANT VALLEY SP),4725,0,4725,2208,214.0,4588
1393,1999,5,PBSP (PELICAN BAY SP),3303,0,3303,2280,144.9,3550
1394,1999,5,NKSP (NORTH KERN SP),5007,4,5011,2692,186.1,4872
1395,1999,5,MCSP (MULE CREEK SP),3542,0,3542,1700,208.4,3562
1396,1999,5,ISP (IRONWOOD SP),4652,0,4652,2200,211.5,4340
1397,1999,5,HDSP (HIGH DESERT SP),4199,3,4202,2224,188.9,4046
1398,1999,5,FOL (FOLSOM SP) (MALE),3799,0,3799,2072,183.3,3725
1399,1999,5,DVI (DEUEL VOCATIONAL INSTITUTION),3761,7,3768,1787,210.9,3706
1400,1999,5,CTF (CORRECTIONAL TRAINING FAC),7351,0,7351,3281,224.0,7161
1401,1999,5,CVSP (CHUCKAWALLA VALLEY SP),3634,0,3634,1738,209.1,3679
1402,1999,5,SATF (CA SUBSTANCE ABUSE TREAT FAC),6219,0,6219,3324,187.1,6105
1403,1999,5,"SOL (CA SP, SOLANO)",5858,1,5859,2610,224.5,5777
1404,1999,5,SQ (SAN QUENTIN SP),5830,19,5849,3279,178.4,5634
1405,1999,5,"SAC (CA SP, SACRAMENTO)",2913,0,2913,1728,168.6,3254
1406,1999,5,"LAC (CA SP, LOS ANGELES COUNTY)",4203,0,4203,2200,191.0,4220
1407,1999,5,"COR (CA SP, CORCORAN)",4693,0,4693,3016,155.6,5063
1408,1999,5,CEN (CENTINELA SP),4539,0,4539,2208,205.6,4588
1409,1999,5,CAL (CALIPATRIA SP),4091,0,4091,2208,185.3,4108
1410,1999,5,"CRC (CAL REHAB CTR, MEN)",2805,1225,4030,1814,222.2,4001
1411,1999,5,CMC (CA MEN'S COLONY),6665,0,6665,3884,171.6,6724
1412,1999,5,CMF (CA MEDICAL FAC),3147,0,3147,2315,135.9,3401
1413,1999,5,CIM (CA INSTITUTION FOR MEN),6325,43,6368,3078,206.9,6318
1414,1999,5,CCI (CA CORRECTIONAL INSTITUTION),5900,0,5900,2781,212.2,5992
1415,1999,5,CCC (CA CORRECTIONAL CENTER),5865,0,5865,3682,159.3,5657
1416,1999,5,ASP (AVENAL SP),5711,0,5711,2320,246.2,5793
1417,1999,6,VSP (VALLEY SP),3655,14,3669,1980,185.3,3664
1418,1999,6,SCC (SIERRA CONSERVATION CENTER),322,0,322,320,100.6,320
1419,1999,6,NCWF (NO CAL WOMEN'S FACIL),771,6,777,400,194.3,760
1420,1999,6,CCWF (CENTRAL CA WOMEN'S FAC),3576,1,3577,2004,178.5,3753
1421,1999,6,"CRC (CAL REHAB CTR, WOMEN)",368,456,824,500,164.8,842
1422,1999,6,CIW (CA INSTITUTION FOR WOMEN),1882,18,1900,1026,185.2,1747
1423,1999,6,WSP (WASCO SP),5924,35,5959,2984,199.7,5580
1424,1999,6,SCC (SIERRA CONSERVATION CENTER),5970,0,5970,3606,165.6,5884
1425,1999,6,SVSP (SALINAS VALLEY SP),4253,0,4253,2224,191.2,4266
1426,1999,6,RJD (RJ DONOVAN CORRECTIONAL FAC),4651,0,4651,2200,211.4,4698
1427,1999,6,PVSP (PLEASANT VALLEY SP),4556,0,4556,2208,206.3,4588
1428,1999,6,PBSP (PELICAN BAY SP),3339,0,3339,2280,146.4,3550
1429,1999,6,NKSP (NORTH KERN SP),5085,2,5087,2692,189.0,5104
1430,1999,6,MCSP (MULE CREEK SP),3615,0,3615,1700,212.6,3562
1431,1999,6,ISP (IRONWOOD SP),4547,0,4547,2200,206.7,4460
1432,1999,6,HDSP (HIGH DESERT SP),4314,8,4322,2224,194.3,4166
1433,1999,6,FOL (FOLSOM SP) (MALE),3848,0,3848,2072,185.7,3725
1434,1999,6,DVI (DEUEL VOCATIONAL INSTITUTION),3828,39,3867,1787,216.4,3706
1435,1999,6,CTF (CORRECTIONAL TRAINING FAC),7297,0,7297,3281,222.4,7161
1436,1999,6,CVSP (CHUCKAWALLA VALLEY SP),3562,0,3562,1738,204.9,3679
1437,1999,6,SATF (CA SUBSTANCE ABUSE TREAT FAC),6363,0,6363,3324,191.4,6105
1438,1999,6,"SOL (CA SP, SOLANO)",5821,1,5822,2610,223.1,5777
1439,1999,6,SQ (SAN QUENTIN SP),5832,23,5855,3279,178.6,5634
1440,1999,6,"SAC (CA SP, SACRAMENTO)",2947,0,2947,1728,170.5,3254
1441,1999,6,"LAC (CA SP, LOS ANGELES COUNTY)",4180,0,4180,2200,190.0,4220
1442,1999,6,"COR (CA SP, CORCORAN)",4857,0,4857,3016,161.0,5063
1443,1999,6,CEN (CENTINELA SP),4540,1,4541,2208,205.7,4588
1444,1999,6,CAL (CALIPATRIA SP),4129,0,4129,2208,187.0,4108
1445,1999,6,"CRC (CAL REHAB CTR, MEN)",2885,1152,4037,1814,222.5,4001
1446,1999,6,CMC (CA MEN'S COLONY),6646,2,6648,3884,171.2,6724
1447,1999,6,CMF (CA MEDICAL FAC),3115,0,3115,2315,134.6,3401
1448,1999,6,CIM (CA INSTITUTION FOR MEN),6484,40,6524,3078,212.0,6318
1449,1999,6,CCI (CA CORRECTIONAL INSTITUTION),5825,0,5825,2781,209.5,5992
1450,1999,6,CCC (CA CORRECTIONAL CENTER),5871,0,5871,3682,159.5,5657
1451,1999,6,ASP (AVENAL SP),5873,0,5873,2320,253.1,5793
1452,1999,7,VSP (VALLEY SP),3615,14,3629,1980,183.3,3664
1453,1999,7,SCC (SIERRA CONSERVATION CENTER),340,0,340,320,106.3,320
1454,1999,7,NCWF (NO CAL WOMEN'S FACIL),749,2,751,400,187.8,760
1455,1999,7,CCWF (CENTRAL CA WOMEN'S FAC),3563,1,3564,2004,177.8,3753
1456,1999,7,"CRC (CAL REHAB CTR, WOMEN)",349,441,790,500,158.0,842
1457,1999,7,CIW (CA INSTITUTION FOR WOMEN),1854,17,1871,1026,182.4,1747
1458,1999,7,WSP (WASCO SP),5476,21,5497,2984,184.2,5580
1459,1999,7,SCC (SIERRA CONSERVATION CENTER),5955,0,5955,3606,165.1,5884
1460,1999,7,SVSP (SALINAS VALLEY SP),4233,0,4233,2224,190.3,4266
1461,1999,7,RJD (RJ DONOVAN CORRECTIONAL FAC),4725,0,4725,2200,214.8,4698
1462,1999,7,PVSP (PLEASANT VALLEY SP),4681,0,4681,2208,212.0,4588
1463,1999,7,PBSP (PELICAN BAY SP),3391,0,3391,2280,148.7,3550
1464,1999,7,NKSP (NORTH KERN SP),5001,1,5002,2692,185.8,5104
1465,1999,7,MCSP (MULE CREEK SP),3547,0,3547,1700,208.6,3562
1466,1999,7,ISP (IRONWOOD SP),4539,0,4539,2200,206.3,4460
1467,1999,7,HDSP (HIGH DESERT SP),4254,3,4257,2224,191.4,4166
1468,1999,7,FOL (FOLSOM SP) (MALE),3810,0,3810,2072,183.9,3725
1469,1999,7,DVI (DEUEL VOCATIONAL INSTITUTION),3710,31,3741,1787,209.3,3706
1470,1999,7,CTF (CORRECTIONAL TRAINING FAC),7236,0,7236,3281,220.5,7161
1471,1999,7,CVSP (CHUCKAWALLA VALLEY SP),3660,0,3660,1738,210.6,3679
1472,1999,7,SATF (CA SUBSTANCE ABUSE TREAT FAC),6383,1,6384,3324,192.1,6105
1473,1999,7,"SOL (CA SP, SOLANO)",5871,1,5872,2610,225.0,5777
1474,1999,7,SQ (SAN QUENTIN SP),5851,25,5876,3279,179.2,5634
1475,1999,7,"SAC (CA SP, SACRAMENTO)",3010,0,3010,1728,174.2,3254
1476,1999,7,"LAC (CA SP, LOS ANGELES COUNTY)",4172,0,4172,2200,189.6,4220
1477,1999,7,"COR (CA SP, CORCORAN)",5002,0,5002,3016,165.8,5063
1478,1999,7,CEN (CENTINELA SP),4574,0,4574,2208,207.2,4588
1479,1999,7,CAL (CALIPATRIA SP),4121,0,4121,2208,186.6,4108
1480,1999,7,"CRC (CAL REHAB CTR, MEN)",2957,1108,4065,1814,224.1,4001
1481,1999,7,CMC (CA MEN'S COLONY),6941,0,6941,3884,178.7,6724
1482,1999,7,CMF (CA MEDICAL FAC),3094,0,3094,2315,133.7,3401
1483,1999,7,CIM (CA INSTITUTION FOR MEN),6183,36,6219,3078,202.0,6318
1484,1999,7,CCI (CA CORRECTIONAL INSTITUTION),5823,0,5823,2781,209.4,5992
1485,1999,7,CCC (CA CORRECTIONAL CENTER),5957,0,5957,3682,161.8,5657
1486,1999,7,ASP (AVENAL SP),6087,0,6087,2320,262.4,5793
1487,1999,8,VSP (VALLEY SP),3557,5,3562,1980,179.9,3664
1488,1999,8,SCC (SIERRA CONSERVATION CENTER),336,0,336,320,105.0,320
1489,1999,8,NCWF (NO CAL WOMEN'S FACIL),741,2,743,400,185.8,760
1490,1999,8,CCWF (CENTRAL CA WOMEN'S FAC),3503,1,3504,2004,174.9,3753
1491,1999,8,"CRC (CAL REHAB CTR, WOMEN)",379,447,826,500,165.2,842
1492,1999,8,CIW (CA INSTITUTION FOR WOMEN),1808,24,1832,1026,178.6,1747
1493,1999,8,WSP (WASCO SP),5619,28,5647,2984,189.2,5580
1494,1999,8,SCC (SIERRA CONSERVATION CENTER),6026,0,6026,3606,167.1,5884
1495,1999,8,SVSP (SALINAS VALLEY SP),4242,0,4242,2224,190.7,4266
1496,1999,8,RJD (RJ DONOVAN CORRECTIONAL FAC),4730,1,4731,2200,215.0,4698
1497,1999,8,PVSP (PLEASANT VALLEY SP),4652,0,4652,2208,210.7,4588
1498,1999,8,PBSP (PELICAN BAY SP),3444,0,3444,2280,151.1,3550
1499,1999,8,NKSP (NORTH KERN SP),4971,4,4975,2692,184.8,5104
1500,1999,8,MCSP (MULE CREEK SP),3564,0,3564,1700,209.6,3562
1501,1999,8,ISP (IRONWOOD SP),4606,0,4606,2200,209.4,4460
1502,1999,8,HDSP (HIGH DESERT SP),4329,1,4330,2224,194.7,4166
1503,1999,8,FOL (FOLSOM SP) (MALE),3835,0,3835,2072,185.1,3725
1504,1999,8,DVI (DEUEL VOCATIONAL INSTITUTION),3737,11,3748,1787,209.7,3706
1505,1999,8,CTF (CORRECTIONAL TRAINING FAC),7269,0,7269,3281,221.5,7161
1506,1999,8,CVSP (CHUCKAWALLA VALLEY SP),3623,0,3623,1738,208.5,3679
1507,1999,8,SATF (CA SUBSTANCE ABUSE TREAT FAC),6386,1,6387,3324,192.1,6105
1508,1999,8,"SOL (CA SP, SOLANO)",5856,1,5857,2610,224.4,5777
1509,1999,8,SQ (SAN QUENTIN SP),5791,20,5811,3279,177.2,5634
1510,1999,8,"SAC (CA SP, SACRAMENTO)",3031,0,3031,1728,175.4,3254
1511,1999,8,"LAC (CA SP, LOS ANGELES COUNTY)",4219,0,4219,2200,191.8,4220
1512,1999,8,"COR (CA SP, CORCORAN)",5026,0,5026,3016,166.6,5063
1513,1999,8,CEN (CENTINELA SP),4531,0,4531,2208,205.2,4588
1514,1999,8,CAL (CALIPATRIA SP),4062,0,4062,2208,184.0,4108
1515,1999,8,"CRC (CAL REHAB CTR, MEN)",2937,1125,4062,1814,223.9,4001
1516,1999,8,CMC (CA MEN'S COLONY),6935,1,6936,3884,178.6,6724
1517,1999,8,CMF (CA MEDICAL FAC),3141,0,3141,2315,135.7,3401
1518,1999,8,CIM (CA INSTITUTION FOR MEN),6141,36,6177,3078,200.7,6318
1519,1999,8,CCI (CA CORRECTIONAL INSTITUTION),5795,0,5795,2781,208.4,5992
1520,1999,8,CCC (CA CORRECTIONAL CENTER),5918,0,5918,3682,160.7,5657
1521,1999,8,ASP (AVENAL SP),6144,0,6144,2320,264.8,5793
1522,1999,9,VSP (VALLEY SP),3605,16,3621,1980,182.9,3664
1523,1999,9,SCC (SIERRA CONSERVATION CENTER),330,0,330,320,103.1,320
1524,1999,9,NCWF (NO CAL WOMEN'S FACIL),752,0,752,400,188.0,760
1525,1999,9,CCWF (CENTRAL CA WOMEN'S FAC),3519,5,3524,2004,175.8,3753
1526,1999,9,"CRC (CAL REHAB CTR, WOMEN)",386,429,815,500,163.0,842
1527,1999,9,CIW (CA INSTITUTION FOR WOMEN),1867,30,1897,1026,184.9,1747
1528,1999,9,WSP (WASCO SP),5553,29,5582,2984,187.1,5580
1529,1999,9,SCC (SIERRA CONSERVATION CENTER),6037,0,6037,3606,167.4,5884
1530,1999,9,SVSP (SALINAS VALLEY SP),4249,0,4249,2224,191.1,4266
1531,1999,9,RJD (RJ DONOVAN CORRECTIONAL FAC),4728,0,4728,2200,214.9,4698
1532,1999,9,PVSP (PLEASANT VALLEY SP),4645,0,4645,2208,210.4,4588
1533,1999,9,PBSP (PELICAN BAY SP),3410,0,3410,2280,149.6,3550
1534,1999,9,NKSP (NORTH KERN SP),4805,9,4814,2692,178.8,5104
1535,1999,9,MCSP (MULE CREEK SP),3560,0,3560,1700,209.4,3562
1536,1999,9,ISP (IRONWOOD SP),4631,0,4631,2200,210.5,4460
1537,1999,9,HDSP (HIGH DESERT SP),4348,5,4353,2224,195.7,4166
1538,1999,9,FOL (FOLSOM SP) (MALE),3843,0,3843,2072,185.5,3725
1539,1999,9,DVI (DEUEL VOCATIONAL INSTITUTION),3809,31,3840,1787,214.9,3706
1540,1999,9,CTF (CORRECTIONAL TRAINING FAC),7235,0,7235,3281,220.5,7161
1541,1999,9,CVSP (CHUCKAWALLA VALLEY SP),3635,0,3635,1738,209.1,3679
1542,1999,9,SATF (CA SUBSTANCE ABUSE TREAT FAC),6418,4,6422,3324,193.2,6105
1543,1999,9,"SOL (CA SP, SOLANO)",5843,1,5844,2610,223.9,5777
1544,1999,9,SQ (SAN QUENTIN SP),5734,19,5753,3279,175.4,5634
1545,1999,9,"SAC (CA SP, SACRAMENTO)",3023,0,3023,1728,174.9,3254
1546,1999,9,"LAC (CA SP, LOS ANGELES COUNTY)",4208,0,4208,2200,191.3,4220
1547,1999,9,"COR (CA SP, CORCORAN)",4927,0,4927,3016,163.4,5063
1548,1999,9,CEN (CENTINELA SP),4562,0,4562,2208,206.6,4588
1549,1999,9,CAL (CALIPATRIA SP),4162,0,4162,2208,188.5,4108
1550,1999,9,"CRC (CAL REHAB CTR, MEN)",2923,1123,4046,1814,223.0,4001
1551,1999,9,CMC (CA MEN'S COLONY),6970,0,6970,3884,179.5,6724
1552,1999,9,CMF (CA MEDICAL FAC),3081,0,3081,2315,133.1,3401
1553,1999,9,CIM (CA INSTITUTION FOR MEN),6267,39,6306,3078,204.9,6318
1554,1999,9,CCI (CA CORRECTIONAL INSTITUTION),5816,1,5817,2781,209.2,5992
1555,1999,9,CCC (CA CORRECTIONAL CENTER),5905,0,5905,3682,160.4,5657
1556,1999,9,ASP (AVENAL SP),6265,0,6265,2320,270.0,5793
1557,1999,10,VSP (VALLEY SP),3591,11,3602,1980,181.9,3664
1558,1999,10,SCC (SIERRA CONSERVATION CENTER),338,0,338,320,105.6,320
1559,1999,10,NCWF (NO CAL WOMEN'S FACIL),680,1,681,400,170.3,760
1560,1999,10,CCWF (CENTRAL CA WOMEN'S FAC),3508,2,3510,2004,175.1,3753
1561,1999,10,"CRC (CAL REHAB CTR, WOMEN)",373,426,799,500,159.8,842
1562,1999,10,CIW (CA INSTITUTION FOR WOMEN),1877,30,1907,1026,185.9,1747
1563,1999,10,WSP (WASCO SP),5537,21,5558,2984,186.3,5580
1564,1999,10,SCC (SIERRA CONSERVATION CENTER),5942,0,5942,3606,164.8,5884
1565,1999,10,SVSP (SALINAS VALLEY SP),4212,0,4212,2224,189.4,4266
1566,1999,10,RJD (RJ DONOVAN CORRECTIONAL FAC),4731,0,4731,2200,215.0,4698
1567,1999,10,PVSP (PLEASANT VALLEY SP),4648,1,4649,2208,210.6,4588
1568,1999,10,PBSP (PELICAN BAY SP),3401,0,3401,2280,149.2,3550
1569,1999,10,NKSP (NORTH KERN SP),4787,13,4800,2692,178.3,5104
1570,1999,10,MCSP (MULE CREEK SP),3566,0,3566,1700,209.8,3562
1571,1999,10,ISP (IRONWOOD SP),4573,0,4573,2200,207.9,4460
1572,1999,10,HDSP (HIGH DESERT SP),4245,4,4249,2224,191.1,4166
1573,1999,10,FOL (FOLSOM SP) (MALE),3839,0,3839,2072,185.3,3725
1574,1999,10,DVI (DEUEL VOCATIONAL INSTITUTION),3675,16,3691,1787,206.5,3706
1575,1999,10,CTF (CORRECTIONAL TRAINING FAC),7141,0,7141,3281,217.6,7161
1576,1999,10,CVSP (CHUCKAWALLA VALLEY SP),3640,0,3640,1738,209.4,3679
1577,1999,10,SATF (CA SUBSTANCE ABUSE TREAT FAC),6406,3,6409,3324,192.8,6105
1578,1999,10,"SOL (CA SP, SOLANO)",5786,1,5787,2610,221.7,5777
1579,1999,10,SQ (SAN QUENTIN SP),5820,11,5831,3279,177.8,5634
1580,1999,10,"SAC (CA SP, SACRAMENTO)",3064,0,3064,1728,177.3,3254
1581,1999,10,"LAC (CA SP, LOS ANGELES COUNTY)",4210,0,4210,2200,191.4,4220
1582,1999,10,"COR (CA SP, CORCORAN)",4994,0,4994,3016,165.6,5063
1583,1999,10,CEN (CENTINELA SP),4558,0,4558,2208,206.4,4588
1584,1999,10,CAL (CALIPATRIA SP),4130,0,4130,2208,187.0,4108
1585,1999,10,"CRC (CAL REHAB CTR, MEN)",2899,1175,4074,1814,224.6,4001
1586,1999,10,CMC (CA MEN'S COLONY),6990,0,6990,3884,180.0,6724
1587,1999,10,CMF (CA MEDICAL FAC),3068,0,3068,2315,132.5,3401
1588,1999,10,CIM (CA INSTITUTION FOR MEN),6314,34,6348,3078,206.2,6318
1589,1999,10,CCI (CA CORRECTIONAL INSTITUTION),5776,2,5778,2781,207.8,5992
1590,1999,10,CCC (CA CORRECTIONAL CENTER),5830,0,5830,3682,158.3,5657
1591,1999,10,ASP (AVENAL SP),6303,0,6303,2320,271.7,5793
1592,1999,11,VSP (VALLEY SP),3519,8,3527,1980,178.1,3664
1593,1999,11,SCC (SIERRA CONSERVATION CENTER),325,0,325,320,101.6,320
1594,1999,11,NCWF (NO CAL WOMEN'S FACIL),731,2,733,400,183.3,760
1595,1999,11,CCWF (CENTRAL CA WOMEN'S FAC),3409,1,3410,2004,170.2,3753
1596,1999,11,"CRC (CAL REHAB CTR, WOMEN)",379,431,810,500,162.0,842
1597,1999,11,CIW (CA INSTITUTION FOR WOMEN),1857,29,1886,1026,183.8,1747
1598,1999,11,WSP (WASCO SP),5371,22,5393,2984,180.7,5580
1599,1999,11,SCC (SIERRA CONSERVATION CENTER),5941,0,5941,3606,164.8,5884
1600,1999,11,SVSP (SALINAS VALLEY SP),4211,0,4211,2224,189.3,4266
1601,1999,11,RJD (RJ DONOVAN CORRECTIONAL FAC),4764,0,4764,2200,216.5,4698
1602,1999,11,PVSP (PLEASANT VALLEY SP),4672,0,4672,2208,211.6,4588
1603,1999,11,PBSP (PELICAN BAY SP),3389,0,3389,2280,148.6,3550
1604,1999,11,NKSP (NORTH KERN SP),4776,9,4785,2692,177.7,5104
1605,1999,11,MCSP (MULE CREEK SP),3549,0,3549,1700,208.8,3562
1606,1999,11,ISP (IRONWOOD SP),4552,0,4552,2200,206.9,4460
1607,1999,11,HDSP (HIGH DESERT SP),4249,3,4252,2224,191.2,4166
1608,1999,11,FOL (FOLSOM SP) (MALE),3797,0,3797,2072,183.3,3725
1609,1999,11,DVI (DEUEL VOCATIONAL INSTITUTION),3655,25,3680,1787,205.9,3706
1610,1999,11,CTF (CORRECTIONAL TRAINING FAC),7196,0,7196,3281,219.3,7161
1611,1999,11,CVSP (CHUCKAWALLA VALLEY SP),3563,0,3563,1738,205.0,3679
1612,1999,11,SATF (CA SUBSTANCE ABUSE TREAT FAC),6372,5,6377,3324,191.8,6105
1613,1999,11,"SOL (CA SP, SOLANO)",5784,1,5785,2610,221.6,5777
1614,1999,11,SQ (SAN QUENTIN SP),5729,14,5743,3279,175.1,5634
1615,1999,11,"SAC (CA SP, SACRAMENTO)",3071,0,3071,1728,177.7,3254
1616,1999,11,"LAC (CA SP, LOS ANGELES COUNTY)",4228,0,4228,2200,192.2,4220
1617,1999,11,"COR (CA SP, CORCORAN)",5036,0,5036,3016,167.0,5063
1618,1999,11,CEN (CENTINELA SP),4558,0,4558,2208,206.4,4588
1619,1999,11,CAL (CALIPATRIA SP),4179,0,4179,2208,189.3,4108
1620,1999,11,"CRC (CAL REHAB CTR, MEN)",2811,1264,4075,1814,224.6,4001
1621,1999,11,CMC (CA MEN'S COLONY),6924,0,6924,3884,178.3,6724
1622,1999,11,CMF (CA MEDICAL FAC),3024,0,3024,2315,130.6,3401
1623,1999,11,CIM (CA INSTITUTION FOR MEN),5970,34,6004,3078,195.1,6318
1624,1999,11,CCI (CA CORRECTIONAL INSTITUTION),5615,0,5615,2781,201.9,5992
1625,1999,11,CCC (CA CORRECTIONAL CENTER),5790,1,5791,3682,157.3,5657
1626,1999,11,ASP (AVENAL SP),6553,0,6553,2320,282.5,5793
1627,1999,12,VSP (VALLEY SP),3532,12,3544,1980,179.0,3587
1628,1999,12,SCC (SIERRA CONSERVATION CENTER),340,0,340,320,106.3,320
1629,1999,12,NCWF (NO CAL WOMEN'S FACIL),764,2,766,400,191.5,760
1630,1999,12,CCWF (CENTRAL CA WOMEN'S FAC),3400,2,3402,2004,169.8,3522
1631,1999,12,"CRC (CAL REHAB CTR, WOMEN)",371,436,807,500,161.4,842
1632,1999,12,CIW (CA INSTITUTION FOR WOMEN),1862,20,1882,1026,183.4,1747
1633,1999,12,WSP (WASCO SP),5316,13,5329,2984,178.6,5580
1634,1999,12,SCC (SIERRA CONSERVATION CENTER),5937,0,5937,3606,164.6,5884
1635,1999,12,SVSP (SALINAS VALLEY SP),4131,0,4131,2224,185.7,4240
1636,1999,12,RJD (RJ DONOVAN CORRECTIONAL FAC),4638,0,4638,2200,210.8,4688
1637,1999,12,PVSP (PLEASANT VALLEY SP),4631,0,4631,2208,209.7,4588
1638,1999,12,PBSP (PELICAN BAY SP),3382,0,3382,2280,148.3,3426
1639,1999,12,NKSP (NORTH KERN SP),4652,12,4664,2692,173.3,4872
1640,1999,12,MCSP (MULE CREEK SP),3535,0,3535,1700,207.9,3552
1641,1999,12,ISP (IRONWOOD SP),4581,0,4581,2200,208.2,4580
1642,1999,12,HDSP (HIGH DESERT SP),4264,5,4269,2224,192.0,4386
1643,1999,12,FOL (FOLSOM SP) (MALE),3799,0,3799,2072,183.3,3725
1644,1999,12,DVI (DEUEL VOCATIONAL INSTITUTION),3679,21,3700,1787,207.1,3841
1645,1999,12,CTF (CORRECTIONAL TRAINING FAC),7183,0,7183,3281,218.9,7161
1646,1999,12,CVSP (CHUCKAWALLA VALLEY SP),3515,0,3515,1738,202.2,3679
1647,1999,12,SATF (CA SUBSTANCE ABUSE TREAT FAC),6519,5,6524,3324,196.3,6585
1648,1999,12,"SOL (CA SP, SOLANO)",5731,1,5732,2610,219.6,5777
1649,1999,12,SQ (SAN QUENTIN SP),5619,22,5641,3278,172.1,5613
1650,1999,12,"SAC (CA SP, SACRAMENTO)",3038,0,3038,1728,175.8,3162
1651,1999,12,"LAC (CA SP, LOS ANGELES COUNTY)",4188,0,4188,2200,190.4,4180
1652,1999,12,"COR (CA SP, CORCORAN)",5010,0,5010,3016,166.1,5059
1653,1999,12,CEN (CENTINELA SP),4553,0,4553,2208,206.2,4588
1654,1999,12,CAL (CALIPATRIA SP),4144,0,4144,2208,187.7,4108
1655,1999,12,"CRC (CAL REHAB CTR, MEN)",2810,1285,4095,1814,225.7,3952
1656,1999,12,CMC (CA MEN'S COLONY),6884,0,6884,3884,177.2,6724
1657,1999,12,CMF (CA MEDICAL FAC),2974,0,2974,2315,128.5,3401
1658,1999,12,CIM (CA INSTITUTION FOR MEN),6214,35,6249,3078,203.0,6318
1659,1999,12,CCI (CA CORRECTIONAL INSTITUTION),5756,0,5756,2781,207.0,5920
1660,1999,12,CCC (CA CORRECTIONAL CENTER),5719,0,5719,3682,155.3,5657
1661,1999,12,ASP (AVENAL SP),6516,0,6516,2720,239.6,6593
1662,2000,1,VSP (VALLEY SP),3537,20,3557,1980,179.6,3498
1663,2000,1,SCC (SIERRA CONSERVATION CENTER),337,0,337,320,105.3,320
1664,2000,1,NCWF (NO CAL WOMEN'S FACIL),782,1,783,400,195.8,755
1665,2000,1,CCWF (CENTRAL CA WOMEN'S FAC),3307,1,3308,2004,165.1,3516
1666,2000,1,"CRC (CAL REHAB CTR, WOMEN)",369,447,816,500,163.2,842
1667,2000,1,CIW (CA INSTITUTION FOR WOMEN),1789,28,1817,1026,177.1,1742
1668,2000,1,WSP (WASCO SP),5735,29,5764,2984,193.2,5565
1669,2000,1,SCC (SIERRA CONSERVATION CENTER),6031,0,6031,3606,167.2,5819
1670,2000,1,SVSP (SALINAS VALLEY SP),4163,0,4163,2224,187.2,4164
1671,2000,1,RJD (RJ DONOVAN CORRECTIONAL FAC),4633,0,4633,2200,210.6,4673
1672,2000,1,PVSP (PLEASANT VALLEY SP),4605,0,4605,2208,208.6,4573
1673,2000,1,PBSP (PELICAN BAY SP),3343,0,3343,2280,146.6,3384
1674,2000,1,NKSP (NORTH KERN SP),4873,12,4885,2692,181.5,4857
1675,2000,1,MCSP (MULE CREEK SP),3531,0,3531,1700,207.7,3537
1676,2000,1,ISP (IRONWOOD SP),4610,0,4610,2200,209.5,4565
1677,2000,1,HDSP (HIGH DESERT SP),4288,4,4292,2224,193.0,4310
1678,2000,1,FOL (FOLSOM SP) (MALE),3792,0,3792,2072,183.0,3725
1679,2000,1,DVI (DEUEL VOCATIONAL INSTITUTION),3643,23,3666,1787,205.1,3841
1680,2000,1,CTF (CORRECTIONAL TRAINING FAC),7218,0,7218,3281,220.0,7161
1681,2000,1,CVSP (CHUCKAWALLA VALLEY SP),3681,0,3681,1738,211.8,3664
1682,2000,1,SATF (CA SUBSTANCE ABUSE TREAT FAC),6407,5,6412,3324,192.9,6450
1683,2000,1,"SOL (CA SP, SOLANO)",5667,1,5668,2610,217.2,5762
1684,2000,1,SQ (SAN QUENTIN SP),5794,15,5809,3278,177.2,5613
1685,2000,1,"SAC (CA SP, SACRAMENTO)",3038,0,3038,1728,175.8,3060
1686,2000,1,"LAC (CA SP, LOS ANGELES COUNTY)",4108,0,4108,2200,186.7,4140
1687,2000,1,"COR (CA SP, CORCORAN)",4856,0,4856,3016,161.0,5019
1688,2000,1,CEN (CENTINELA SP),4519,0,4519,2208,204.7,4573
1689,2000,1,CAL (CALIPATRIA SP),4062,0,4062,2208,184.0,4108
1690,2000,1,"CRC (CAL REHAB CTR, MEN)",2608,1334,3942,1814,217.3,3760
1691,2000,1,CMC (CA MEN'S COLONY),6774,1,6775,3884,174.4,6724
1692,2000,1,CMF (CA MEDICAL FAC),2941,0,2941,2315,127.0,3401
1693,2000,1,CIM (CA INSTITUTION FOR MEN),6227,38,6265,3078,203.5,6303
1694,2000,1,CCI (CA CORRECTIONAL INSTITUTION),5370,0,5370,2781,193.1,5561
1695,2000,1,CCC (CA CORRECTIONAL CENTER),5702,0,5702,3682,154.9,5642
1696,2000,1,ASP (AVENAL SP),6548,0,6548,2720,240.7,6578
1697,2000,2,VSP (VALLEY SP),3576,7,3583,1980,181.0,3498
1698,2000,2,SCC (SIERRA CONSERVATION CENTER),336,0,336,320,105.0,320
1699,2000,2,NCWF (NO CAL WOMEN'S FACIL),758,2,760,400,190.0,755
1700,2000,2,CCWF (CENTRAL CA WOMEN'S FAC),3336,2,3338,2004,166.6,3410
1701,2000,2,"CRC (CAL REHAB CTR, WOMEN)",358,475,833,500,166.6,842
1702,2000,2,CIW (CA INSTITUTION FOR WOMEN),1857,28,1885,1026,183.7,1742
1703,2000,2,WSP (WASCO SP),5736,20,5756,2984,192.9,5797
1704,2000,2,SCC (SIERRA CONSERVATION CENTER),5966,0,5966,3606,165.4,5819
1705,2000,2,SVSP (SALINAS VALLEY SP),4156,0,4156,2224,186.9,4164
1706,2000,2,RJD (RJ DONOVAN CORRECTIONAL FAC),4590,0,4590,2200,208.6,4673
1707,2000,2,PVSP (PLEASANT VALLEY SP),4648,0,4648,2208,210.5,4573
1708,2000,2,PBSP (PELICAN BAY SP),3339,1,3340,2280,146.5,3384
1709,2000,2,NKSP (NORTH KERN SP),4820,8,4828,2692,179.3,4857
1710,2000,2,MCSP (MULE CREEK SP),3532,0,3532,1700,207.8,3537
1711,2000,2,ISP (IRONWOOD SP),4561,0,4561,2200,207.3,4565
1712,2000,2,HDSP (HIGH DESERT SP),4279,5,4284,2224,192.6,4310
1713,2000,2,FOL (FOLSOM SP) (MALE),3825,0,3825,2072,184.6,3725
1714,2000,2,DVI (DEUEL VOCATIONAL INSTITUTION),3647,18,3665,1787,205.1,3841
1715,2000,2,CTF (CORRECTIONAL TRAINING FAC),7197,0,7197,3281,219.4,7161
1716,2000,2,CVSP (CHUCKAWALLA VALLEY SP),3577,0,3577,1738,205.8,3664
1717,2000,2,SATF (CA SUBSTANCE ABUSE TREAT FAC),6407,5,6412,3324,192.9,6450
1718,2000,2,"SOL (CA SP, SOLANO)",5752,1,5753,2610,220.4,5762
1719,2000,2,SQ (SAN QUENTIN SP),5879,32,5911,3278,180.3,5613
1720,2000,2,"SAC (CA SP, SACRAMENTO)",3003,0,3003,1728,173.8,3060
1721,2000,2,"LAC (CA SP, LOS ANGELES COUNTY)",4198,0,4198,2200,190.8,4140
1722,2000,2,"COR (CA SP, CORCORAN)",4861,0,4861,3016,161.2,4777
1723,2000,2,CEN (CENTINELA SP),4533,0,4533,2208,205.3,4573
1724,2000,2,CAL (CALIPATRIA SP),4084,0,4084,2208,185.0,4108
1725,2000,2,"CRC (CAL REHAB CTR, MEN)",2696,1312,4008,1814,220.9,3760
1726,2000,2,CMC (CA MEN'S COLONY),6646,1,6647,3884,171.1,6724
1727,2000,2,CMF (CA MEDICAL FAC),2933,0,2933,2315,126.7,3401
1728,2000,2,CIM (CA INSTITUTION FOR MEN),6246,38,6284,3078,204.2,6303
1729,2000,2,CCI (CA CORRECTIONAL INSTITUTION),5437,0,5437,2781,195.5,5561
1730,2000,2,CCC (CA CORRECTIONAL CENTER),5873,0,5873,3682,159.5,5642
1731,2000,2,ASP (AVENAL SP),6485,0,6485,2720,238.4,6578
1732,2000,3,VSP (VALLEY SP),3616,12,3628,1980,183.2,3498
1733,2000,3,SCC (SIERRA CONSERVATION CENTER),340,0,340,320,106.3,320
1734,2000,3,NCWF (NO CAL WOMEN'S FACIL),760,3,763,400,190.8,755
1735,2000,3,CCWF (CENTRAL CA WOMEN'S FAC),3370,1,3371,2004,168.2,3410
1736,2000,3,"CRC (CAL REHAB CTR, WOMEN)",338,474,812,500,162.4,842
1737,2000,3,CIW (CA INSTITUTION FOR WOMEN),1922,29,1951,1026,190.2,1742
1738,2000,3,WSP (WASCO SP),5884,16,5900,2984,197.7,5797
1739,2000,3,SCC (SIERRA CONSERVATION CENTER),6043,0,6043,3606,167.6,5819
1740,2000,3,SVSP (SALINAS VALLEY SP),4121,0,4121,2224,185.3,4164
1741,2000,3,RJD (RJ DONOVAN CORRECTIONAL FAC),4571,0,4571,2200,207.8,4673
1742,2000,3,PVSP (PLEASANT VALLEY SP),4581,0,4581,2208,207.5,4573
1743,2000,3,PBSP (PELICAN BAY SP),3345,0,3345,2280,146.7,3384
1744,2000,3,NKSP (NORTH KERN SP),4989,9,4998,2692,185.7,5210
1745,2000,3,MCSP (MULE CREEK SP),3488,0,3488,1700,205.2,3537
1746,2000,3,ISP (IRONWOOD SP),4580,0,4580,2200,208.2,4565
1747,2000,3,HDSP (HIGH DESERT SP),4305,2,4307,2224,193.7,4310
1748,2000,3,FOL (FOLSOM SP) (MALE),3889,0,3889,2072,187.7,3725
1749,2000,3,DVI (DEUEL VOCATIONAL INSTITUTION),3782,21,3803,1787,212.8,3841
1750,2000,3,CTF (CORRECTIONAL TRAINING FAC),7189,0,7189,3281,219.1,7161
1751,2000,3,CVSP (CHUCKAWALLA VALLEY SP),3647,0,3647,1738,209.8,3664
1752,2000,3,SATF (CA SUBSTANCE ABUSE TREAT FAC),6273,5,6278,3324,188.9,6450
1753,2000,3,"SOL (CA SP, SOLANO)",5805,0,5805,2610,222.4,5762
1754,2000,3,SQ (SAN QUENTIN SP),5972,24,5996,3278,182.9,5613
1755,2000,3,"SAC (CA SP, SACRAMENTO)",3024,0,3024,1728,175.0,3060
1756,2000,3,"LAC (CA SP, LOS ANGELES COUNTY)",4171,0,4171,2200,189.6,4140
1757,2000,3,"COR (CA SP, CORCORAN)",5036,0,5036,3016,167.0,4898
1758,2000,3,CEN (CENTINELA SP),4478,0,4478,2208,202.8,4573
1759,2000,3,CAL (CALIPATRIA SP),4127,0,4127,2208,186.9,4108
1760,2000,3,"CRC (CAL REHAB CTR, MEN)",2680,1338,4018,1814,221.5,3760
1761,2000,3,CMC (CA MEN'S COLONY),6699,2,6701,3884,172.5,6724
1762,2000,3,CMF (CA MEDICAL FAC),3098,0,3098,2315,133.8,3401
1763,2000,3,CIM (CA INSTITUTION FOR MEN),6317,34,6351,3078,206.3,6303
1764,2000,3,CCI (CA CORRECTIONAL INSTITUTION),5312,1,5313,2781,191.0,5561
1765,2000,3,CCC (CA CORRECTIONAL CENTER),5826,0,5826,3682,158.2,5642
1766,2000,3,ASP (AVENAL SP),6525,0,6525,2720,239.9,6578
1767,2000,4,VSP (VALLEY SP),3588,6,3594,1980,181.5,3503
1768,2000,4,SCC (SIERRA CONSERVATION CENTER),335,0,335,320,104.7,320
1769,2000,4,NCWF (NO CAL WOMEN'S FACIL),762,0,762,400,190.5,755
1770,2000,4,CCWF (CENTRAL CA WOMEN'S FAC),3332,2,3334,2004,166.4,3463
1771,2000,4,"CRC (CAL REHAB CTR, WOMEN)",330,491,821,500,164.2,842
1772,2000,4,CIW (CA INSTITUTION FOR WOMEN),1894,29,1923,1026,187.4,1742
1773,2000,4,WSP (WASCO SP),5955,25,5980,2984,200.4,5797
1774,2000,4,SCC (SIERRA CONSERVATION CENTER),6018,1,6019,3606,166.9,5869
1775,2000,4,SVSP (SALINAS VALLEY SP),4167,0,4167,2224,187.4,4164
1776,2000,4,RJD (RJ DONOVAN CORRECTIONAL FAC),4577,0,4577,2200,208.0,4673
1777,2000,4,PVSP (PLEASANT VALLEY SP),4624,0,4624,2208,209.4,4573
1778,2000,4,PBSP (PELICAN BAY SP),3379,0,3379,2280,148.2,3376
1779,2000,4,NKSP (NORTH KERN SP),5011,6,5017,2692,186.4,5089
1780,2000,4,MCSP (MULE CREEK SP),3304,0,3304,1700,194.4,3537
1781,2000,4,ISP (IRONWOOD SP),4667,0,4667,2200,212.1,4565
1782,2000,4,HDSP (HIGH DESERT SP),4300,4,4304,2224,193.5,4310
1783,2000,4,FOL (FOLSOM SP) (MALE),3871,0,3871,2072,186.8,3725
1784,2000,4,DVI (DEUEL VOCATIONAL INSTITUTION),3874,11,3885,1787,217.4,3841
1785,2000,4,CTF (CORRECTIONAL TRAINING FAC),7147,0,7147,3281,217.8,7161
1786,2000,4,CVSP (CHUCKAWALLA VALLEY SP),3657,0,3657,1738,210.4,3664
1787,2000,4,SATF (CA SUBSTANCE ABUSE TREAT FAC),6336,5,6341,3324,190.8,6450
1788,2000,4,"SOL (CA SP, SOLANO)",5827,0,5827,2610,223.3,5762
1789,2000,4,SQ (SAN QUENTIN SP),5806,14,5820,3278,177.5,5613
1790,2000,4,"SAC (CA SP, SACRAMENTO)",2907,0,2907,1728,168.2,3144
1791,2000,4,"LAC (CA SP, LOS ANGELES COUNTY)",4216,0,4216,2200,191.6,4140
1792,2000,4,"COR (CA SP, CORCORAN)",4877,0,4877,3016,161.7,5019
1793,2000,4,CEN (CENTINELA SP),4456,0,4456,2208,201.8,4573
1794,2000,4,CAL (CALIPATRIA SP),4142,0,4142,2208,187.6,4068
1795,2000,4,"CRC (CAL REHAB CTR, MEN)",2690,1334,4024,1814,221.8,3952
1796,2000,4,CMC (CA MEN'S COLONY),6691,1,6692,3884,172.3,6724
1797,2000,4,CMF (CA MEDICAL FAC),3045,0,3045,2315,131.5,3401
1798,2000,4,CIM (CA INSTITUTION FOR MEN),6149,40,6189,3078,201.1,6303
1799,2000,4,CCI (CA CORRECTIONAL INSTITUTION),5375,1,5376,2781,193.3,5528
1800,2000,4,CCC (CA CORRECTIONAL CENTER),5850,0,5850,3682,158.9,5642
1801,2000,4,ASP (AVENAL SP),6454,0,6454,2720,237.3,6578
1802,2000,5,VSP (VALLEY SP),3499,12,3511,1980,177.3,3580
1803,2000,5,SCC (SIERRA CONSERVATION CENTER),333,0,333,320,104.1,320
1804,2000,5,NCWF (NO CAL WOMEN'S FACIL),758,3,761,400,190.3,755
1805,2000,5,CCWF (CENTRAL CA WOMEN'S FAC),3450,2,3452,2004,172.3,3463
1806,2000,5,"CRC (CAL REHAB CTR, WOMEN)",314,476,790,500,158.0,842
1807,2000,5,CIW (CA INSTITUTION FOR WOMEN),1865,39,1904,1026,185.6,1742
1808,2000,5,WSP (WASCO SP),5937,15,5952,2984,199.5,5797
1809,2000,5,SCC (SIERRA CONSERVATION CENTER),5995,0,5995,3606,166.3,5869
1810,2000,5,SVSP (SALINAS VALLEY SP),4233,0,4233,2224,190.3,4164
1811,2000,5,RJD (RJ DONOVAN CORRECTIONAL FAC),4589,0,4589,2200,208.6,4673
1812,2000,5,PVSP (PLEASANT VALLEY SP),4655,0,4655,2208,210.8,4573
1813,2000,5,PBSP (PELICAN BAY SP),3320,0,3320,2280,145.6,3376
1814,2000,5,NKSP (NORTH KERN SP),4897,9,4906,2692,182.2,5089
1815,2000,5,MCSP (MULE CREEK SP),3465,0,3465,1700,203.8,3537
1816,2000,5,ISP (IRONWOOD SP),4646,0,4646,2200,211.2,4565
1817,2000,5,HDSP (HIGH DESERT SP),4326,3,4329,2224,194.6,4310
1818,2000,5,FOL (FOLSOM SP) (MALE),3857,0,3857,2072,186.1,3725
1819,2000,5,DVI (DEUEL VOCATIONAL INSTITUTION),3799,10,3809,1787,213.2,3841
1820,2000,5,CTF (CORRECTIONAL TRAINING FAC),7220,10,7230,3281,220.4,7161
1821,2000,5,CVSP (CHUCKAWALLA VALLEY SP),3633,0,3633,1738,209.0,3664
1822,2000,5,SATF (CA SUBSTANCE ABUSE TREAT FAC),6314,5,6319,3324,190.1,6450
1823,2000,5,"SOL (CA SP, SOLANO)",5709,0,5709,2610,218.7,5762
1824,2000,5,SQ (SAN QUENTIN SP),5785,9,5794,3278,176.8,5613
1825,2000,5,"SAC (CA SP, SACRAMENTO)",2972,0,2972,1728,172.0,3144
1826,2000,5,"LAC (CA SP, LOS ANGELES COUNTY)",4157,0,4157,2200,189.0,4140
1827,2000,5,"COR (CA SP, CORCORAN)",4879,0,4879,3016,161.8,5019
1828,2000,5,CEN (CENTINELA SP),4494,0,4494,2208,203.5,4573
1829,2000,5,CAL (CALIPATRIA SP),4052,0,4052,2208,183.5,4068
1830,2000,5,"CRC (CAL REHAB CTR, MEN)",2699,1348,4047,1814,223.1,3952
1831,2000,5,CMC (CA MEN'S COLONY),6662,0,6662,3884,171.5,6724
1832,2000,5,CMF (CA MEDICAL FAC),3047,0,3047,2315,131.6,3401
1833,2000,5,CIM (CA INSTITUTION FOR MEN),6344,43,6387,3078,207.5,6303
1834,2000,5,CCI (CA CORRECTIONAL INSTITUTION),5310,0,5310,2781,190.9,5528
1835,2000,5,CCC (CA CORRECTIONAL CENTER),5870,0,5870,3682,159.4,5642
1836,2000,5,ASP (AVENAL SP),6475,0,6475,2720,238.1,6578
1837,2000,6,VSP (VALLEY SP),3471,8,3479,1980,175.7,3580
1838,2000,6,SCC (SIERRA CONSERVATION CENTER),342,0,342,320,106.9,320
1839,2000,6,NCWF (NO CAL WOMEN'S FACIL),766,2,768,400,192.0,755
1840,2000,6,CCWF (CENTRAL CA WOMEN'S FAC),3469,4,3473,2004,173.3,3463
1841,2000,6,"CRC (CAL REHAB CTR, WOMEN)",302,482,784,500,156.8,842
1842,2000,6,CIW (CA INSTITUTION FOR WOMEN),1859,38,1897,1026,184.9,1742
1843,2000,6,WSP (WASCO SP),5911,31,5942,2984,199.1,5797
1844,2000,6,SCC (SIERRA CONSERVATION CENTER),6000,0,6000,3606,166.4,5869
1845,2000,6,SVSP (SALINAS VALLEY SP),4204,0,4204,2224,189.0,4156
1846,2000,6,RJD (RJ DONOVAN CORRECTIONAL FAC),4642,0,4642,2200,211.0,4673
1847,2000,6,PVSP (PLEASANT VALLEY SP),4653,0,4653,2208,210.7,4573
1848,2000,6,PBSP (PELICAN BAY SP),3299,0,3299,2280,144.7,3376
1849,2000,6,NKSP (NORTH KERN SP),4946,6,4952,2692,184.0,5089
1850,2000,6,MCSP (MULE CREEK SP),3562,0,3562,1700,209.5,3537
1851,2000,6,ISP (IRONWOOD SP),4637,0,4637,2200,210.8,4565
1852,2000,6,HDSP (HIGH DESERT SP),4315,2,4317,2224,194.1,4310
1853,2000,6,FOL (FOLSOM SP) (MALE),3882,0,3882,2072,187.4,3725
1854,2000,6,DVI (DEUEL VOCATIONAL INSTITUTION),3732,24,3756,1787,210.2,3841
1855,2000,6,CTF (CORRECTIONAL TRAINING FAC),7212,1,7213,3281,219.8,7161
1856,2000,6,CVSP (CHUCKAWALLA VALLEY SP),3618,0,3618,1738,208.2,3664
1857,2000,6,SATF (CA SUBSTANCE ABUSE TREAT FAC),6310,5,6315,3324,190.0,6450
1858,2000,6,"SOL (CA SP, SOLANO)",5862,0,5862,2610,224.6,5762
1859,2000,6,SQ (SAN QUENTIN SP),5944,9,5953,3278,181.6,5613
1860,2000,6,"SAC (CA SP, SACRAMENTO)",2953,0,2953,1728,170.9,3144
1861,2000,6,"LAC (CA SP, LOS ANGELES COUNTY)",4202,0,4202,2200,191.0,4140
1862,2000,6,"COR (CA SP, CORCORAN)",4941,0,4941,3016,163.8,4903
1863,2000,6,CEN (CENTINELA SP),4568,0,4568,2208,206.9,4573
1864,2000,6,CAL (CALIPATRIA SP),4019,0,4019,2208,182.0,4068
1865,2000,6,"CRC (CAL REHAB CTR, MEN)",2649,1362,4011,1814,221.1,3952
1866,2000,6,CMC (CA MEN'S COLONY),6696,1,6697,3884,172.4,6724
1867,2000,6,CMF (CA MEDICAL FAC),3040,0,3040,2315,131.3,3401
1868,2000,6,CIM (CA INSTITUTION FOR MEN),6298,50,6348,3078,206.2,6303
1869,2000,6,CCI (CA CORRECTIONAL INSTITUTION),5250,0,5250,2781,188.8,5528
1870,2000,6,CCC (CA CORRECTIONAL CENTER),5920,0,5920,3682,160.8,5642
1871,2000,6,ASP (AVENAL SP),6558,0,6558,2720,241.1,6578
1872,2000,7,VSP (VALLEY SP),3428,7,3435,1980,173.5,3503
1873,2000,7,SCC (SIERRA CONSERVATION CENTER),325,0,325,320,101.6,320
1874,2000,7,NCWF (NO CAL WOMEN'S FACIL),756,2,758,400,189.5,755
1875,2000,7,CCWF (CENTRAL CA WOMEN'S FAC),3434,6,3440,2004,171.7,3463
1876,2000,7,"CRC (CAL REHAB CTR, WOMEN)",301,500,801,500,160.2,842
1877,2000,7,CIW (CA INSTITUTION FOR WOMEN),1851,30,1881,1026,183.3,1742
1878,2000,7,WSP (WASCO SP),5881,31,5912,2984,198.1,5797
1879,2000,7,SCC (SIERRA CONSERVATION CENTER),6059,0,6059,3606,168.0,5869
1880,2000,7,SVSP (SALINAS VALLEY SP),4206,0,4206,2224,189.1,4156
1881,2000,7,RJD (RJ DONOVAN CORRECTIONAL FAC),4694,0,4694,2200,213.4,4673
1882,2000,7,PVSP (PLEASANT VALLEY SP),4647,0,4647,2208,210.5,4573
1883,2000,7,PBSP (PELICAN BAY SP),3290,1,3291,2280,144.3,3376
1884,2000,7,NKSP (NORTH KERN SP),4934,6,4940,2692,183.5,5089
1885,2000,7,MCSP (MULE CREEK SP),3540,0,3540,1700,208.2,3537
1886,2000,7,ISP (IRONWOOD SP),4587,0,4587,2200,208.5,4565
1887,2000,7,HDSP (HIGH DESERT SP),4338,5,4343,2224,195.3,4310
1888,2000,7,FOL (FOLSOM SP) (MALE),3822,0,3822,2072,184.5,3725
1889,2000,7,DVI (DEUEL VOCATIONAL INSTITUTION),3818,29,3847,1787,215.3,3909
1890,2000,7,CTF (CORRECTIONAL TRAINING FAC),7213,0,7213,3281,219.8,7161
1891,2000,7,CVSP (CHUCKAWALLA VALLEY SP),3621,0,3621,1738,208.3,3664
1892,2000,7,SATF (CA SUBSTANCE ABUSE TREAT FAC),6308,9,6317,3324,190.0,6450
1893,2000,7,"SOL (CA SP, SOLANO)",5790,0,5790,2610,221.8,5762
1894,2000,7,SQ (SAN QUENTIN SP),5830,18,5848,3273,178.7,5533
1895,2000,7,"SAC (CA SP, SACRAMENTO)",2966,0,2966,1728,171.6,3144
1896,2000,7,"LAC (CA SP, LOS ANGELES COUNTY)",4184,0,4184,2200,190.2,4140
1897,2000,7,"COR (CA SP, CORCORAN)",4805,0,4805,3016,159.3,4903
1898,2000,7,CEN (CENTINELA SP),4516,0,4516,2208,204.5,4573
1899,2000,7,CAL (CALIPATRIA SP),4097,0,4097,2208,185.6,4068
1900,2000,7,"CRC (CAL REHAB CTR, MEN)",2632,1357,3989,1814,219.9,3952
1901,2000,7,CMC (CA MEN'S COLONY),6694,0,6694,3884,172.3,6724
1902,2000,7,CMF (CA MEDICAL FAC),2961,0,2961,2315,127.9,3401
1903,2000,7,CIM (CA INSTITUTION FOR MEN),6285,49,6334,3078,205.8,6303
1904,2000,7,CCI (CA CORRECTIONAL INSTITUTION),5262,0,5262,2781,189.2,5497
1905,2000,7,CCC (CA CORRECTIONAL CENTER),5913,0,5913,3682,160.6,5642
1906,2000,7,ASP (AVENAL SP),6603,0,6603,2820,234.1,6678
1907,2000,8,VSP (VALLEY SP),3484,14,3498,1980,176.7,3503
1908,2000,8,SCC (SIERRA CONSERVATION CENTER),313,0,313,320,97.8,320
1909,2000,8,NCWF (NO CAL WOMEN'S FACIL),753,0,753,400,188.3,755
1910,2000,8,CCWF (CENTRAL CA WOMEN'S FAC),3426,5,3431,2004,171.2,3463
1911,2000,8,"CRC (CAL REHAB CTR, WOMEN)",308,474,782,500,156.4,842
1912,2000,8,CIW (CA INSTITUTION FOR WOMEN),1900,26,1926,1026,187.7,1742
1913,2000,8,WSP (WASCO SP),6077,13,6090,2984,204.1,5797
1914,2000,8,SCC (SIERRA CONSERVATION CENTER),6113,0,6113,3606,169.5,5869
1915,2000,8,SVSP (SALINAS VALLEY SP),4218,0,4218,2224,189.7,4156
1916,2000,8,RJD (RJ DONOVAN CORRECTIONAL FAC),4671,0,4671,2200,212.3,4673
1917,2000,8,PVSP (PLEASANT VALLEY SP),4639,0,4639,2208,210.1,4573
1918,2000,8,PBSP (PELICAN BAY SP),3364,0,3364,2280,147.5,3376
1919,2000,8,NKSP (NORTH KERN SP),4948,7,4955,2692,184.1,5089
1920,2000,8,MCSP (MULE CREEK SP),3513,0,3513,1700,206.6,3537
1921,2000,8,ISP (IRONWOOD SP),4654,0,4654,2200,211.5,4565
1922,2000,8,HDSP (HIGH DESERT SP),4330,5,4335,2224,194.9,4310
1923,2000,8,FOL (FOLSOM SP) (MALE),3884,0,3884,2072,187.5,3725
1924,2000,8,DVI (DEUEL VOCATIONAL INSTITUTION),3891,27,3918,1787,219.3,3909
1925,2000,8,CTF (CORRECTIONAL TRAINING FAC),7174,0,7174,3281,218.7,7161
1926,2000,8,CVSP (CHUCKAWALLA VALLEY SP),3647,0,3647,1738,209.8,3664
1927,2000,8,SATF (CA SUBSTANCE ABUSE TREAT FAC),6283,11,6294,3324,189.4,6570
1928,2000,8,"SOL (CA SP, SOLANO)",5758,0,5758,2610,220.6,5762
1929,2000,8,SQ (SAN QUENTIN SP),5920,32,5952,3273,181.9,5533
1930,2000,8,"SAC (CA SP, SACRAMENTO)",2983,0,2983,1728,172.6,3144
1931,2000,8,"LAC (CA SP, LOS ANGELES COUNTY)",4208,0,4208,2200,191.3,4140
1932,2000,8,"COR (CA SP, CORCORAN)",4889,0,4889,3016,162.1,5018
1933,2000,8,CEN (CENTINELA SP),4484,0,4484,2208,203.1,4573
1934,2000,8,CAL (CALIPATRIA SP),4153,0,4153,2208,188.1,4068
1935,2000,8,"CRC (CAL REHAB CTR, MEN)",2595,1389,3984,1814,219.6,3952
1936,2000,8,CMC (CA MEN'S COLONY),6726,0,6726,3884,173.2,6974
1937,2000,8,CMF (CA MEDICAL FAC),3022,0,3022,2315,130.5,3401
1938,2000,8,CIM (CA INSTITUTION FOR MEN),6122,46,6168,3078,200.4,6303
1939,2000,8,CCI (CA CORRECTIONAL INSTITUTION),5353,0,5353,2889,185.3,5744
1940,2000,8,CCC (CA CORRECTIONAL CENTER),5816,0,5816,3682,158.0,5642
1941,2000,8,ASP (AVENAL SP),6798,0,6798,2820,241.1,6870
1942,2000,9,VSP (VALLEY SP),3511,9,3520,1980,177.8,3503
1943,2000,9,SCC (SIERRA CONSERVATION CENTER),335,0,335,320,104.7,320
1944,2000,9,NCWF (NO CAL WOMEN'S FACIL),769,3,772,400,193.0,755
1945,2000,9,CCWF (CENTRAL CA WOMEN'S FAC),3348,8,3356,2004,167.5,3463
1946,2000,9,"CRC (CAL REHAB CTR, WOMEN)",285,474,759,500,151.8,842
1947,2000,9,CIW (CA INSTITUTION FOR WOMEN),1867,28,1895,1026,184.7,1742
1948,2000,9,WSP (WASCO SP),5859,13,5872,2984,196.8,5797
1949,2000,9,SCC (SIERRA CONSERVATION CENTER),6039,0,6039,3606,167.5,5869
1950,2000,9,SVSP (SALINAS VALLEY SP),4171,0,4171,2224,187.5,4156
1951,2000,9,RJD (RJ DONOVAN CORRECTIONAL FAC),4656,0,4656,2200,211.6,4673
1952,2000,9,PVSP (PLEASANT VALLEY SP),4639,0,4639,2208,210.1,4573
1953,2000,9,PBSP (PELICAN BAY SP),3389,1,3390,2280,148.7,3376
1954,2000,9,NKSP (NORTH KERN SP),4945,6,4951,2692,183.9,5089
1955,2000,9,MCSP (MULE CREEK SP),3497,0,3497,1700,205.7,3537
1956,2000,9,ISP (IRONWOOD SP),4609,0,4609,2200,209.5,4565
1957,2000,9,HDSP (HIGH DESERT SP),4354,3,4357,2224,195.9,4310
1958,2000,9,FOL (FOLSOM SP) (MALE),3822,0,3822,2072,184.5,3725
1959,2000,9,DVI (DEUEL VOCATIONAL INSTITUTION),3978,13,3991,1787,223.3,3909
1960,2000,9,CTF (CORRECTIONAL TRAINING FAC),7192,0,7192,4652,154.6,10242
1961,2000,9,CVSP (CHUCKAWALLA VALLEY SP),3542,0,3542,1738,203.8,3664
1962,2000,9,SATF (CA SUBSTANCE ABUSE TREAT FAC),6365,10,6375,3324,191.8,6570
1963,2000,9,"SOL (CA SP, SOLANO)",5822,0,5822,2610,223.1,5762
1964,2000,9,SQ (SAN QUENTIN SP),5888,16,5904,3273,180.4,5533
1965,2000,9,"SAC (CA SP, SACRAMENTO)",2986,0,2986,1728,172.8,3144
1966,2000,9,"LAC (CA SP, LOS ANGELES COUNTY)",4191,0,4191,2200,190.5,4140
1967,2000,9,"COR (CA SP, CORCORAN)",4921,0,4921,3016,163.2,5018
1968,2000,9,CEN (CENTINELA SP),4518,0,4518,2208,204.6,4573
1969,2000,9,CAL (CALIPATRIA SP),4173,0,4173,2208,189.0,4068
1970,2000,9,"CRC (CAL REHAB CTR, MEN)",2595,1405,4000,1814,220.5,3952
1971,2000,9,CMC (CA MEN'S COLONY),6793,0,6793,3884,174.9,6974
1972,2000,9,CMF (CA MEDICAL FAC),3033,0,3033,2315,131.0,3401
1973,2000,9,CIM (CA INSTITUTION FOR MEN),6356,60,6416,3078,208.4,6303
1974,2000,9,CCI (CA CORRECTIONAL INSTITUTION),5381,0,5381,2889,186.3,5744
1975,2000,9,CCC (CA CORRECTIONAL CENTER),5749,1,5750,3682,156.2,5642
1976,2000,9,ASP (AVENAL SP),6726,0,6726,2820,238.5,6870
1977,2000,10,VSP (VALLEY SP),3394,13,3407,1980,172.1,3503
1978,2000,10,SCC (SIERRA CONSERVATION CENTER),336,0,336,320,105.0,320
1979,2000,10,NCWF (NO CAL WOMEN'S FACIL),749,2,751,400,187.8,755
1980,2000,10,CCWF (CENTRAL CA WOMEN'S FAC),3363,7,3370,2004,168.2,3463
1981,2000,10,"CRC (CAL REHAB CTR, WOMEN)",320,476,796,500,159.2,842
1982,2000,10,CIW (CA INSTITUTION FOR WOMEN),1872,23,1895,1026,184.7,1742
1983,2000,10,WSP (WASCO SP),5920,20,5940,2984,199.1,5797
1984,2000,10,SCC (SIERRA CONSERVATION CENTER),5957,0,5957,3606,165.2,5869
1985,2000,10,SVSP (SALINAS VALLEY SP),4099,0,4099,2224,184.3,4156
1986,2000,10,RJD (RJ DONOVAN CORRECTIONAL FAC),4596,0,4596,2200,208.9,4673
1987,2000,10,PVSP (PLEASANT VALLEY SP),4628,0,4628,2208,209.6,4573
1988,2000,10,PBSP (PELICAN BAY SP),3360,0,3360,2280,147.4,3376
1989,2000,10,NKSP (NORTH KERN SP),5042,7,5049,2692,187.6,5089
1990,2000,10,MCSP (MULE CREEK SP),3452,0,3452,1700,203.1,3537
1991,2000,10,ISP (IRONWOOD SP),4604,0,4604,2200,209.3,4565
1992,2000,10,HDSP (HIGH DESERT SP),4286,1,4287,2224,192.8,4310
1993,2000,10,FOL (FOLSOM SP) (MALE),3889,0,3889,2072,187.7,3725
1994,2000,10,DVI (DEUEL VOCATIONAL INSTITUTION),3929,18,3947,1787,220.9,3909
1995,2000,10,CTF (CORRECTIONAL TRAINING FAC),7196,0,7196,3281,219.3,7161
1996,2000,10,CVSP (CHUCKAWALLA VALLEY SP),3591,0,3591,1738,206.6,3664
1997,2000,10,SATF (CA SUBSTANCE ABUSE TREAT FAC),6385,13,6398,3324,192.5,6570
1998,2000,10,"SOL (CA SP, SOLANO)",5830,0,5830,2610,223.4,5762
1999,2000,10,SQ (SAN QUENTIN SP),5652,6,5658,3273,172.9,5533
2000,2000,10,"SAC (CA SP, SACRAMENTO)",2974,1,2975,1728,172.2,3042
2001,2000,10,"LAC (CA SP, LOS ANGELES COUNTY)",4184,0,4184,2200,190.2,4140
2002,2000,10,"COR (CA SP, CORCORAN)",4939,1,4940,3016,163.8,5140
2003,2000,10,CEN (CENTINELA SP),4497,0,4497,2208,203.7,4573
2004,2000,10,CAL (CALIPATRIA SP),4122,0,4122,2208,186.7,4068
2005,2000,10,"CRC (CAL REHAB CTR, MEN)",2638,1443,4081,1814,225.0,3952
2006,2000,10,CMC (CA MEN'S COLONY),6750,0,6750,3884,173.8,6974
2007,2000,10,CMF (CA MEDICAL FAC),3070,0,3070,2315,132.6,3401
2008,2000,10,CIM (CA INSTITUTION FOR MEN),6240,59,6299,3078,204.6,6303
2009,2000,10,CCI (CA CORRECTIONAL INSTITUTION),5473,0,5473,2781,196.8,5600
2010,2000,10,CCC (CA CORRECTIONAL CENTER),5886,0,5886,3682,159.9,5642
2011,2000,10,ASP (AVENAL SP),6826,1,6827,2920,233.8,6978
2012,2000,11,VSP (VALLEY SP),3286,4,3290,1980,166.2,3503
2013,2000,11,SCC (SIERRA CONSERVATION CENTER),323,0,323,320,100.9,320
2014,2000,11,NCWF (NO CAL WOMEN'S FACIL),723,1,724,400,181.0,755
2015,2000,11,CCWF (CENTRAL CA WOMEN'S FAC),3384,7,3391,2004,169.2,3463
2016,2000,11,"CRC (CAL REHAB CTR, WOMEN)",331,484,815,500,163.0,842
2017,2000,11,CIW (CA INSTITUTION FOR WOMEN),1976,23,1999,1026,194.8,1742
2018,2000,11,WSP (WASCO SP),5831,16,5847,2984,195.9,5797
2019,2000,11,SCC (SIERRA CONSERVATION CENTER),5991,0,5991,3606,166.1,5869
2020,2000,11,SVSP (SALINAS VALLEY SP),4101,0,4101,2224,184.4,4156
2021,2000,11,RJD (RJ DONOVAN CORRECTIONAL FAC),4631,0,4631,2200,210.5,4673
2022,2000,11,PVSP (PLEASANT VALLEY SP),4637,0,4637,2208,210.0,4573
2023,2000,11,PBSP (PELICAN BAY SP),3333,0,3333,2280,146.2,3376
2024,2000,11,NKSP (NORTH KERN SP),5006,5,5011,2692,186.1,5089
2025,2000,11,MCSP (MULE CREEK SP),3493,0,3493,1700,205.5,3537
2026,2000,11,ISP (IRONWOOD SP),4566,0,4566,2200,207.5,4565
2027,2000,11,HDSP (HIGH DESERT SP),4306,4,4310,2224,193.8,4310
2028,2000,11,FOL (FOLSOM SP) (MALE),3835,0,3835,2072,185.1,3725
2029,2000,11,DVI (DEUEL VOCATIONAL INSTITUTION),3840,22,3862,1787,216.1,3909
2030,2000,11,CTF (CORRECTIONAL TRAINING FAC),7118,0,7118,3281,216.9,7161
2031,2000,11,CVSP (CHUCKAWALLA VALLEY SP),3634,0,3634,1738,209.1,3664
2032,2000,11,SATF (CA SUBSTANCE ABUSE TREAT FAC),6350,12,6362,3324,191.4,6570
2033,2000,11,"SOL (CA SP, SOLANO)",5791,0,5791,2610,221.9,5762
2034,2000,11,SQ (SAN QUENTIN SP),5665,8,5673,3273,173.3,5533
2035,2000,11,"SAC (CA SP, SACRAMENTO)",2950,0,2950,1728,170.7,3042
2036,2000,11,"LAC (CA SP, LOS ANGELES COUNTY)",4150,0,4150,2200,188.6,4140
2037,2000,11,"COR (CA SP, CORCORAN)",4947,0,4947,3016,164.0,5140
2038,2000,11,CEN (CENTINELA SP),4483,0,4483,2208,203.0,4573
2039,2000,11,CAL (CALIPATRIA SP),4128,0,4128,2208,187.0,4068
2040,2000,11,"CRC (CAL REHAB CTR, MEN)",2662,1435,4097,1814,225.9,3952
2041,2000,11,CMC (CA MEN'S COLONY),6829,0,6829,3884,175.8,6974
2042,2000,11,CMF (CA MEDICAL FAC),3072,0,3072,2315,132.7,3401
2043,2000,11,CIM (CA INSTITUTION FOR MEN),6124,47,6171,3078,200.5,6303
2044,2000,11,CCI (CA CORRECTIONAL INSTITUTION),5532,0,5532,2781,198.9,5600
2045,2000,11,CCC (CA CORRECTIONAL CENTER),5833,0,5833,3682,158.4,5642
2046,2000,11,ASP (AVENAL SP),6818,0,6818,2920,233.5,6978
2047,2000,12,VSP (VALLEY SP),3332,14,3346,1980,169.0,3503
2048,2000,12,SCC (SIERRA CONSERVATION CENTER),339,0,339,320,105.9,320
2049,2000,12,NCWF (NO CAL WOMEN'S FACIL),729,3,732,400,183.0,755
2050,2000,12,CCWF (CENTRAL CA WOMEN'S FAC),3417,9,3426,2004,171.0,3463
2051,2000,12,"CRC (CAL REHAB CTR, WOMEN)",308,462,770,500,154.0,842
2052,2000,12,CIW (CA INSTITUTION FOR WOMEN),1918,17,1935,1026,188.6,1742
2053,2000,12,WSP (WASCO SP),5774,24,5798,2984,194.3,5797
2054,2000,12,SCC (SIERRA CONSERVATION CENTER),5979,0,5979,3606,165.8,5869
2055,2000,12,SVSP (SALINAS VALLEY SP),4104,0,4104,2224,184.5,4156
2056,2000,12,RJD (RJ DONOVAN CORRECTIONAL FAC),4597,0,4597,2200,209.0,4673
2057,2000,12,PVSP (PLEASANT VALLEY SP),4604,0,4604,2208,208.5,4573
2058,2000,12,PBSP (PELICAN BAY SP),3324,0,3324,2280,145.8,3376
2059,2000,12,NKSP (NORTH KERN SP),4893,4,4897,2692,181.9,5089
2060,2000,12,MCSP (MULE CREEK SP),3499,0,3499,1700,205.8,3537
2061,2000,12,ISP (IRONWOOD SP),4559,0,4559,2200,207.2,4565
2062,2000,12,HDSP (HIGH DESERT SP),4334,2,4336,2224,195.0,4310
2063,2000,12,FOL (FOLSOM SP) (MALE),3862,0,3862,2072,186.4,3725
2064,2000,12,DVI (DEUEL VOCATIONAL INSTITUTION),3853,31,3884,1787,217.3,3909
2065,2000,12,CTF (CORRECTIONAL TRAINING FAC),6648,0,6648,3281,202.6,7161
2066,2000,12,CVSP (CHUCKAWALLA VALLEY SP),3637,0,3637,1738,209.3,3664
2067,2000,12,SATF (CA SUBSTANCE ABUSE TREAT FAC),6078,12,6090,3324,183.2,6450
2068,2000,12,"SOL (CA SP, SOLANO)",5806,0,5806,2610,222.5,5762
2069,2000,12,SQ (SAN QUENTIN SP),5593,12,5605,3273,171.2,5533
2070,2000,12,"SAC (CA SP, SACRAMENTO)",3056,0,3056,1728,176.9,3182
2071,2000,12,"LAC (CA SP, LOS ANGELES COUNTY)",4322,0,4322,2200,196.5,4260
2072,2000,12,"COR (CA SP, CORCORAN)",4986,0,4986,3016,165.3,5140
2073,2000,12,CEN (CENTINELA SP),4479,0,4479,2208,202.9,4573
2074,2000,12,CAL (CALIPATRIA SP),4077,0,4077,2208,184.6,4068
2075,2000,12,"CRC (CAL REHAB CTR, MEN)",2705,1323,4028,1814,222.1,3952
2076,2000,12,CMC (CA MEN'S COLONY),6931,0,6931,3884,178.5,6974
2077,2000,12,CMF (CA MEDICAL FAC),3039,0,3039,2315,131.3,3401
2078,2000,12,CIM (CA INSTITUTION FOR MEN),6092,45,6137,3078,199.4,6303
2079,2000,12,CCI (CA CORRECTIONAL INSTITUTION),5504,0,5504,2781,197.9,5600
2080,2000,12,CCC (CA CORRECTIONAL CENTER),5753,0,5753,3682,156.2,5642
2081,2000,12,ASP (AVENAL SP),6895,0,6895,2920,236.1,6978
2082,2001,1,VSP (VALLEY SP),3271,8,3279,1980,165.6,3324
2083,2001,1,SCC (SIERRA CONSERVATION CENTER),335,0,335,320,104.7,320
2084,2001,1,NCWF (NO CAL WOMEN'S FACIL),780,6,786,400,196.5,755
2085,2001,1,CCWF (CENTRAL CA WOMEN'S FAC),3400,8,3408,2004,170.1,3410
2086,2001,1,"CRC (CAL REHAB CTR, WOMEN)",291,435,726,500,145.2,842
2087,2001,1,CIW (CA INSTITUTION FOR WOMEN),1893,17,1910,1026,186.2,1742
2088,2001,1,WSP (WASCO SP),5527,12,5539,2984,185.6,5565
2089,2001,1,SCC (SIERRA CONSERVATION CENTER),5974,0,5974,3606,165.7,5869
2090,2001,1,SVSP (SALINAS VALLEY SP),4079,0,4079,2224,183.4,4156
2091,2001,1,RJD (RJ DONOVAN CORRECTIONAL FAC),4563,0,4563,2200,207.4,4673
2092,2001,1,PVSP (PLEASANT VALLEY SP),4652,0,4652,2208,210.7,4573
2093,2001,1,PBSP (PELICAN BAY SP),3219,0,3219,2280,141.2,3384
2094,2001,1,NKSP (NORTH KERN SP),4779,4,4783,2692,177.7,5089
2095,2001,1,MCSP (MULE CREEK SP),3503,0,3503,1700,206.1,3537
2096,2001,1,ISP (IRONWOOD SP),4527,0,4527,2200,205.8,4565
2097,2001,1,HDSP (HIGH DESERT SP),4329,4,4333,2224,194.8,4310
2098,2001,1,FOL (FOLSOM SP) (MALE),3841,0,3841,2072,185.4,3725
2099,2001,1,DVI (DEUEL VOCATIONAL INSTITUTION),3829,21,3850,1787,215.4,3841
2100,2001,1,CTF (CORRECTIONAL TRAINING FAC),7062,0,7062,3281,215.2,7101
2101,2001,1,CVSP (CHUCKAWALLA VALLEY SP),3586,0,3586,1738,206.3,3664
2102,2001,1,SATF (CA SUBSTANCE ABUSE TREAT FAC),6173,12,6185,3324,186.1,6450
2103,2001,1,"SOL (CA SP, SOLANO)",5801,0,5801,2610,222.3,5762
2104,2001,1,SQ (SAN QUENTIN SP),5728,10,5738,3273,175.3,5533
2105,2001,1,"SAC (CA SP, SACRAMENTO)",2919,0,2919,1728,168.9,3042
2106,2001,1,"LAC (CA SP, LOS ANGELES COUNTY)",4298,0,4298,2200,195.4,3980
2107,2001,1,"COR (CA SP, CORCORAN)",4946,0,4946,3016,164.0,4898
2108,2001,1,CEN (CENTINELA SP),4429,0,4429,2208,200.6,4573
2109,2001,1,CAL (CALIPATRIA SP),4116,0,4116,2208,186.4,4068
2110,2001,1,"CRC (CAL REHAB CTR, MEN)",2682,1350,4032,1814,222.3,3952
2111,2001,1,CMC (CA MEN'S COLONY),6804,0,6804,3884,175.2,6724
2112,2001,1,CMF (CA MEDICAL FAC),3095,0,3095,2315,133.7,3401
2113,2001,1,CIM (CA INSTITUTION FOR MEN),6241,46,6287,3078,204.3,6303
2114,2001,1,CCI (CA CORRECTIONAL INSTITUTION),5355,0,5355,2781,192.6,5600
2115,2001,1,CCC (CA CORRECTIONAL CENTER),5783,0,5783,3682,157.1,5642
2116,2001,1,ASP (AVENAL SP),6781,0,6781,2920,232.2,6878
2117,2001,2,VSP (VALLEY SP),3226,9,3235,1980,163.4,3324
2118,2001,2,SCC (SIERRA CONSERVATION CENTER),325,0,325,320,101.6,320
2119,2001,2,NCWF (NO CAL WOMEN'S FACIL),744,2,746,400,186.5,755
2120,2001,2,CCWF (CENTRAL CA WOMEN'S FAC),3373,8,3381,2004,168.7,3410
2121,2001,2,"CRC (CAL REHAB CTR, WOMEN)",282,425,707,500,141.4,842
2122,2001,2,CIW (CA INSTITUTION FOR WOMEN),1798,14,1812,1026,176.6,1742
2123,2001,2,WSP (WASCO SP),5330,27,5357,2984,179.5,5565
2124,2001,2,SCC (SIERRA CONSERVATION CENTER),5950,0,5950,3606,165.0,5869
2125,2001,2,SVSP (SALINAS VALLEY SP),4139,0,4139,2224,186.1,4156
2126,2001,2,RJD (RJ DONOVAN CORRECTIONAL FAC),4579,0,4579,2200,208.1,4673
2127,2001,2,PVSP (PLEASANT VALLEY SP),4638,0,4638,2208,210.1,4573
2128,2001,2,PBSP (PELICAN BAY SP),3208,0,3208,2280,140.7,3384
2129,2001,2,NKSP (NORTH KERN SP),4943,1,4944,2692,183.7,5089
2130,2001,2,MCSP (MULE CREEK SP),3497,0,3497,1700,205.7,3537
2131,2001,2,ISP (IRONWOOD SP),4382,0,4382,2200,199.2,4565
2132,2001,2,HDSP (HIGH DESERT SP),4265,2,4267,2224,191.9,4310
2133,2001,2,FOL (FOLSOM SP) (MALE),3876,0,3876,2072,187.1,3725
2134,2001,2,DVI (DEUEL VOCATIONAL INSTITUTION),3977,19,3996,1787,223.6,3841
2135,2001,2,CTF (CORRECTIONAL TRAINING FAC),7299,0,7299,3281,222.5,7101
2136,2001,2,CVSP (CHUCKAWALLA VALLEY SP),3640,0,3640,1738,209.4,3664
2137,2001,2,SATF (CA SUBSTANCE ABUSE TREAT FAC),6118,12,6130,3324,184.4,6450
2138,2001,2,"SOL (CA SP, SOLANO)",5762,0,5762,2610,220.8,5762
2139,2001,2,SQ (SAN QUENTIN SP),5815,13,5828,3273,178.1,5533
2140,2001,2,"SAC (CA SP, SACRAMENTO)",2881,0,2881,1728,166.7,3042
2141,2001,2,"LAC (CA SP, LOS ANGELES COUNTY)",4265,0,4265,2200,193.9,3980
2142,2001,2,"COR (CA SP, CORCORAN)",4833,0,4833,3016,160.2,4898
2143,2001,2,CEN (CENTINELA SP),4388,0,4388,2208,198.7,4573
2144,2001,2,CAL (CALIPATRIA SP),4075,0,4075,2208,184.6,4068
2145,2001,2,"CRC (CAL REHAB CTR, MEN)",2640,1378,4018,1814,221.5,3952
2146,2001,2,CMC (CA MEN'S COLONY),6738,1,6739,3884,173.5,6724
2147,2001,2,CMF (CA MEDICAL FAC),3179,0,3179,2315,137.3,3401
2148,2001,2,CIM (CA INSTITUTION FOR MEN),6075,37,6112,3078,198.6,6303
2149,2001,2,CCI (CA CORRECTIONAL INSTITUTION),5255,0,5255,2781,189.0,5600
2150,2001,2,CCC (CA CORRECTIONAL CENTER),5834,0,5834,3682,158.4,5642
2151,2001,2,ASP (AVENAL SP),6809,0,6809,2920,233.2,6878
2152,2001,3,VSP (VALLEY SP),3297,13,3310,1980,167.2,3324
2153,2001,3,SCC (SIERRA CONSERVATION CENTER),324,0,324,320,101.3,320
2154,2001,3,NCWF (NO CAL WOMEN'S FACIL),732,2,734,400,183.5,755
2155,2001,3,CCWF (CENTRAL CA WOMEN'S FAC),3411,9,3420,2004,170.7,3333
2156,2001,3,"CRC (CAL REHAB CTR, WOMEN)",297,410,707,500,141.4,751
2157,2001,3,CIW (CA INSTITUTION FOR WOMEN),1756,9,1765,1026,172.0,1742
2158,2001,3,WSP (WASCO SP),5768,27,5795,2984,194.2,5445
2159,2001,3,SCC (SIERRA CONSERVATION CENTER),5992,0,5992,3606,166.2,5869
2160,2001,3,SVSP (SALINAS VALLEY SP),4080,0,4080,2224,183.5,4156
2161,2001,3,RJD (RJ DONOVAN CORRECTIONAL FAC),4597,0,4597,2200,209.0,4673
2162,2001,3,PVSP (PLEASANT VALLEY SP),4597,0,4597,2208,208.2,4573
2163,2001,3,PBSP (PELICAN BAY SP),3179,0,3179,2280,139.4,3384
2164,2001,3,NKSP (NORTH KERN SP),5112,0,5112,2692,189.9,5089
2165,2001,3,MCSP (MULE CREEK SP),3504,0,3504,1700,206.1,3537
2166,2001,3,ISP (IRONWOOD SP),4528,0,4528,2200,205.8,4445
2167,2001,3,HDSP (HIGH DESERT SP),4332,1,4333,2224,194.8,4310
2168,2001,3,FOL (FOLSOM SP) (MALE),3884,0,3884,2072,187.5,3725
2169,2001,3,DVI (DEUEL VOCATIONAL INSTITUTION),3896,17,3913,1787,219.0,3841
2170,2001,3,CTF (CORRECTIONAL TRAINING FAC),7094,0,7094,3281,216.2,7101
2171,2001,3,CVSP (CHUCKAWALLA VALLEY SP),3664,0,3664,1738,210.8,3664
2172,2001,3,SATF (CA SUBSTANCE ABUSE TREAT FAC),6135,13,6148,3324,185.0,6450
2173,2001,3,"SOL (CA SP, SOLANO)",5837,0,5837,2610,223.6,5762
2174,2001,3,SQ (SAN QUENTIN SP),5737,24,5761,3273,176.0,5533
2175,2001,3,"SAC (CA SP, SACRAMENTO)",2942,0,2942,1728,170.3,3042
2176,2001,3,"LAC (CA SP, LOS ANGELES COUNTY)",4072,0,4072,2200,185.1,4020
2177,2001,3,"COR (CA SP, CORCORAN)",4889,0,4889,3016,162.1,4898
2178,2001,3,CEN (CENTINELA SP),4456,0,4456,2208,201.8,4573
2179,2001,3,CAL (CALIPATRIA SP),4185,0,4185,2208,189.5,4068
2180,2001,3,"CRC (CAL REHAB CTR, MEN)",2712,1359,4071,1814,224.4,3952
2181,2001,3,CMC (CA MEN'S COLONY),6706,0,6706,3884,172.7,6724
2182,2001,3,CMF (CA MEDICAL FAC),3212,0,3212,2315,138.7,3401
2183,2001,3,CIM (CA INSTITUTION FOR MEN),6137,33,6170,3078,200.5,6303
2184,2001,3,CCI (CA CORRECTIONAL INSTITUTION),5487,0,5487,2781,197.3,5600
2185,2001,3,CCC (CA CORRECTIONAL CENTER),5849,0,5849,3682,158.9,5642
2186,2001,3,ASP (AVENAL SP),6937,0,6937,2920,237.6,6878
2187,2001,4,VSP (VALLEY SP),3302,9,3311,1980,167.2,3324
2188,2001,4,SCC (SIERRA CONSERVATION CENTER),325,0,325,320,101.6,320
2189,2001,4,NCWF (NO CAL WOMEN'S FACIL),757,1,758,400,189.5,755
2190,2001,4,CCWF (CENTRAL CA WOMEN'S FAC),3412,5,3417,2004,170.5,3386
2191,2001,4,"CRC (CAL REHAB CTR, WOMEN)",266,404,670,500,134.0,751
2192,2001,4,CIW (CA INSTITUTION FOR WOMEN),1799,13,1812,1026,176.6,1742
2193,2001,4,WSP (WASCO SP),5723,19,5742,2984,192.4,5677
2194,2001,4,SCC (SIERRA CONSERVATION CENTER),5979,0,5979,3606,165.8,5869
2195,2001,4,SVSP (SALINAS VALLEY SP),4105,0,4105,2224,184.6,4156
2196,2001,4,RJD (RJ DONOVAN CORRECTIONAL FAC),4653,0,4653,2200,211.5,4673
2197,2001,4,PVSP (PLEASANT VALLEY SP),4651,0,4651,2208,210.6,4573
2198,2001,4,PBSP (PELICAN BAY SP),3251,0,3251,2280,142.6,3384
2199,2001,4,NKSP (NORTH KERN SP),5046,6,5052,2692,187.7,5089
2200,2001,4,MCSP (MULE CREEK SP),3502,0,3502,1700,206.0,3537
2201,2001,4,ISP (IRONWOOD SP),4566,0,4566,2200,207.5,4565
2202,2001,4,HDSP (HIGH DESERT SP),4331,4,4335,2224,194.9,4310
2203,2001,4,FOL (FOLSOM SP) (MALE),3841,0,3841,2072,185.4,3725
2204,2001,4,DVI (DEUEL VOCATIONAL INSTITUTION),3843,9,3852,1787,215.6,3841
2205,2001,4,CTF (CORRECTIONAL TRAINING FAC),6985,0,6985,3281,212.9,7101
2206,2001,4,CVSP (CHUCKAWALLA VALLEY SP),3599,0,3599,1738,207.1,3664
2207,2001,4,SATF (CA SUBSTANCE ABUSE TREAT FAC),6267,11,6278,3324,188.9,6450
2208,2001,4,"SOL (CA SP, SOLANO)",5790,0,5790,2610,221.8,5852
2209,2001,4,SQ (SAN QUENTIN SP),5595,14,5609,3273,171.4,5533
2210,2001,4,"SAC (CA SP, SACRAMENTO)",2934,0,2934,1728,169.8,3042
2211,2001,4,"LAC (CA SP, LOS ANGELES COUNTY)",4019,0,4019,2200,182.7,4020
2212,2001,4,"COR (CA SP, CORCORAN)",4963,0,4963,3016,164.6,5019
2213,2001,4,CEN (CENTINELA SP),4456,0,4456,2208,201.8,4573
2214,2001,4,CAL (CALIPATRIA SP),4144,0,4144,2208,187.7,4068
2215,2001,4,"CRC (CAL REHAB CTR, MEN)",2680,1363,4043,1814,222.9,3952
2216,2001,4,CMC (CA MEN'S COLONY),6636,1,6637,3884,170.9,6724
2217,2001,4,CMF (CA MEDICAL FAC),3294,0,3294,2315,142.3,3401
2218,2001,4,CIM (CA INSTITUTION FOR MEN),6288,28,6316,3078,205.2,6303
2219,2001,4,CCI (CA CORRECTIONAL INSTITUTION),5527,0,5527,2781,198.7,5600
2220,2001,4,CCC (CA CORRECTIONAL CENTER),5936,0,5936,3682,161.2,5642
2221,2001,4,ASP (AVENAL SP),6714,0,6714,2920,229.9,6978
2222,2001,5,VSP (VALLEY SP),3269,2,3271,1980,165.2,3324
2223,2001,5,SCC (SIERRA CONSERVATION CENTER),309,0,309,320,96.6,320
2224,2001,5,NCWF (NO CAL WOMEN'S FACIL),768,1,769,400,192.3,755
2225,2001,5,CCWF (CENTRAL CA WOMEN'S FAC),3302,4,3306,2004,165.0,3386
2226,2001,5,"CRC (CAL REHAB CTR, WOMEN)",365,389,754,500,150.8,751
2227,2001,5,CIW (CA INSTITUTION FOR WOMEN),1900,10,1910,1026,186.2,1742
2228,2001,5,WSP (WASCO SP),5771,19,5790,2984,194.0,5797
2229,2001,5,SCC (SIERRA CONSERVATION CENTER),5978,0,5978,3606,165.8,5869
2230,2001,5,SVSP (SALINAS VALLEY SP),4138,0,4138,2224,186.1,4156
2231,2001,5,RJD (RJ DONOVAN CORRECTIONAL FAC),4708,0,4708,2200,214.0,4673
2232,2001,5,PVSP (PLEASANT VALLEY SP),4592,0,4592,2208,208.0,4573
2233,2001,5,PBSP (PELICAN BAY SP),3300,0,3300,2280,144.7,3384
2234,2001,5,NKSP (NORTH KERN SP),5003,8,5011,2692,186.1,5089
2235,2001,5,MCSP (MULE CREEK SP),3493,0,3493,1700,205.5,3537
2236,2001,5,ISP (IRONWOOD SP),4562,0,4562,2200,207.4,4565
2237,2001,5,HDSP (HIGH DESERT SP),4326,2,4328,2224,194.6,4310
2238,2001,5,FOL (FOLSOM SP) (MALE),3866,0,3866,2072,186.6,3725
2239,2001,5,DVI (DEUEL VOCATIONAL INSTITUTION),3916,20,3936,1787,220.3,3941
2240,2001,5,CTF (CORRECTIONAL TRAINING FAC),7009,0,7009,3281,213.6,7101
2241,2001,5,CVSP (CHUCKAWALLA VALLEY SP),3587,0,3587,1738,206.4,3664
2242,2001,5,SATF (CA SUBSTANCE ABUSE TREAT FAC),6339,11,6350,3324,191.0,6450
2243,2001,5,"SOL (CA SP, SOLANO)",5816,0,5816,2610,222.8,5852
2244,2001,5,SQ (SAN QUENTIN SP),5715,17,5732,3273,175.1,5533
2245,2001,5,"SAC (CA SP, SACRAMENTO)",2904,0,2904,1728,168.1,3042
2246,2001,5,"LAC (CA SP, LOS ANGELES COUNTY)",4105,0,4105,2200,186.6,4140
2247,2001,5,"COR (CA SP, CORCORAN)",4985,0,4985,3016,165.3,5019
2248,2001,5,CEN (CENTINELA SP),4460,0,4460,2208,202.0,4573
2249,2001,5,CAL (CALIPATRIA SP),4162,0,4162,2208,188.5,4068
2250,2001,5,"CRC (CAL REHAB CTR, MEN)",2698,1329,4027,1814,222.0,3952
2251,2001,5,CMC (CA MEN'S COLONY),6723,0,6723,3884,173.1,6724
2252,2001,5,CMF (CA MEDICAL FAC),3295,0,3295,2315,142.3,3401
2253,2001,5,CIM (CA INSTITUTION FOR MEN),6257,23,6280,3078,204.0,6303
2254,2001,5,CCI (CA CORRECTIONAL INSTITUTION),5594,0,5594,2781,201.2,5741
2255,2001,5,CCC (CA CORRECTIONAL CENTER),5868,0,5868,3682,159.4,5642
2256,2001,5,ASP (AVENAL SP),6846,0,6846,2920,234.5,6978
2257,2001,6,VSP (VALLEY SP),3243,4,3247,1980,164.0,3324
2258,2001,6,SCC (SIERRA CONSERVATION CENTER),314,0,314,320,98.1,320
2259,2001,6,NCWF (NO CAL WOMEN'S FACIL),783,2,785,400,196.3,755
2260,2001,6,CCWF (CENTRAL CA WOMEN'S FAC),3305,5,3310,2004,165.2,3386
2261,2001,6,"CRC (CAL REHAB CTR, WOMEN)",443,379,822,500,164.4,751
2262,2001,6,CIW (CA INSTITUTION FOR WOMEN),1768,10,1778,1026,173.3,1742
2263,2001,6,WSP (WASCO SP),5852,21,5873,2984,196.8,5797
2264,2001,6,SCC (SIERRA CONSERVATION CENTER),6055,0,6055,3606,167.9,5869
2265,2001,6,SVSP (SALINAS VALLEY SP),4196,0,4196,2224,188.7,4156
2266,2001,6,RJD (RJ DONOVAN CORRECTIONAL FAC),4526,0,4526,2200,205.7,4673
2267,2001,6,PVSP (PLEASANT VALLEY SP),4642,0,4642,2208,210.2,4573
2268,2001,6,PBSP (PELICAN BAY SP),3283,0,3283,2280,144.0,3384
2269,2001,6,NKSP (NORTH KERN SP),5059,4,5063,2692,188.1,5089
2270,2001,6,MCSP (MULE CREEK SP),3483,0,3483,1700,204.9,3537
2271,2001,6,ISP (IRONWOOD SP),4625,0,4625,2200,210.2,4565
2272,2001,6,HDSP (HIGH DESERT SP),4284,2,4286,2224,192.7,4310
2273,2001,6,FOL (FOLSOM SP) (MALE),3837,0,3837,2072,185.2,3725
2274,2001,6,DVI (DEUEL VOCATIONAL INSTITUTION),3811,14,3825,1787,214.0,3941
2275,2001,6,CTF (CORRECTIONAL TRAINING FAC),7002,0,7002,3281,213.4,7101
2276,2001,6,CVSP (CHUCKAWALLA VALLEY SP),3652,0,3652,1738,210.1,3664
2277,2001,6,SATF (CA SUBSTANCE ABUSE TREAT FAC),6327,7,6334,3324,190.6,6450
2278,2001,6,"SOL (CA SP, SOLANO)",5801,0,5801,2610,222.3,5852
2279,2001,6,SQ (SAN QUENTIN SP),5583,12,5595,3273,170.9,5533
2280,2001,6,"SAC (CA SP, SACRAMENTO)",2903,0,2903,1728,168.0,3042
2281,2001,6,"LAC (CA SP, LOS ANGELES COUNTY)",4123,0,4123,2200,187.4,4140
2282,2001,6,"COR (CA SP, CORCORAN)",4978,1,4979,3016,165.1,5019
2283,2001,6,CEN (CENTINELA SP),4385,0,4385,2208,198.6,4573
2284,2001,6,CAL (CALIPATRIA SP),4178,0,4178,2208,189.2,4068
2285,2001,6,"CRC (CAL REHAB CTR, MEN)",2731,1281,4012,1814,221.2,3952
2286,2001,6,CMC (CA MEN'S COLONY),6752,0,6752,3884,173.8,6724
2287,2001,6,CMF (CA MEDICAL FAC),3278,0,3278,2315,141.6,3401
2288,2001,6,CIM (CA INSTITUTION FOR MEN),6263,31,6294,3078,204.5,6303
2289,2001,6,CCI (CA CORRECTIONAL INSTITUTION),5595,0,5595,2781,201.2,5741
2290,2001,6,CCC (CA CORRECTIONAL CENTER),5809,0,5809,3682,157.8,5642
2291,2001,6,ASP (AVENAL SP),6867,0,6867,2920,235.2,6978
2292,2001,7,VSP (VALLEY SP),3185,7,3192,1980,161.2,3324
2293,2001,7,SCC (SIERRA CONSERVATION CENTER),328,0,328,320,102.5,320
2294,2001,7,NCWF (NO CAL WOMEN'S FACIL),734,0,734,400,183.5,755
2295,2001,7,CCWF (CENTRAL CA WOMEN'S FAC),3142,5,3147,2004,157.0,3386
2296,2001,7,"CRC (CAL REHAB CTR, WOMEN)",434,365,799,500,159.8,751
2297,2001,7,CIW (CA INSTITUTION FOR WOMEN),1779,7,1786,1026,174.1,1742
2298,2001,7,WSP (WASCO SP),5544,17,5561,2984,186.4,5797
2299,2001,7,SCC (SIERRA CONSERVATION CENTER),5972,0,5972,3606,165.6,5869
2300,2001,7,SVSP (SALINAS VALLEY SP),4223,0,4223,2224,189.9,4156
2301,2001,7,RJD (RJ DONOVAN CORRECTIONAL FAC),4627,0,4627,2200,210.3,4673
2302,2001,7,PVSP (PLEASANT VALLEY SP),4641,0,4641,2208,210.2,4573
2303,2001,7,PBSP (PELICAN BAY SP),3366,0,3366,2280,147.6,3494
2304,2001,7,NKSP (NORTH KERN SP),4917,3,4920,2692,182.8,5089
2305,2001,7,MCSP (MULE CREEK SP),3493,0,3493,1700,205.5,3697
2306,2001,7,ISP (IRONWOOD SP),4599,0,4599,2200,209.0,4565
2307,2001,7,HDSP (HIGH DESERT SP),4256,3,4259,2224,191.5,4310
2308,2001,7,FOL (FOLSOM SP) (MALE),3819,0,3819,2072,184.3,3725
2309,2001,7,DVI (DEUEL VOCATIONAL INSTITUTION),3811,18,3829,1787,214.3,3941
2310,2001,7,CTF (CORRECTIONAL TRAINING FAC),6503,0,6503,3281,198.2,6601
2311,2001,7,CVSP (CHUCKAWALLA VALLEY SP),3620,0,3620,1738,208.3,3664
2312,2001,7,SATF (CA SUBSTANCE ABUSE TREAT FAC),6326,7,6333,3324,190.5,6450
2313,2001,7,"SOL (CA SP, SOLANO)",5751,0,5751,2610,220.3,5852
2314,2001,7,SQ (SAN QUENTIN SP),5549,9,5558,3273,169.8,5533
2315,2001,7,"SAC (CA SP, SACRAMENTO)",3015,0,3015,1728,174.5,3042
2316,2001,7,"LAC (CA SP, LOS ANGELES COUNTY)",4124,0,4124,2200,187.5,4140
2317,2001,7,"COR (CA SP, CORCORAN)",5112,1,5113,3016,169.5,5140
2318,2001,7,CEN (CENTINELA SP),4450,0,4450,2208,201.5,4693
2319,2001,7,CAL (CALIPATRIA SP),4138,0,4138,2208,187.4,4068
2320,2001,7,"CRC (CAL REHAB CTR, MEN)",2697,1268,3965,1814,218.6,3952
2321,2001,7,CMC (CA MEN'S COLONY),6573,1,6574,3884,169.3,6604
2322,2001,7,CMF (CA MEDICAL FAC),3268,0,3268,2315,141.2,3401
2323,2001,7,CIM (CA INSTITUTION FOR MEN),6116,18,6134,3078,199.3,6303
2324,2001,7,CCI (CA CORRECTIONAL INSTITUTION),5544,0,5544,2781,199.4,5741
2325,2001,7,CCC (CA CORRECTIONAL CENTER),5880,0,5880,3682,159.7,5642
2326,2001,7,ASP (AVENAL SP),6852,0,6852,2920,234.7,6978
2327,2001,8,VSP (VALLEY SP),3120,7,3127,1980,157.9,3324
2328,2001,8,SCC (SIERRA CONSERVATION CENTER),329,0,329,320,102.8,320
2329,2001,8,NCWF (NO CAL WOMEN'S FACIL),736,2,738,400,184.5,670
2330,2001,8,CCWF (CENTRAL CA WOMEN'S FAC),3027,3,3030,2004,151.2,3333
2331,2001,8,"CRC (CAL REHAB CTR, WOMEN)",420,353,773,500,154.6,751
2332,2001,8,CIW (CA INSTITUTION FOR WOMEN),1827,8,1835,1026,178.8,1742
2333,2001,8,WSP (WASCO SP),5404,20,5424,2984,181.8,5797
2334,2001,8,SCC (SIERRA CONSERVATION CENTER),6041,0,6041,3606,167.5,5869
2335,2001,8,SVSP (SALINAS VALLEY SP),4141,0,4141,2224,186.2,4156
2336,2001,8,RJD (RJ DONOVAN CORRECTIONAL FAC),4362,0,4362,2200,198.3,4673
2337,2001,8,PVSP (PLEASANT VALLEY SP),4583,0,4583,2208,207.6,4573
2338,2001,8,PBSP (PELICAN BAY SP),3334,0,3334,2280,146.2,3494
2339,2001,8,NKSP (NORTH KERN SP),4508,3,4511,2692,167.6,5089
2340,2001,8,MCSP (MULE CREEK SP),3619,0,3619,1700,212.9,3697
2341,2001,8,ISP (IRONWOOD SP),4553,0,4553,2200,207.0,4445
2342,2001,8,HDSP (HIGH DESERT SP),4213,3,4216,2224,189.6,4310
2343,2001,8,FOL (FOLSOM SP) (MALE),3816,0,3816,2072,184.2,3725
2344,2001,8,DVI (DEUEL VOCATIONAL INSTITUTION),3766,6,3772,1787,211.1,3941
2345,2001,8,CTF (CORRECTIONAL TRAINING FAC),6480,0,6480,3281,197.5,6601
2346,2001,8,CVSP (CHUCKAWALLA VALLEY SP),3623,0,3623,1738,208.5,3664
2347,2001,8,SATF (CA SUBSTANCE ABUSE TREAT FAC),6418,7,6425,3324,193.3,6450
2348,2001,8,"SOL (CA SP, SOLANO)",5779,0,5779,2610,221.4,5852
2349,2001,8,SQ (SAN QUENTIN SP),5450,13,5463,3273,166.9,5533
2350,2001,8,"SAC (CA SP, SACRAMENTO)",3001,0,3001,1728,173.7,3042
2351,2001,8,"LAC (CA SP, LOS ANGELES COUNTY)",4122,0,4122,2200,187.4,4020
2352,2001,8,"COR (CA SP, CORCORAN)",5069,0,5069,3016,168.1,5140
2353,2001,8,CEN (CENTINELA SP),4435,0,4435,2208,200.9,4573
2354,2001,8,CAL (CALIPATRIA SP),4099,0,4099,2208,185.6,4068
2355,2001,8,"CRC (CAL REHAB CTR, MEN)",2762,1224,3986,1814,219.7,3952
2356,2001,8,CMC (CA MEN'S COLONY),6502,1,6503,3884,167.4,6604
2357,2001,8,CMF (CA MEDICAL FAC),3245,0,3245,2315,140.2,3401
2358,2001,8,CIM (CA INSTITUTION FOR MEN),6244,26,6270,3078,203.7,6303
2359,2001,8,CCI (CA CORRECTIONAL INSTITUTION),5433,0,5433,2781,195.4,5600
2360,2001,8,CCC (CA CORRECTIONAL CENTER),5850,0,5850,3682,158.9,5642
2361,2001,8,ASP (AVENAL SP),6908,0,6908,2920,236.6,6978
2362,2001,9,VSP (VALLEY SP),3057,5,3062,1980,154.6,3324
2363,2001,9,SCC (SIERRA CONSERVATION CENTER),325,0,325,320,101.6,320
2364,2001,9,NCWF (NO CAL WOMEN'S FACIL),638,0,638,400,159.5,670
2365,2001,9,CCWF (CENTRAL CA WOMEN'S FAC),3102,2,3104,2004,154.9,3280
2366,2001,9,"CRC (CAL REHAB CTR, WOMEN)",390,338,728,500,145.6,751
2367,2001,9,CIW (CA INSTITUTION FOR WOMEN),1886,9,1895,1026,184.7,1634
2368,2001,9,WSP (WASCO SP),5286,22,5308,2984,177.9,5565
2369,2001,9,SCC (SIERRA CONSERVATION CENTER),5934,0,5934,3606,164.6,5869
2370,2001,9,SVSP (SALINAS VALLEY SP),4096,0,4096,2224,184.2,4156
2371,2001,9,RJD (RJ DONOVAN CORRECTIONAL FAC),4471,0,4471,2200,203.2,4583
2372,2001,9,PVSP (PLEASANT VALLEY SP),4675,0,4675,2208,211.7,4573
2373,2001,9,PBSP (PELICAN BAY SP),3366,0,3366,2280,147.6,3494
2374,2001,9,NKSP (NORTH KERN SP),4535,3,4538,2692,168.6,4857
2375,2001,9,MCSP (MULE CREEK SP),3557,0,3557,1700,209.2,3697
2376,2001,9,ISP (IRONWOOD SP),4567,0,4567,2200,207.6,4445
2377,2001,9,HDSP (HIGH DESERT SP),4175,3,4178,2224,187.9,4310
2378,2001,9,FOL (FOLSOM SP) (MALE),3832,0,3832,2072,184.9,3725
2379,2001,9,DVI (DEUEL VOCATIONAL INSTITUTION),3927,11,3938,1787,220.4,3941
2380,2001,9,CTF (CORRECTIONAL TRAINING FAC),6427,0,6427,3281,195.9,6601
2381,2001,9,CVSP (CHUCKAWALLA VALLEY SP),3627,0,3627,1738,208.7,3664
2382,2001,9,SATF (CA SUBSTANCE ABUSE TREAT FAC),6443,8,6451,3324,194.1,6450
2383,2001,9,"SOL (CA SP, SOLANO)",5816,0,5816,2610,222.8,5852
2384,2001,9,SQ (SAN QUENTIN SP),5513,8,5521,3273,168.7,5383
2385,2001,9,"SAC (CA SP, SACRAMENTO)",2975,0,2975,1728,172.2,3042
2386,2001,9,"LAC (CA SP, LOS ANGELES COUNTY)",4108,0,4108,2200,186.7,4020
2387,2001,9,"COR (CA SP, CORCORAN)",5020,0,5020,3016,166.4,5140
2388,2001,9,CEN (CENTINELA SP),4445,1,4446,2208,201.4,4573
2389,2001,9,CAL (CALIPATRIA SP),3968,0,3968,2208,179.7,4068
2390,2001,9,"CRC (CAL REHAB CTR, MEN)",2796,1214,4010,1814,221.1,3952
2391,2001,9,CMC (CA MEN'S COLONY),6558,1,6559,3884,168.9,6604
2392,2001,9,CMF (CA MEDICAL FAC),3181,0,3181,2315,137.4,3401
2393,2001,9,CIM (CA INSTITUTION FOR MEN),6272,28,6300,3078,204.7,6065
2394,2001,9,CCI (CA CORRECTIONAL INSTITUTION),5197,0,5197,2781,186.9,5475
2395,2001,9,CCC (CA CORRECTIONAL CENTER),5907,0,5907,3682,160.4,5642
2396,2001,9,ASP (AVENAL SP),6801,0,6801,2920,232.9,6978
2397,2001,10,VSP (VALLEY SP),3053,7,3060,1980,154.5,3247
2398,2001,10,SCC (SIERRA CONSERVATION CENTER),318,0,318,320,99.4,320
2399,2001,10,NCWF (NO CAL WOMEN'S FACIL),626,2,628,400,157.0,630
2400,2001,10,CCWF (CENTRAL CA WOMEN'S FAC),3142,0,3142,2004,156.8,3028
2401,2001,10,"CRC (CAL REHAB CTR, WOMEN)",330,329,659,500,131.8,751
2402,2001,10,CIW (CA INSTITUTION FOR WOMEN),1892,6,1898,1026,185.0,1598
2403,2001,10,WSP (WASCO SP),5391,15,5406,2984,181.2,5445
2404,2001,10,SCC (SIERRA CONSERVATION CENTER),6017,0,6017,3606,166.9,5869
2405,2001,10,SVSP (SALINAS VALLEY SP),4247,0,4247,2224,191.0,4156
2406,2001,10,RJD (RJ DONOVAN CORRECTIONAL FAC),4561,0,4561,2200,207.3,4583
2407,2001,10,PVSP (PLEASANT VALLEY SP),4674,0,4674,2208,211.7,4573
2408,2001,10,PBSP (PELICAN BAY SP),3387,0,3387,2280,148.6,3494
2409,2001,10,NKSP (NORTH KERN SP),5037,22,5059,2692,187.9,4857
2410,2001,10,MCSP (MULE CREEK SP),3559,0,3559,1700,209.4,3697
2411,2001,10,ISP (IRONWOOD SP),4598,0,4598,2200,209.0,4445
2412,2001,10,HDSP (HIGH DESERT SP),4259,6,4265,2224,191.8,4190
2413,2001,10,FOL (FOLSOM SP) (MALE),3854,0,3854,2072,186.0,3725
2414,2001,10,DVI (DEUEL VOCATIONAL INSTITUTION),3900,8,3908,1787,218.7,3941
2415,2001,10,CTF (CORRECTIONAL TRAINING FAC),6013,0,6013,3281,183.3,6141
2416,2001,10,CVSP (CHUCKAWALLA VALLEY SP),3634,0,3634,1738,209.1,3664
2417,2001,10,SATF (CA SUBSTANCE ABUSE TREAT FAC),6456,9,6465,3324,194.5,6450
2418,2001,10,"SOL (CA SP, SOLANO)",5810,1,5811,2610,222.6,5852
2419,2001,10,SQ (SAN QUENTIN SP),5550,11,5561,3273,169.9,5180
2420,2001,10,"SAC (CA SP, SACRAMENTO)",2988,0,2988,1728,172.9,3042
2421,2001,10,"LAC (CA SP, LOS ANGELES COUNTY)",4082,0,4082,2200,185.5,4020
2422,2001,10,"COR (CA SP, CORCORAN)",4964,0,4964,3016,164.6,5140
2423,2001,10,CEN (CENTINELA SP),4299,0,4299,2208,194.7,4453
2424,2001,10,CAL (CALIPATRIA SP),4078,0,4078,2208,184.7,4068
2425,2001,10,"CRC (CAL REHAB CTR, MEN)",2818,1164,3982,1814,219.5,3952
2426,2001,10,CMC (CA MEN'S COLONY),6562,0,6562,3884,168.9,6604
2427,2001,10,CMF (CA MEDICAL FAC),3250,0,3250,2315,140.4,3401
2428,2001,10,CIM (CA INSTITUTION FOR MEN),6236,22,6258,3078,203.3,6027
2429,2001,10,CCI (CA CORRECTIONAL INSTITUTION),5035,0,5035,2781,181.0,5475
2430,2001,10,CCC (CA CORRECTIONAL CENTER),5955,0,5955,3682,161.7,5642
2431,2001,10,ASP (AVENAL SP),6858,0,6858,2920,234.9,6878
2432,2001,11,VSP (VALLEY SP),3005,15,3020,1980,152.5,3247
2433,2001,11,SCC (SIERRA CONSERVATION CENTER),334,0,334,320,104.4,320
2434,2001,11,NCWF (NO CAL WOMEN'S FACIL),638,1,639,400,159.8,630
2435,2001,11,CCWF (CENTRAL CA WOMEN'S FAC),3107,1,3108,2004,155.1,3028
2436,2001,11,"CRC (CAL REHAB CTR, WOMEN)",339,320,659,500,131.8,751
2437,2001,11,CIW (CA INSTITUTION FOR WOMEN),1837,7,1844,1026,179.7,1564
2438,2001,11,WSP (WASCO SP),5588,10,5598,2984,187.6,5445
2439,2001,11,SCC (SIERRA CONSERVATION CENTER),6031,0,6031,3606,167.2,5869
2440,2001,11,SVSP (SALINAS VALLEY SP),4236,0,4236,2224,190.5,4156
2441,2001,11,RJD (RJ DONOVAN CORRECTIONAL FAC),4554,0,4554,2200,207.0,4673
2442,2001,11,PVSP (PLEASANT VALLEY SP),4670,0,4670,2208,211.5,4573
2443,2001,11,PBSP (PELICAN BAY SP),3336,0,3336,2280,146.3,3494
2444,2001,11,NKSP (NORTH KERN SP),4978,3,4981,2692,185.0,4857
2445,2001,11,MCSP (MULE CREEK SP),3632,0,3632,1700,213.6,3697
2446,2001,11,ISP (IRONWOOD SP),4650,0,4650,2200,211.4,4565
2447,2001,11,HDSP (HIGH DESERT SP),4178,6,4184,2224,188.1,4190
2448,2001,11,FOL (FOLSOM SP) (MALE),3750,0,3750,2072,181.0,3725
2449,2001,11,DVI (DEUEL VOCATIONAL INSTITUTION),3888,13,3901,1787,218.3,3941
2450,2001,11,CTF (CORRECTIONAL TRAINING FAC),5619,0,5619,2771,202.8,5631
2451,2001,11,CVSP (CHUCKAWALLA VALLEY SP),3641,0,3641,1738,209.5,3664
2452,2001,11,SATF (CA SUBSTANCE ABUSE TREAT FAC),6474,7,6481,3324,195.0,6450
2453,2001,11,"SOL (CA SP, SOLANO)",5833,0,5833,2610,223.5,5852
2454,2001,11,SQ (SAN QUENTIN SP),5594,19,5613,3273,171.5,5533
2455,2001,11,"SAC (CA SP, SACRAMENTO)",3000,0,3000,1728,173.6,3042
2456,2001,11,"LAC (CA SP, LOS ANGELES COUNTY)",4130,0,4130,2200,187.7,4020
2457,2001,11,"COR (CA SP, CORCORAN)",5090,0,5090,3016,168.8,5140
2458,2001,11,CEN (CENTINELA SP),4257,0,4257,2208,192.8,4453
2459,2001,11,CAL (CALIPATRIA SP),4053,0,4053,2208,183.6,4068
2460,2001,11,"CRC (CAL REHAB CTR, MEN)",2877,1106,3983,1814,219.6,3952
2461,2001,11,CMC (CA MEN'S COLONY),6592,0,6592,3884,169.7,6604
2462,2001,11,CMF (CA MEDICAL FAC),3246,0,3246,2315,140.2,3401
2463,2001,11,CIM (CA INSTITUTION FOR MEN),6205,29,6234,3078,202.5,6027
2464,2001,11,CCI (CA CORRECTIONAL INSTITUTION),4895,0,4895,2781,176.0,5475
2465,2001,11,CCC (CA CORRECTIONAL CENTER),5846,0,5846,3682,158.8,5642
2466,2001,11,ASP (AVENAL SP),6918,0,6918,2920,236.9,6978
2467,2001,12,VSP (VALLEY SP),2920,5,2925,1980,147.7,3247
2468,2001,12,SCC (SIERRA CONSERVATION CENTER),318,0,318,320,99.4,320
2469,2001,12,NCWF (NO CAL WOMEN'S FACIL),620,2,622,400,155.5,630
2470,2001,12,CCWF (CENTRAL CA WOMEN'S FAC),3052,3,3055,2004,152.4,2925
2471,2001,12,"CRC (CAL REHAB CTR, WOMEN)",361,311,672,500,134.4,751
2472,2001,12,CIW (CA INSTITUTION FOR WOMEN),1720,7,1727,1026,168.3,1564
2473,2001,12,WSP (WASCO SP),5635,11,5646,2984,189.2,5445
2474,2001,12,SCC (SIERRA CONSERVATION CENTER),6023,0,6023,3606,167.0,5869
2475,2001,12,SVSP (SALINAS VALLEY SP),4159,0,4159,2224,187.0,4156
2476,2001,12,RJD (RJ DONOVAN CORRECTIONAL FAC),4600,0,4600,2200,209.1,4673
2477,2001,12,PVSP (PLEASANT VALLEY SP),4601,0,4601,2208,208.4,4573
2478,2001,12,PBSP (PELICAN BAY SP),3260,0,3260,2280,143.0,3384
2479,2001,12,NKSP (NORTH KERN SP),4910,3,4913,2692,182.5,4857
2480,2001,12,MCSP (MULE CREEK SP),3604,0,3604,1700,212.0,3697
2481,2001,12,ISP (IRONWOOD SP),4623,0,4623,2200,210.1,4565
2482,2001,12,HDSP (HIGH DESERT SP),4158,6,4164,2224,187.2,4190
2483,2001,12,FOL (FOLSOM SP) (MALE),3743,0,3743,2072,180.6,3725
2484,2001,12,DVI (DEUEL VOCATIONAL INSTITUTION),4003,11,4014,1787,224.6,3941
2485,2001,12,CTF (CORRECTIONAL TRAINING FAC),5572,0,5572,2771,201.1,5631
2486,2001,12,CVSP (CHUCKAWALLA VALLEY SP),3600,0,3600,1738,207.1,3664
2487,2001,12,SATF (CA SUBSTANCE ABUSE TREAT FAC),6387,7,6394,3324,192.4,6450
2488,2001,12,"SOL (CA SP, SOLANO)",5811,0,5811,2610,222.6,5852
2489,2001,12,SQ (SAN QUENTIN SP),5580,8,5588,3273,170.7,5533
2490,2001,12,"SAC (CA SP, SACRAMENTO)",2909,0,2909,1728,168.3,3042
2491,2001,12,"LAC (CA SP, LOS ANGELES COUNTY)",4087,0,4087,2200,185.8,4020
2492,2001,12,"COR (CA SP, CORCORAN)",4978,0,4978,3016,165.1,5140
2493,2001,12,CEN (CENTINELA SP),4183,0,4183,2208,189.4,4453
2494,2001,12,CAL (CALIPATRIA SP),4119,0,4119,2208,186.5,4068
2495,2001,12,"CRC (CAL REHAB CTR, MEN)",2857,1084,3941,1814,217.3,3952
2496,2001,12,CMC (CA MEN'S COLONY),6592,0,6592,3884,169.7,6604
2497,2001,12,CMF (CA MEDICAL FAC),3219,0,3219,2315,139.0,3401
2498,2001,12,CIM (CA INSTITUTION FOR MEN),6242,32,6274,3078,203.8,6027
2499,2001,12,CCI (CA CORRECTIONAL INSTITUTION),5079,0,5079,2781,182.6,5475
2500,2001,12,CCC (CA CORRECTIONAL CENTER),5765,0,5765,3682,156.6,5642
2501,2001,12,ASP (AVENAL SP),6478,0,6478,2920,221.8,6778
2502,2002,1,VSP (VALLEY SP),3037,3,3040,1980,153.5,3247
2503,2002,1,SCC (SIERRA CONSERVATION CENTER),295,0,295,320,92.2,320
2504,2002,1,NCWF (NO CAL WOMEN'S FACIL),628,0,628,400,157.0,630
2505,2002,1,CCWF (CENTRAL CA WOMEN'S FAC),3009,2,3011,2004,150.2,2925
2506,2002,1,"CRC (CAL REHAB CTR, WOMEN)",345,314,659,500,131.8,680
2507,2002,1,CIW (CA INSTITUTION FOR WOMEN),1652,8,1660,1026,161.8,1564
2508,2002,1,WSP (WASCO SP),5941,27,5968,2984,200.0,5677
2509,2002,1,SCC (SIERRA CONSERVATION CENTER),6068,0,6068,3606,168.3,5869
2510,2002,1,SVSP (SALINAS VALLEY SP),4230,0,4230,2224,190.2,4156
2511,2002,1,RJD (RJ DONOVAN CORRECTIONAL FAC),4599,0,4599,2200,209.0,4673
2512,2002,1,PVSP (PLEASANT VALLEY SP),4633,0,4633,2208,209.8,4573
2513,2002,1,PBSP (PELICAN BAY SP),3205,0,3205,2280,140.6,3384
2514,2002,1,NKSP (NORTH KERN SP),5044,2,5046,2692,187.4,4857
2515,2002,1,MCSP (MULE CREEK SP),3589,0,3589,1700,211.1,3697
2516,2002,1,ISP (IRONWOOD SP),4544,0,4544,2200,206.5,4565
2517,2002,1,HDSP (HIGH DESERT SP),4167,6,4173,2224,187.6,4140
2518,2002,1,FOL (FOLSOM SP) (MALE),3704,0,3704,2072,178.8,3725
2519,2002,1,DVI (DEUEL VOCATIONAL INSTITUTION),4006,13,4019,1787,224.9,3941
2520,2002,1,CTF (CORRECTIONAL TRAINING FAC),5534,0,5534,2771,199.7,5631
2521,2002,1,CVSP (CHUCKAWALLA VALLEY SP),3547,0,3547,1738,204.1,3664
2522,2002,1,SATF (CA SUBSTANCE ABUSE TREAT FAC),6346,6,6352,3324,191.1,6330
2523,2002,1,"SOL (CA SP, SOLANO)",5876,0,5876,2610,225.1,5852
2524,2002,1,SQ (SAN QUENTIN SP),5585,8,5593,3273,170.9,5533
2525,2002,1,"SAC (CA SP, SACRAMENTO)",2895,0,2895,1728,167.5,3042
2526,2002,1,"LAC (CA SP, LOS ANGELES COUNTY)",4048,0,4048,2200,184.0,4020
2527,2002,1,"COR (CA SP, CORCORAN)",4795,0,4795,3016,159.0,4904
2528,2002,1,CEN (CENTINELA SP),4218,0,4218,2208,191.0,4453
2529,2002,1,CAL (CALIPATRIA SP),3959,0,3959,2208,179.3,4068
2530,2002,1,"CRC (CAL REHAB CTR, MEN)",2787,1068,3855,1814,212.5,3756
2531,2002,1,CMC (CA MEN'S COLONY),6504,0,6504,3884,167.5,6604
2532,2002,1,CMF (CA MEDICAL FAC),3235,0,3235,2315,139.7,3401
2533,2002,1,CIM (CA INSTITUTION FOR MEN),6463,30,6493,3078,210.9,6128
2534,2002,1,CCI (CA CORRECTIONAL INSTITUTION),5293,0,5293,2781,190.3,5450
2535,2002,1,CCC (CA CORRECTIONAL CENTER),5687,0,5687,3682,154.5,5642
2536,2002,1,ASP (AVENAL SP),6257,0,6257,2920,214.3,6378
2537,2002,2,VSP (VALLEY SP),2983,9,2992,1980,151.1,3247
2538,2002,2,SCC (SIERRA CONSERVATION CENTER),293,0,293,320,91.6,320
2539,2002,2,NCWF (NO CAL WOMEN'S FACIL),626,1,627,400,156.8,630
2540,2002,2,CCWF (CENTRAL CA WOMEN'S FAC),2996,1,2997,2004,149.6,2925
2541,2002,2,"CRC (CAL REHAB CTR, WOMEN)",306,314,620,500,124.0,680
2542,2002,2,CIW (CA INSTITUTION FOR WOMEN),1616,8,1624,1026,158.3,1564
2543,2002,2,WSP (WASCO SP),5990,33,6023,2984,201.8,5677
2544,2002,2,SCC (SIERRA CONSERVATION CENTER),6020,0,6020,3606,166.9,5869
2545,2002,2,SVSP (SALINAS VALLEY SP),4213,0,4213,2224,189.4,4156
2546,2002,2,RJD (RJ DONOVAN CORRECTIONAL FAC),4606,0,4606,2200,209.4,4673
2547,2002,2,PVSP (PLEASANT VALLEY SP),4622,0,4622,2208,209.3,4573
2548,2002,2,PBSP (PELICAN BAY SP),3180,0,3180,2280,139.5,3384
2549,2002,2,NKSP (NORTH KERN SP),5035,1,5036,2692,187.1,4857
2550,2002,2,MCSP (MULE CREEK SP),3630,0,3630,1700,213.5,3671
2551,2002,2,ISP (IRONWOOD SP),4633,0,4633,2200,210.6,4445
2552,2002,2,HDSP (HIGH DESERT SP),4136,6,4142,2224,186.2,4140
2553,2002,2,FOL (FOLSOM SP) (MALE),3692,0,3692,2072,178.2,3725
2554,2002,2,DVI (DEUEL VOCATIONAL INSTITUTION),4062,5,4067,1787,227.6,3941
2555,2002,2,CTF (CORRECTIONAL TRAINING FAC),5284,0,5284,2771,190.7,5631
2556,2002,2,CVSP (CHUCKAWALLA VALLEY SP),3578,0,3578,1738,205.9,3664
2557,2002,2,SATF (CA SUBSTANCE ABUSE TREAT FAC),6317,7,6324,3324,190.3,6505
2558,2002,2,"SOL (CA SP, SOLANO)",5840,0,5840,2610,223.8,5852
2559,2002,2,SQ (SAN QUENTIN SP),5732,13,5745,3273,175.5,5533
2560,2002,2,"SAC (CA SP, SACRAMENTO)",2881,0,2881,1728,166.7,2992
2561,2002,2,"LAC (CA SP, LOS ANGELES COUNTY)",3992,0,3992,2200,181.5,3980
2562,2002,2,"COR (CA SP, CORCORAN)",4705,0,4705,3016,156.0,4904
2563,2002,2,CEN (CENTINELA SP),4117,0,4117,2208,186.5,4308
2564,2002,2,CAL (CALIPATRIA SP),4029,0,4029,2208,182.5,4068
2565,2002,2,"CRC (CAL REHAB CTR, MEN)",2629,1062,3691,1814,203.5,3756
2566,2002,2,CMC (CA MEN'S COLONY),6578,0,6578,3884,169.4,6604
2567,2002,2,CMF (CA MEDICAL FAC),3246,0,3246,2315,140.2,3401
2568,2002,2,CIM (CA INSTITUTION FOR MEN),6445,32,6477,3078,210.4,6128
2569,2002,2,CCI (CA CORRECTIONAL INSTITUTION),5296,0,5296,2781,190.4,5450
2570,2002,2,CCC (CA CORRECTIONAL CENTER),5706,0,5706,3682,155.0,5642
2571,2002,2,ASP (AVENAL SP),6285,0,6285,2920,215.2,6378
2572,2002,3,VSP (VALLEY SP),2983,3,2986,1980,150.8,3247
2573,2002,3,SCC (SIERRA CONSERVATION CENTER),326,0,326,320,101.9,320
2574,2002,3,NCWF (NO CAL WOMEN'S FACIL),593,0,593,400,148.3,630
2575,2002,3,CCWF (CENTRAL CA WOMEN'S FAC),3052,1,3053,2004,152.3,2925
2576,2002,3,"CRC (CAL REHAB CTR, WOMEN)",292,314,606,500,121.2,680
2577,2002,3,CIW (CA INSTITUTION FOR WOMEN),1654,16,1670,1026,162.8,1564
2578,2002,3,WSP (WASCO SP),5992,24,6016,2984,201.6,5797
2579,2002,3,SCC (SIERRA CONSERVATION CENTER),6017,0,6017,3606,166.9,5869
2580,2002,3,SVSP (SALINAS VALLEY SP),4198,0,4198,2224,188.8,4156
2581,2002,3,RJD (RJ DONOVAN CORRECTIONAL FAC),4576,0,4576,2200,208.0,4673
2582,2002,3,PVSP (PLEASANT VALLEY SP),4671,0,4671,2208,211.5,4573
2583,2002,3,PBSP (PELICAN BAY SP),3212,0,3212,2280,140.9,3384
2584,2002,3,NKSP (NORTH KERN SP),4988,6,4994,2692,185.5,5089
2585,2002,3,MCSP (MULE CREEK SP),3617,0,3617,1700,212.8,3671
2586,2002,3,ISP (IRONWOOD SP),4572,0,4572,2200,207.8,4325
2587,2002,3,HDSP (HIGH DESERT SP),4163,9,4172,2224,187.6,4140
2588,2002,3,FOL (FOLSOM SP) (MALE),3608,0,3608,2072,174.1,3725
2589,2002,3,DVI (DEUEL VOCATIONAL INSTITUTION),3855,10,3865,1787,216.3,3941
2590,2002,3,CTF (CORRECTIONAL TRAINING FAC),5383,0,5383,2771,194.3,5631
2591,2002,3,CVSP (CHUCKAWALLA VALLEY SP),3614,0,3614,1738,207.9,3664
2592,2002,3,SATF (CA SUBSTANCE ABUSE TREAT FAC),6138,7,6145,3324,184.9,6505
2593,2002,3,"SOL (CA SP, SOLANO)",5731,0,5731,2610,219.6,5852
2594,2002,3,SQ (SAN QUENTIN SP),5756,12,5768,3273,176.2,5533
2595,2002,3,"SAC (CA SP, SACRAMENTO)",2915,0,2915,1728,168.7,2992
2596,2002,3,"LAC (CA SP, LOS ANGELES COUNTY)",3940,0,3940,2200,179.1,3980
2597,2002,3,"COR (CA SP, CORCORAN)",4678,0,4678,3016,155.1,4904
2598,2002,3,CEN (CENTINELA SP),4275,0,4275,2208,193.6,4308
2599,2002,3,CAL (CALIPATRIA SP),4049,0,4049,2208,183.4,4068
2600,2002,3,"CRC (CAL REHAB CTR, MEN)",2736,1083,3819,1814,210.5,3756
2601,2002,3,CMC (CA MEN'S COLONY),6549,0,6549,3884,168.6,6604
2602,2002,3,CMF (CA MEDICAL FAC),3219,0,3219,2315,139.0,3401
2603,2002,3,CIM (CA INSTITUTION FOR MEN),6376,38,6414,3078,208.4,6128
2604,2002,3,CCI (CA CORRECTIONAL INSTITUTION),5232,0,5232,2781,188.1,5450
2605,2002,3,CCC (CA CORRECTIONAL CENTER),5826,0,5826,3682,158.2,5642
2606,2002,3,ASP (AVENAL SP),6651,0,6651,2920,227.8,6378
2607,2002,4,VSP (VALLEY SP),2919,12,2931,1980,148.0,3067
2608,2002,4,SCC (SIERRA CONSERVATION CENTER),291,0,291,320,90.9,320
2609,2002,4,NCWF (NO CAL WOMEN'S FACIL),632,2,634,400,158.5,630
2610,2002,4,CCWF (CENTRAL CA WOMEN'S FAC),2999,2,3001,2004,149.8,2853
2611,2002,4,"CRC (CAL REHAB CTR, WOMEN)",321,308,629,500,125.8,680
2612,2002,4,CIW (CA INSTITUTION FOR WOMEN),1762,19,1781,1026,173.6,1564
2613,2002,4,WSP (WASCO SP),5971,22,5993,2984,200.8,5797
2614,2002,4,SCC (SIERRA CONSERVATION CENTER),5923,0,5923,3606,164.3,5869
2615,2002,4,SVSP (SALINAS VALLEY SP),4238,0,4238,2224,190.6,4156
2616,2002,4,RJD (RJ DONOVAN CORRECTIONAL FAC),4611,0,4611,2200,209.6,4673
2617,2002,4,PVSP (PLEASANT VALLEY SP),4613,0,4613,2208,208.9,4573
2618,2002,4,PBSP (PELICAN BAY SP),3238,1,3239,2280,142.1,3384
2619,2002,4,NKSP (NORTH KERN SP),5111,3,5114,2692,190.0,5089
2620,2002,4,MCSP (MULE CREEK SP),3602,0,3602,1700,211.9,3671
2621,2002,4,ISP (IRONWOOD SP),4423,0,4423,2200,201.0,4445
2622,2002,4,HDSP (HIGH DESERT SP),4122,7,4129,2224,185.7,4140
2623,2002,4,FOL (FOLSOM SP) (MALE),3641,0,3641,2072,175.7,3725
2624,2002,4,DVI (DEUEL VOCATIONAL INSTITUTION),3870,7,3877,1787,217.0,3941
2625,2002,4,CTF (CORRECTIONAL TRAINING FAC),5518,0,5518,2771,199.1,5631
2626,2002,4,CVSP (CHUCKAWALLA VALLEY SP),3560,0,3560,1738,204.8,3664
2627,2002,4,SATF (CA SUBSTANCE ABUSE TREAT FAC),6333,7,6340,3324,190.7,6625
2628,2002,4,"SOL (CA SP, SOLANO)",5757,0,5757,2610,220.6,5852
2629,2002,4,SQ (SAN QUENTIN SP),5723,16,5739,3273,175.3,5533
2630,2002,4,"SAC (CA SP, SACRAMENTO)",2959,0,2959,1728,171.2,2992
2631,2002,4,"LAC (CA SP, LOS ANGELES COUNTY)",3873,0,3873,2200,176.0,3980
2632,2002,4,"COR (CA SP, CORCORAN)",4731,0,4731,3016,156.9,4904
2633,2002,4,CEN (CENTINELA SP),4291,0,4291,2208,194.3,4428
2634,2002,4,CAL (CALIPATRIA SP),3997,0,3997,2208,181.0,4068
2635,2002,4,"CRC (CAL REHAB CTR, MEN)",2947,1060,4007,1814,220.9,3952
2636,2002,4,CMC (CA MEN'S COLONY),6560,0,6560,3884,168.9,6604
2637,2002,4,CMF (CA MEDICAL FAC),3219,0,3219,2315,139.0,3401
2638,2002,4,CIM (CA INSTITUTION FOR MEN),6361,32,6393,3078,207.7,6128
2639,2002,4,CCI (CA CORRECTIONAL INSTITUTION),5146,0,5146,2781,185.0,5450
2640,2002,4,CCC (CA CORRECTIONAL CENTER),5818,0,5818,3682,158.0,5642
2641,2002,4,ASP (AVENAL SP),6549,0,6549,2920,224.3,6578
2642,2002,5,VSP (VALLEY SP),3032,8,3040,1980,153.5,3067
2643,2002,5,SCC (SIERRA CONSERVATION CENTER),326,0,326,320,101.9,320
2644,2002,5,NCWF (NO CAL WOMEN'S FACIL),672,0,672,400,168.0,630
2645,2002,5,CCWF (CENTRAL CA WOMEN'S FAC),3075,2,3077,2004,153.5,2853
2646,2002,5,"CRC (CAL REHAB CTR, WOMEN)",326,300,626,500,125.2,680
2647,2002,5,CIW (CA INSTITUTION FOR WOMEN),1711,17,1728,1026,168.4,1564
2648,2002,5,WSP (WASCO SP),5917,39,5956,2984,199.6,5797
2649,2002,5,SCC (SIERRA CONSERVATION CENTER),6028,0,6028,3606,167.2,5869
2650,2002,5,SVSP (SALINAS VALLEY SP),4169,0,4169,2224,187.5,4156
2651,2002,5,RJD (RJ DONOVAN CORRECTIONAL FAC),4605,0,4605,2200,209.3,4673
2652,2002,5,PVSP (PLEASANT VALLEY SP),4653,0,4653,2208,210.7,4573
2653,2002,5,PBSP (PELICAN BAY SP),3230,0,3230,2280,141.7,3384
2654,2002,5,NKSP (NORTH KERN SP),4994,4,4998,2692,185.7,5089
2655,2002,5,MCSP (MULE CREEK SP),3659,0,3659,1700,215.2,3671
2656,2002,5,ISP (IRONWOOD SP),4663,0,4663,2200,212.0,4445
2657,2002,5,HDSP (HIGH DESERT SP),4176,3,4179,2224,187.9,4140
2658,2002,5,FOL (FOLSOM SP) (MALE),3722,0,3722,2072,179.6,3725
2659,2002,5,DVI (DEUEL VOCATIONAL INSTITUTION),3925,14,3939,1787,220.4,3941
2660,2002,5,CTF (CORRECTIONAL TRAINING FAC),5721,0,5721,2771,206.5,5631
2661,2002,5,CVSP (CHUCKAWALLA VALLEY SP),3681,0,3681,1738,211.8,3664
2662,2002,5,SATF (CA SUBSTANCE ABUSE TREAT FAC),6479,5,6484,3324,195.1,6625
2663,2002,5,"SOL (CA SP, SOLANO)",5837,0,5837,2610,223.6,5852
2664,2002,5,SQ (SAN QUENTIN SP),5703,5,5708,3273,174.4,5533
2665,2002,5,"SAC (CA SP, SACRAMENTO)",2907,0,2907,1728,168.2,2992
2666,2002,5,"LAC (CA SP, LOS ANGELES COUNTY)",3879,0,3879,2200,176.3,3980
2667,2002,5,"COR (CA SP, CORCORAN)",4876,0,4876,3016,161.7,4904
2668,2002,5,CEN (CENTINELA SP),4369,0,4369,2208,197.9,4428
2669,2002,5,CAL (CALIPATRIA SP),4011,0,4011,2208,181.7,4068
2670,2002,5,"CRC (CAL REHAB CTR, MEN)",2932,1068,4000,1814,220.5,3952
2671,2002,5,CMC (CA MEN'S COLONY),6558,0,6558,3884,168.8,6604
2672,2002,5,CMF (CA MEDICAL FAC),3257,0,3257,2315,140.7,3401
2673,2002,5,CIM (CA INSTITUTION FOR MEN),6305,27,6332,3078,205.7,6128
2674,2002,5,CCI (CA CORRECTIONAL INSTITUTION),5200,0,5200,2781,187.0,5450
2675,2002,5,CCC (CA CORRECTIONAL CENTER),5948,0,5948,3682,161.5,5642
2676,2002,5,ASP (AVENAL SP),6836,0,6836,2920,234.1,6578
2677,2002,6,VSP (VALLEY SP),3026,4,3030,1980,153.0,3247
2678,2002,6,SCC (SIERRA CONSERVATION CENTER),325,0,325,320,101.6,320
2679,2002,6,NCWF (NO CAL WOMEN'S FACIL),702,1,703,400,175.8,630
2680,2002,6,CCWF (CENTRAL CA WOMEN'S FAC),3041,3,3044,2004,151.9,2853
2681,2002,6,"CRC (CAL REHAB CTR, WOMEN)",340,291,631,500,126.2,680
2682,2002,6,CIW (CA INSTITUTION FOR WOMEN),1761,12,1773,1026,172.8,1564
2683,2002,6,WSP (WASCO SP),5926,23,5949,2984,199.4,5797
2684,2002,6,SCC (SIERRA CONSERVATION CENTER),6047,0,6047,3606,167.7,5869
2685,2002,6,SVSP (SALINAS VALLEY SP),4170,0,4170,2224,187.5,4256
2686,2002,6,RJD (RJ DONOVAN CORRECTIONAL FAC),4577,0,4577,2200,208.0,4673
2687,2002,6,PVSP (PLEASANT VALLEY SP),4665,0,4665,2208,211.3,4573
2688,2002,6,PBSP (PELICAN BAY SP),3279,0,3279,2280,143.8,3494
2689,2002,6,NKSP (NORTH KERN SP),5074,3,5077,2692,188.6,5089
2690,2002,6,MCSP (MULE CREEK SP),3652,0,3652,1700,214.8,3671
2691,2002,6,ISP (IRONWOOD SP),4635,0,4635,2200,210.7,4565
2692,2002,6,HDSP (HIGH DESERT SP),4148,3,4151,2224,186.6,4260
2693,2002,6,FOL (FOLSOM SP) (MALE),3739,0,3739,2072,180.5,3725
2694,2002,6,DVI (DEUEL VOCATIONAL INSTITUTION),3994,11,4005,1787,224.1,3941
2695,2002,6,CTF (CORRECTIONAL TRAINING FAC),5869,0,5869,2771,211.8,5791
2696,2002,6,CVSP (CHUCKAWALLA VALLEY SP),3611,0,3611,1738,207.8,3664
2697,2002,6,SATF (CA SUBSTANCE ABUSE TREAT FAC),6481,5,6486,3324,195.1,6655
2698,2002,6,"SOL (CA SP, SOLANO)",5775,0,5775,2610,221.3,5852
2699,2002,6,SQ (SAN QUENTIN SP),5690,6,5696,3273,174.0,5533
2700,2002,6,"SAC (CA SP, SACRAMENTO)",2895,0,2895,1728,167.5,3042
2701,2002,6,"LAC (CA SP, LOS ANGELES COUNTY)",3914,0,3914,2200,177.9,3980
2702,2002,6,"COR (CA SP, CORCORAN)",4898,0,4898,3016,162.4,5019
2703,2002,6,CEN (CENTINELA SP),4446,0,4446,2208,201.4,4548
2704,2002,6,CAL (CALIPATRIA SP),4102,0,4102,2208,185.8,4068
2705,2002,6,"CRC (CAL REHAB CTR, MEN)",2867,1053,3920,1814,216.1,3952
2706,2002,6,CMC (CA MEN'S COLONY),6594,0,6594,3884,169.8,6604
2707,2002,6,CMF (CA MEDICAL FAC),3282,0,3282,2315,141.8,3401
2708,2002,6,CIM (CA INSTITUTION FOR MEN),6249,24,6273,3078,203.8,6265
2709,2002,6,CCI (CA CORRECTIONAL INSTITUTION),5296,0,5296,2781,190.4,5475
2710,2002,6,CCC (CA CORRECTIONAL CENTER),5901,0,5901,3682,160.3,5642
2711,2002,6,ASP (AVENAL SP),6943,0,6943,2920,237.8,6778
2712,2002,7,VSP (VALLEY SP),3047,11,3058,1980,154.4,3247
2713,2002,7,SCC (SIERRA CONSERVATION CENTER),308,0,308,320,96.3,320
2714,2002,7,NCWF (NO CAL WOMEN'S FACIL),716,2,718,400,179.5,630
2715,2002,7,CCWF (CENTRAL CA WOMEN'S FAC),3088,3,3091,2004,154.2,2853
2716,2002,7,"CRC (CAL REHAB CTR, WOMEN)",343,280,623,500,124.6,680
2717,2002,7,CIW (CA INSTITUTION FOR WOMEN),1784,10,1794,1026,174.9,1564
2718,2002,7,WSP (WASCO SP),5985,14,5999,2984,201.0,5893
2719,2002,7,SCC (SIERRA CONSERVATION CENTER),5994,0,5994,3606,166.2,5869
2720,2002,7,SVSP (SALINAS VALLEY SP),4212,0,4212,2224,189.4,4376
2721,2002,7,RJD (RJ DONOVAN CORRECTIONAL FAC),4608,1,4609,2200,209.5,4673
2722,2002,7,PVSP (PLEASANT VALLEY SP),4648,0,4648,2208,210.5,4573
2723,2002,7,PBSP (PELICAN BAY SP),3272,0,3272,2280,143.5,3494
2724,2002,7,NKSP (NORTH KERN SP),5103,2,5105,2692,189.6,5089
2725,2002,7,MCSP (MULE CREEK SP),3666,0,3666,1700,215.6,3671
2726,2002,7,ISP (IRONWOOD SP),4602,0,4602,2200,209.2,4565
2727,2002,7,HDSP (HIGH DESERT SP),4177,2,4179,2224,187.9,4260
2728,2002,7,FOL (FOLSOM SP) (MALE),3668,0,3668,2072,177.0,3725
2729,2002,7,DVI (DEUEL VOCATIONAL INSTITUTION),3902,11,3913,1787,219.0,3941
2730,2002,7,CTF (CORRECTIONAL TRAINING FAC),6298,0,6298,3281,192.0,6301
2731,2002,7,CVSP (CHUCKAWALLA VALLEY SP),3660,0,3660,1738,210.6,3664
2732,2002,7,SATF (CA SUBSTANCE ABUSE TREAT FAC),6471,2,6473,3324,194.7,6655
2733,2002,7,"SOL (CA SP, SOLANO)",5823,0,5823,2610,223.1,5852
2734,2002,7,SQ (SAN QUENTIN SP),5614,4,5618,3273,171.6,5533
2735,2002,7,"SAC (CA SP, SACRAMENTO)",2970,0,2970,1728,171.9,3042
2736,2002,7,"LAC (CA SP, LOS ANGELES COUNTY)",4027,0,4027,2200,183.0,4100
2737,2002,7,"COR (CA SP, CORCORAN)",4986,0,4986,3016,165.3,5019
2738,2002,7,CEN (CENTINELA SP),4512,0,4512,2208,204.3,4668
2739,2002,7,CAL (CALIPATRIA SP),4045,0,4045,2208,183.2,4068
2740,2002,7,"CRC (CAL REHAB CTR, MEN)",2913,1023,3936,1814,217.0,3952
2741,2002,7,CMC (CA MEN'S COLONY),6540,0,6540,3884,168.4,6604
2742,2002,7,CMF (CA MEDICAL FAC),3308,0,3308,2315,142.9,3401
2743,2002,7,CIM (CA INSTITUTION FOR MEN),6524,28,6552,3078,212.9,6265
2744,2002,7,CCI (CA CORRECTIONAL INSTITUTION),5339,0,5339,2781,192.0,5600
2745,2002,7,CCC (CA CORRECTIONAL CENTER),5918,0,5918,3682,160.7,5642
2746,2002,7,ASP (AVENAL SP),6865,0,6865,2920,235.1,6778
2747,2002,8,VSP (VALLEY SP),3021,3,3024,1980,152.7,3247
2748,2002,8,SCC (SIERRA CONSERVATION CENTER),331,0,331,320,103.4,320
2749,2002,8,NCWF (NO CAL WOMEN'S FACIL),731,3,734,400,183.5,630
2750,2002,8,CCWF (CENTRAL CA WOMEN'S FAC),3137,6,3143,2004,156.8,2853
2751,2002,8,"CRC (CAL REHAB CTR, WOMEN)",310,278,588,500,117.6,680
2752,2002,8,CIW (CA INSTITUTION FOR WOMEN),1714,12,1726,1026,168.2,1564
2753,2002,8,WSP (WASCO SP),6048,23,6071,2984,203.5,5893
2754,2002,8,SCC (SIERRA CONSERVATION CENTER),6018,0,6018,3606,166.9,5869
2755,2002,8,SVSP (SALINAS VALLEY SP),4201,0,4201,2224,188.9,4376
2756,2002,8,RJD (RJ DONOVAN CORRECTIONAL FAC),4519,0,4519,2200,205.4,4673
2757,2002,8,PVSP (PLEASANT VALLEY SP),4604,0,4604,2208,208.5,4573
2758,2002,8,PBSP (PELICAN BAY SP),3309,0,3309,2280,145.1,3494
2759,2002,8,NKSP (NORTH KERN SP),5079,7,5086,2692,188.9,5089
2760,2002,8,MCSP (MULE CREEK SP),3655,0,3655,1700,215.0,3671
2761,2002,8,ISP (IRONWOOD SP),4621,0,4621,2200,210.0,4565
2762,2002,8,HDSP (HIGH DESERT SP),4170,4,4174,2224,187.7,4260
2763,2002,8,FOL (FOLSOM SP) (MALE),3725,0,3725,2072,179.8,3725
2764,2002,8,DVI (DEUEL VOCATIONAL INSTITUTION),3968,10,3978,1787,222.6,3941
2765,2002,8,CTF (CORRECTIONAL TRAINING FAC),6836,1,6837,3281,208.4,6761
2766,2002,8,CVSP (CHUCKAWALLA VALLEY SP),3655,0,3655,1738,210.3,3664
2767,2002,8,SATF (CA SUBSTANCE ABUSE TREAT FAC),6493,2,6495,3324,195.4,6655
2768,2002,8,"SOL (CA SP, SOLANO)",5788,0,5788,2610,221.8,5852
2769,2002,8,SQ (SAN QUENTIN SP),5770,9,5779,3273,176.6,5533
2770,2002,8,"SAC (CA SP, SACRAMENTO)",2939,0,2939,1728,170.1,3042
2771,2002,8,"LAC (CA SP, LOS ANGELES COUNTY)",4079,0,4079,2200,185.4,4100
2772,2002,8,"COR (CA SP, CORCORAN)",4958,0,4958,3016,164.4,5019
2773,2002,8,CEN (CENTINELA SP),4501,0,4501,2208,203.8,4668
2774,2002,8,CAL (CALIPATRIA SP),4111,0,4111,2208,186.2,4068
2775,2002,8,"CRC (CAL REHAB CTR, MEN)",2982,997,3979,1814,219.3,3952
2776,2002,8,CMC (CA MEN'S COLONY),6518,0,6518,3884,167.8,6604
2777,2002,8,CMF (CA MEDICAL FAC),3295,0,3295,2315,142.3,3401
2778,2002,8,CIM (CA INSTITUTION FOR MEN),6617,66,6683,3078,217.1,6265
2779,2002,8,CCI (CA CORRECTIONAL INSTITUTION),5377,0,5377,2781,193.3,5600
2780,2002,8,CCC (CA CORRECTIONAL CENTER),5913,0,5913,3682,160.6,5642
2781,2002,8,ASP (AVENAL SP),6899,0,6899,2920,236.3,6778
2782,2002,9,VSP (VALLEY SP),3082,9,3091,1980,156.1,3247
2783,2002,9,SCC (SIERRA CONSERVATION CENTER),335,0,335,320,104.7,320
2784,2002,9,NCWF (NO CAL WOMEN'S FACIL),703,0,703,400,175.8,630
2785,2002,9,CCWF (CENTRAL CA WOMEN'S FAC),3159,4,3163,2004,157.8,2978
2786,2002,9,"CRC (CAL REHAB CTR, WOMEN)",300,293,593,500,118.6,680
2787,2002,9,CIW (CA INSTITUTION FOR WOMEN),1762,8,1770,1026,172.5,1564
2788,2002,9,WSP (WASCO SP),5925,15,5940,2984,199.1,5893
2789,2002,9,SCC (SIERRA CONSERVATION CENTER),6047,0,6047,3606,167.7,5869
2790,2002,9,SVSP (SALINAS VALLEY SP),4218,0,4218,2224,189.7,4376
2791,2002,9,RJD (RJ DONOVAN CORRECTIONAL FAC),4562,0,4562,2200,207.4,4673
2792,2002,9,PVSP (PLEASANT VALLEY SP),4628,0,4628,2208,209.6,4573
2793,2002,9,PBSP (PELICAN BAY SP),3290,0,3290,2280,144.3,3494
2794,2002,9,NKSP (NORTH KERN SP),5099,4,5103,2692,189.6,5089
2795,2002,9,MCSP (MULE CREEK SP),3645,0,3645,1700,214.4,3671
2796,2002,9,ISP (IRONWOOD SP),4642,0,4642,2200,211.0,4565
2797,2002,9,HDSP (HIGH DESERT SP),4309,0,4309,2224,193.8,4260
2798,2002,9,FOL (FOLSOM SP) (MALE),3711,0,3711,2072,179.1,3725
2799,2002,9,DVI (DEUEL VOCATIONAL INSTITUTION),3915,11,3926,1787,219.7,3941
2800,2002,9,CTF (CORRECTIONAL TRAINING FAC),6901,0,6901,3281,210.3,6761
2801,2002,9,CVSP (CHUCKAWALLA VALLEY SP),3684,0,3684,1738,212.0,3664
2802,2002,9,SATF (CA SUBSTANCE ABUSE TREAT FAC),6618,2,6620,3324,199.2,6655
2803,2002,9,"SOL (CA SP, SOLANO)",5770,0,5770,2610,221.1,5852
2804,2002,9,SQ (SAN QUENTIN SP),5775,3,5778,3273,176.5,5533
2805,2002,9,"SAC (CA SP, SACRAMENTO)",2940,0,2940,1728,170.1,3042
2806,2002,9,"LAC (CA SP, LOS ANGELES COUNTY)",4169,0,4169,2200,189.5,4100
2807,2002,9,"COR (CA SP, CORCORAN)",4982,0,4982,3016,165.2,5019
2808,2002,9,CEN (CENTINELA SP),4482,0,4482,2208,203.0,4668
2809,2002,9,CAL (CALIPATRIA SP),4113,0,4113,2208,186.3,4068
2810,2002,9,"CRC (CAL REHAB CTR, MEN)",2943,1037,3980,1814,219.4,3952
2811,2002,9,CMC (CA MEN'S COLONY),6532,0,6532,3884,168.2,6604
2812,2002,9,CMF (CA MEDICAL FAC),3321,0,3321,2315,143.5,3401
2813,2002,9,CIM (CA INSTITUTION FOR MEN),6546,42,6588,3078,214.0,6265
2814,2002,9,CCI (CA CORRECTIONAL INSTITUTION),5397,0,5397,2781,194.1,5600
2815,2002,9,CCC (CA CORRECTIONAL CENTER),5911,0,5911,3682,160.5,5642
2816,2002,9,ASP (AVENAL SP),6949,0,6949,2920,238.0,6778
2817,2002,10,VSP (VALLEY SP),3082,6,3088,1980,156.0,3427
2818,2002,10,SCC (SIERRA CONSERVATION CENTER),328,0,328,320,102.5,320
2819,2002,10,NCWF (NO CAL WOMEN'S FACIL),669,1,670,400,167.5,630
2820,2002,10,CCWF (CENTRAL CA WOMEN'S FAC),3141,5,3146,2004,157.0,3103
2821,2002,10,"CRC (CAL REHAB CTR, WOMEN)",328,294,622,500,124.4,680
2822,2002,10,CIW (CA INSTITUTION FOR WOMEN),1736,11,1747,1026,170.3,1564
2823,2002,10,WSP (WASCO SP),5765,18,5783,2984,193.8,5893
2824,2002,10,SCC (SIERRA CONSERVATION CENTER),6065,0,6065,3606,168.2,5869
2825,2002,10,SVSP (SALINAS VALLEY SP),4191,0,4191,2224,188.4,4376
2826,2002,10,RJD (RJ DONOVAN CORRECTIONAL FAC),4568,0,4568,2200,207.6,4673
2827,2002,10,PVSP (PLEASANT VALLEY SP),4419,0,4419,2208,200.1,4573
2828,2002,10,PBSP (PELICAN BAY SP),3331,0,3331,2280,146.1,3604
2829,2002,10,NKSP (NORTH KERN SP),5030,4,5034,2692,187.0,5089
2830,2002,10,MCSP (MULE CREEK SP),3615,0,3615,1700,212.6,3671
2831,2002,10,ISP (IRONWOOD SP),4646,0,4646,2200,211.2,4565
2832,2002,10,HDSP (HIGH DESERT SP),4385,4,4389,2224,197.3,4140
2833,2002,10,FOL (FOLSOM SP) (MALE),3675,0,3675,2072,177.4,3725
2834,2002,10,DVI (DEUEL VOCATIONAL INSTITUTION),3903,19,3922,1787,219.5,3941
2835,2002,10,CTF (CORRECTIONAL TRAINING FAC),7114,0,7114,3281,216.8,7001
2836,2002,10,CVSP (CHUCKAWALLA VALLEY SP),3635,0,3635,1738,209.1,3664
2837,2002,10,SATF (CA SUBSTANCE ABUSE TREAT FAC),6805,3,6808,3324,204.8,6775
2838,2002,10,"SOL (CA SP, SOLANO)",5832,1,5833,2610,223.5,5852
2839,2002,10,SQ (SAN QUENTIN SP),5689,7,5696,3273,174.0,5533
2840,2002,10,"SAC (CA SP, SACRAMENTO)",3103,0,3103,1728,179.6,3226
2841,2002,10,"LAC (CA SP, LOS ANGELES COUNTY)",4194,0,4194,2200,190.6,4100
2842,2002,10,"COR (CA SP, CORCORAN)",4902,0,4902,3016,162.5,5019
2843,2002,10,CEN (CENTINELA SP),4495,0,4495,2208,203.6,4668
2844,2002,10,CAL (CALIPATRIA SP),4186,0,4186,2208,189.6,4068
2845,2002,10,"CRC (CAL REHAB CTR, MEN)",2957,1073,4030,1814,222.2,3952
2846,2002,10,CMC (CA MEN'S COLONY),6644,0,6644,3884,171.1,6754
2847,2002,10,CMF (CA MEDICAL FAC),3327,0,3327,2315,143.7,3401
2848,2002,10,CIM (CA INSTITUTION FOR MEN),6306,51,6357,3078,206.5,6265
2849,2002,10,CCI (CA CORRECTIONAL INSTITUTION),5496,0,5496,2781,197.6,5600
2850,2002,10,CCC (CA CORRECTIONAL CENTER),5997,0,5997,3682,162.9,5642
2851,2002,10,ASP (AVENAL SP),6820,0,6820,2920,233.6,6778
2852,2002,11,VSP (VALLEY SP),3107,5,3112,1980,157.2,3427
2853,2002,11,SCC (SIERRA CONSERVATION CENTER),325,0,325,320,101.6,320
2854,2002,11,NCWF (NO CAL WOMEN'S FACIL),672,0,672,400,168.0,630
2855,2002,11,CCWF (CENTRAL CA WOMEN'S FAC),3114,5,3119,2004,155.6,3103
2856,2002,11,"CRC (CAL REHAB CTR, WOMEN)",341,298,639,500,127.8,680
2857,2002,11,CIW (CA INSTITUTION FOR WOMEN),1646,9,1655,1026,161.3,1564
2858,2002,11,WSP (WASCO SP),5900,20,5920,2984,198.4,5893
2859,2002,11,SCC (SIERRA CONSERVATION CENTER),6074,0,6074,3606,168.4,5869
2860,2002,11,SVSP (SALINAS VALLEY SP),4219,0,4219,2224,189.7,4376
2861,2002,11,RJD (RJ DONOVAN CORRECTIONAL FAC),4423,0,4423,2200,201.0,4673
2862,2002,11,PVSP (PLEASANT VALLEY SP),4525,0,4525,2208,204.9,4573
2863,2002,11,PBSP (PELICAN BAY SP),3305,0,3305,2280,145.0,3604
2864,2002,11,NKSP (NORTH KERN SP),4969,2,4971,2692,184.7,5089
2865,2002,11,MCSP (MULE CREEK SP),3598,0,3598,1700,211.6,3671
2866,2002,11,ISP (IRONWOOD SP),4598,0,4598,2200,209.0,4565
2867,2002,11,HDSP (HIGH DESERT SP),4497,3,4500,2344,192.0,4260
2868,2002,11,FOL (FOLSOM SP) (MALE),3628,0,3628,2072,175.1,3725
2869,2002,11,DVI (DEUEL VOCATIONAL INSTITUTION),3835,20,3855,1787,215.7,3941
2870,2002,11,CTF (CORRECTIONAL TRAINING FAC),7015,0,7015,3281,213.8,7001
2871,2002,11,CVSP (CHUCKAWALLA VALLEY SP),3694,0,3694,1738,212.5,3808
2872,2002,11,SATF (CA SUBSTANCE ABUSE TREAT FAC),6660,4,6664,3324,200.5,6775
2873,2002,11,"SOL (CA SP, SOLANO)",5753,0,5753,2610,220.4,5852
2874,2002,11,SQ (SAN QUENTIN SP),5581,3,5584,3273,170.6,5533
2875,2002,11,"SAC (CA SP, SACRAMENTO)",3061,0,3061,1728,177.1,3226
2876,2002,11,"LAC (CA SP, LOS ANGELES COUNTY)",4118,0,4118,2200,187.2,4290
2877,2002,11,"COR (CA SP, CORCORAN)",4858,1,4859,3016,161.1,5019
2878,2002,11,CEN (CENTINELA SP),4515,0,4515,2208,204.5,4668
2879,2002,11,CAL (CALIPATRIA SP),4140,0,4140,2208,187.5,4068
2880,2002,11,"CRC (CAL REHAB CTR, MEN)",2920,1102,4022,1814,221.7,3952
2881,2002,11,CMC (CA MEN'S COLONY),6582,1,6583,3884,169.5,6754
2882,2002,11,CMF (CA MEDICAL FAC),3288,0,3288,2315,142.0,3401
2883,2002,11,CIM (CA INSTITUTION FOR MEN),6182,47,6229,3078,202.4,6265
2884,2002,11,CCI (CA CORRECTIONAL INSTITUTION),5373,0,5373,2781,193.2,5600
2885,2002,11,CCC (CA CORRECTIONAL CENTER),5834,0,5834,3682,158.4,5642
2886,2002,11,ASP (AVENAL SP),7046,0,7046,2920,241.3,6978
2887,2002,12,VSP (VALLEY SP),3123,0,3123,1980,157.7,3427
2888,2002,12,SCC (SIERRA CONSERVATION CENTER),326,0,326,320,101.9,320
2889,2002,12,NCWF (NO CAL WOMEN'S FACIL),640,0,640,400,160.0,630
2890,2002,12,CCWF (CENTRAL CA WOMEN'S FAC),3150,6,3156,2004,157.5,3103
2891,2002,12,"CRC (CAL REHAB CTR, WOMEN)",357,291,648,500,129.6,680
2892,2002,12,CIW (CA INSTITUTION FOR WOMEN),1474,9,1483,1026,144.5,1564
2893,2002,12,WSP (WASCO SP),5799,18,5817,2984,194.9,5893
2894,2002,12,SCC (SIERRA CONSERVATION CENTER),6075,0,6075,3606,168.5,5869
2895,2002,12,SVSP (SALINAS VALLEY SP),4261,0,4261,2224,191.6,4376
2896,2002,12,RJD (RJ DONOVAN CORRECTIONAL FAC),4143,0,4143,2200,188.3,4673
2897,2002,12,PVSP (PLEASANT VALLEY SP),4479,0,4479,2208,202.9,4573
2898,2002,12,PBSP (PELICAN BAY SP),3328,0,3328,2280,146.0,3604
2899,2002,12,NKSP (NORTH KERN SP),4922,3,4925,2692,182.9,5089
2900,2002,12,MCSP (MULE CREEK SP),3621,0,3621,1700,213.0,3671
2901,2002,12,ISP (IRONWOOD SP),4507,0,4507,2200,204.9,4565
2902,2002,12,HDSP (HIGH DESERT SP),4506,1,4507,2344,192.3,4260
2903,2002,12,FOL (FOLSOM SP) (MALE),3583,0,3583,2072,172.9,3725
2904,2002,12,DVI (DEUEL VOCATIONAL INSTITUTION),3868,19,3887,1787,217.5,3941
2905,2002,12,CTF (CORRECTIONAL TRAINING FAC),7011,0,7011,3281,213.7,7001
2906,2002,12,CVSP (CHUCKAWALLA VALLEY SP),3614,0,3614,1738,207.9,3808
2907,2002,12,SATF (CA SUBSTANCE ABUSE TREAT FAC),6569,6,6575,3324,197.8,6775
2908,2002,12,"SOL (CA SP, SOLANO)",5779,0,5779,2610,221.4,5852
2909,2002,12,SQ (SAN QUENTIN SP),5757,4,5761,3273,176.0,5533
2910,2002,12,"SAC (CA SP, SACRAMENTO)",2916,0,2916,1728,168.8,3226
2911,2002,12,"LAC (CA SP, LOS ANGELES COUNTY)",4104,0,4104,2200,186.5,4290
2912,2002,12,"COR (CA SP, CORCORAN)",4848,0,4848,3016,160.7,5019
2913,2002,12,CEN (CENTINELA SP),4497,0,4497,2208,203.7,4668
2914,2002,12,CAL (CALIPATRIA SP),4121,0,4121,2208,186.6,4068
2915,2002,12,"CRC (CAL REHAB CTR, MEN)",2875,1112,3987,1814,219.8,3952
2916,2002,12,CMC (CA MEN'S COLONY),6561,0,6561,3884,168.9,6754
2917,2002,12,CMF (CA MEDICAL FAC),3295,0,3295,2315,142.3,3401
2918,2002,12,CIM (CA INSTITUTION FOR MEN),6312,41,6353,3078,206.4,6265
2919,2002,12,CCI (CA CORRECTIONAL INSTITUTION),5343,0,5343,2781,192.1,5600
2920,2002,12,CCC (CA CORRECTIONAL CENTER),5702,0,5702,3682,154.9,5642
2921,2002,12,ASP (AVENAL SP),6952,0,6952,2920,238.1,6978
2922,2003,1,VSP (VALLEY SP),3177,2,3179,1980,160.6,3427
2923,2003,1,SCC (SIERRA CONSERVATION CENTER),325,0,325,320,101.6,320
2924,2003,1,NCWF (NO CAL WOMEN'S FACIL),421,0,421,400,105.3,630
2925,2003,1,CCWF (CENTRAL CA WOMEN'S FAC),3291,11,3302,2004,164.8,3103
2926,2003,1,"CRC (CAL REHAB CTR, WOMEN)",319,287,606,500,121.2,680
2927,2003,1,CIW (CA INSTITUTION FOR WOMEN),1525,6,1531,1026,149.2,1564
2928,2003,1,WSP (WASCO SP),6164,13,6177,2984,207.0,5797
2929,2003,1,SCC (SIERRA CONSERVATION CENTER),5947,0,5947,3606,164.9,5869
2930,2003,1,SVSP (SALINAS VALLEY SP),4299,0,4299,2224,193.3,4376
2931,2003,1,RJD (RJ DONOVAN CORRECTIONAL FAC),4047,0,4047,2200,184.0,4443
2932,2003,1,PVSP (PLEASANT VALLEY SP),4430,0,4430,2208,200.6,4573
2933,2003,1,PBSP (PELICAN BAY SP),3283,0,3283,2280,144.0,3604
2934,2003,1,NKSP (NORTH KERN SP),5025,0,5025,2692,186.7,5089
2935,2003,1,MCSP (MULE CREEK SP),3587,0,3587,1700,211.0,3671
2936,2003,1,ISP (IRONWOOD SP),4361,0,4361,2200,198.2,4565
2937,2003,1,HDSP (HIGH DESERT SP),4420,1,4421,2344,188.6,4140
2938,2003,1,FOL (FOLSOM SP) (MALE),3665,0,3665,2072,176.9,3725
2939,2003,1,DVI (DEUEL VOCATIONAL INSTITUTION),3939,17,3956,1787,221.4,3941
2940,2003,1,CTF (CORRECTIONAL TRAINING FAC),7041,0,7041,3281,214.6,7001
2941,2003,1,CVSP (CHUCKAWALLA VALLEY SP),3493,0,3493,1738,201.0,3664
2942,2003,1,SATF (CA SUBSTANCE ABUSE TREAT FAC),6671,5,6676,3324,200.8,6655
2943,2003,1,"SOL (CA SP, SOLANO)",5803,0,5803,2610,222.3,5852
2944,2003,1,SQ (SAN QUENTIN SP),5941,5,5946,3273,181.7,5533
2945,2003,1,"SAC (CA SP, SACRAMENTO)",2899,0,2899,1728,167.8,3192
2946,2003,1,"LAC (CA SP, LOS ANGELES COUNTY)",4124,0,4124,2200,187.5,4480
2947,2003,1,"COR (CA SP, CORCORAN)",4792,0,4792,3016,158.9,4904
2948,2003,1,CEN (CENTINELA SP),4499,0,4499,2208,203.8,4668
2949,2003,1,CAL (CALIPATRIA SP),4075,0,4075,2208,184.6,4068
2950,2003,1,"CRC (CAL REHAB CTR, MEN)",2874,1124,3998,1814,220.4,3952
2951,2003,1,CMC (CA MEN'S COLONY),6470,0,6470,3884,166.6,6754
2952,2003,1,CMF (CA MEDICAL FAC),3278,0,3278,2315,141.6,3401
2953,2003,1,CIM (CA INSTITUTION FOR MEN),6508,41,6549,3078,212.8,6265
2954,2003,1,CCI (CA CORRECTIONAL INSTITUTION),5315,0,5315,2781,191.1,5600
2955,2003,1,CCC (CA CORRECTIONAL CENTER),5608,0,5608,3682,152.3,5642
2956,2003,1,ASP (AVENAL SP),6938,0,6938,2920,237.6,6778
2957,2003,2,VSP (VALLEY SP),3315,6,3321,1980,167.7,3660
2958,2003,2,SCC (SIERRA CONSERVATION CENTER),308,0,308,320,96.3,320
2959,2003,2,CCWF (CENTRAL CA WOMEN'S FAC),3533,9,3542,2004,176.7,3233
2960,2003,2,"CRC (CAL REHAB CTR, WOMEN)",318,268,586,500,117.2,680
2961,2003,2,CIW (CA INSTITUTION FOR WOMEN),1656,7,1663,1026,162.1,1564
2962,2003,2,WSP (WASCO SP),6130,14,6144,2984,205.9,5797
2963,2003,2,SCC (SIERRA CONSERVATION CENTER),5929,0,5929,3606,164.4,5869
2964,2003,2,SVSP (SALINAS VALLEY SP),4258,0,4258,2224,191.5,4552
2965,2003,2,RJD (RJ DONOVAN CORRECTIONAL FAC),4126,0,4126,2200,187.5,4443
2966,2003,2,PVSP (PLEASANT VALLEY SP),4460,0,4460,2208,202.0,4763
2967,2003,2,PBSP (PELICAN BAY SP),3303,0,3303,2280,144.9,3604
2968,2003,2,NKSP (NORTH KERN SP),5055,3,5058,2692,187.9,5089
2969,2003,2,MCSP (MULE CREEK SP),3629,0,3629,1700,213.5,3671
2970,2003,2,ISP (IRONWOOD SP),4370,0,4370,2200,198.6,4325
2971,2003,2,HDSP (HIGH DESERT SP),4351,1,4352,2344,185.7,4140
2972,2003,2,FOL (FOLSOM SP) (MALE),3835,0,3835,2072,185.1,3725
2973,2003,2,DVI (DEUEL VOCATIONAL INSTITUTION),3622,20,3642,1787,203.8,3941
2974,2003,2,CTF (CORRECTIONAL TRAINING FAC),7048,0,7048,3281,214.8,7001
2975,2003,2,CVSP (CHUCKAWALLA VALLEY SP),3489,0,3489,1738,200.7,3664
2976,2003,2,SATF (CA SUBSTANCE ABUSE TREAT FAC),6709,5,6714,3324,202.0,6655
2977,2003,2,"SOL (CA SP, SOLANO)",5751,0,5751,2610,220.3,5852
2978,2003,2,SQ (SAN QUENTIN SP),5790,7,5797,3273,177.1,5533
2979,2003,2,"SAC (CA SP, SACRAMENTO)",2926,0,2926,1728,169.3,3192
2980,2003,2,"LAC (CA SP, LOS ANGELES COUNTY)",4196,0,4196,2200,190.7,4480
2981,2003,2,"COR (CA SP, CORCORAN)",4681,0,4681,3016,155.2,4904
2982,2003,2,CEN (CENTINELA SP),4458,0,4458,2208,201.9,4668
2983,2003,2,CAL (CALIPATRIA SP),4136,0,4136,2208,187.3,4068
2984,2003,2,"CRC (CAL REHAB CTR, MEN)",2834,1096,3930,1814,216.6,3952
2985,2003,2,CMC (CA MEN'S COLONY),6437,0,6437,3884,165.7,6604
2986,2003,2,CMF (CA MEDICAL FAC),3264,0,3264,2315,141.0,3401
2987,2003,2,CIM (CA INSTITUTION FOR MEN),6532,39,6571,3078,213.5,6265
2988,2003,2,CCI (CA CORRECTIONAL INSTITUTION),5263,0,5263,2781,189.2,5600
2989,2003,2,CCC (CA CORRECTIONAL CENTER),5548,0,5548,3682,150.7,5642
2990,2003,2,ASP (AVENAL SP),6908,0,6908,2920,236.6,6778
2991,2003,3,VSP (VALLEY SP),3391,8,3399,1980,171.7,3660
2992,2003,3,SCC (SIERRA CONSERVATION CENTER),277,0,277,320,86.6,320
2993,2003,3,CCWF (CENTRAL CA WOMEN'S FAC),3528,5,3533,2004,176.3,3233
2994,2003,3,"CRC (CAL REHAB CTR, WOMEN)",279,263,542,500,108.4,680
2995,2003,3,CIW (CA INSTITUTION FOR WOMEN),1618,6,1624,1026,158.3,1564
2996,2003,3,WSP (WASCO SP),6078,19,6097,2984,204.3,5797
2997,2003,3,SCC (SIERRA CONSERVATION CENTER),6056,0,6056,3606,167.9,5869
2998,2003,3,SVSP (SALINAS VALLEY SP),4178,0,4178,2224,187.9,4552
2999,2003,3,RJD (RJ DONOVAN CORRECTIONAL FAC),4203,0,4203,2200,191.0,4443
3000,2003,3,PVSP (PLEASANT VALLEY SP),4549,0,4549,2208,206.0,4763
3001,2003,3,PBSP (PELICAN BAY SP),3298,0,3298,2280,144.6,3604
3002,2003,3,NKSP (NORTH KERN SP),5101,3,5104,2692,189.6,5089
3003,2003,3,MCSP (MULE CREEK SP),3587,0,3587,1700,211.0,3671
3004,2003,3,ISP (IRONWOOD SP),4514,0,4514,2200,205.2,4325
3005,2003,3,HDSP (HIGH DESERT SP),4336,3,4339,2344,185.1,4140
3006,2003,3,FOL (FOLSOM SP) (MALE),3798,0,3798,2072,183.3,3725
3007,2003,3,DVI (DEUEL VOCATIONAL INSTITUTION),3967,14,3981,1787,222.8,3941
3008,2003,3,CTF (CORRECTIONAL TRAINING FAC),7090,0,7090,3281,216.1,7001
3009,2003,3,CVSP (CHUCKAWALLA VALLEY SP),3584,0,3584,1738,206.2,3664
3010,2003,3,SATF (CA SUBSTANCE ABUSE TREAT FAC),6613,6,6619,3324,199.1,6655
3011,2003,3,"SOL (CA SP, SOLANO)",5750,0,5750,2610,220.3,5852
3012,2003,3,SQ (SAN QUENTIN SP),5750,14,5764,3273,176.1,5533
3013,2003,3,"SAC (CA SP, SACRAMENTO)",2993,0,2993,1728,173.2,3192
3014,2003,3,"LAC (CA SP, LOS ANGELES COUNTY)",4234,0,4234,2200,192.5,4480
3015,2003,3,"COR (CA SP, CORCORAN)",4584,0,4584,3016,152.0,4904
3016,2003,3,CEN (CENTINELA SP),4527,0,4527,2208,205.0,4668
3017,2003,3,CAL (CALIPATRIA SP),4202,0,4202,2208,190.3,4068
3018,2003,3,"CRC (CAL REHAB CTR, MEN)",2870,1089,3959,1814,218.2,3952
3019,2003,3,CMC (CA MEN'S COLONY),6362,0,6362,3884,163.8,6604
3020,2003,3,CMF (CA MEDICAL FAC),3254,0,3254,2315,140.6,3401
3021,2003,3,CIM (CA INSTITUTION FOR MEN),6312,35,6347,3078,206.2,6265
3022,2003,3,CCI (CA CORRECTIONAL INSTITUTION),5168,0,5168,2781,185.8,5600
3023,2003,3,CCC (CA CORRECTIONAL CENTER),5632,0,5632,3682,153.0,5642
3024,2003,3,ASP (AVENAL SP),6748,0,6748,2920,231.1,6778
3025,2003,4,VSP (VALLEY SP),3704,8,3712,1980,187.5,3660
3026,2003,4,SCC (SIERRA CONSERVATION CENTER),277,0,277,320,86.6,320
3027,2003,4,CCWF (CENTRAL CA WOMEN'S FAC),3388,6,3394,2004,169.4,3233
3028,2003,4,"CRC (CAL REHAB CTR, WOMEN)",273,264,537,500,107.4,680
3029,2003,4,CIW (CA INSTITUTION FOR WOMEN),1663,3,1666,1026,162.4,1564
3030,2003,4,WSP (WASCO SP),5834,31,5865,2984,196.5,5797
3031,2003,4,SCC (SIERRA CONSERVATION CENTER),5945,0,5945,3606,164.9,5869
3032,2003,4,SVSP (SALINAS VALLEY SP),4047,0,4047,2224,182.0,4552
3033,2003,4,RJD (RJ DONOVAN CORRECTIONAL FAC),4242,0,4242,2200,192.8,4443
3034,2003,4,PVSP (PLEASANT VALLEY SP),4627,0,4627,2208,209.6,4763
3035,2003,4,PBSP (PELICAN BAY SP),3193,0,3193,2280,140.0,3467
3036,2003,4,NKSP (NORTH KERN SP),5041,3,5044,2692,187.4,5089
3037,2003,4,MCSP (MULE CREEK SP),3664,0,3664,1700,215.5,3671
3038,2003,4,ISP (IRONWOOD SP),4590,0,4590,2200,208.6,4445
3039,2003,4,HDSP (HIGH DESERT SP),4254,4,4258,2344,181.7,4140
3040,2003,4,FOL (FOLSOM SP) (MALE),3766,0,3766,2072,181.8,3725
3041,2003,4,DVI (DEUEL VOCATIONAL INSTITUTION),4023,28,4051,1787,226.7,3941
3042,2003,4,CTF (CORRECTIONAL TRAINING FAC),7121,8,7129,3281,217.3,7001
3043,2003,4,CVSP (CHUCKAWALLA VALLEY SP),3590,0,3590,1738,206.6,3639
3044,2003,4,SATF (CA SUBSTANCE ABUSE TREAT FAC),6541,6,6547,3324,197.0,6655
3045,2003,4,"SOL (CA SP, SOLANO)",5778,0,5778,2610,221.4,5852
3046,2003,4,SQ (SAN QUENTIN SP),5661,6,5667,3273,173.1,5533
3047,2003,4,"SAC (CA SP, SACRAMENTO)",2987,0,2987,1728,172.9,3102
3048,2003,4,"LAC (CA SP, LOS ANGELES COUNTY)",4373,0,4373,2200,198.8,4455
3049,2003,4,"COR (CA SP, CORCORAN)",4802,0,4802,3016,159.2,4904
3050,2003,4,CEN (CENTINELA SP),4495,0,4495,2208,203.6,4523
3051,2003,4,CAL (CALIPATRIA SP),4122,0,4122,2208,186.7,4043
3052,2003,4,"CRC (CAL REHAB CTR, MEN)",2877,1082,3959,1814,218.2,3952
3053,2003,4,CMC (CA MEN'S COLONY),6425,0,6425,3884,165.4,6604
3054,2003,4,CMF (CA MEDICAL FAC),3253,0,3253,2315,140.5,3401
3055,2003,4,CIM (CA INSTITUTION FOR MEN),6256,37,6293,3078,204.5,6265
3056,2003,4,CCI (CA CORRECTIONAL INSTITUTION),5211,0,5211,2781,187.4,5600
3057,2003,4,CCC (CA CORRECTIONAL CENTER),5914,0,5914,3682,160.6,5642
3058,2003,4,ASP (AVENAL SP),6634,0,6634,2920,227.2,6678
3059,2003,5,VSP (VALLEY SP),3742,6,3748,1980,189.3,3660
3060,2003,5,SCC (SIERRA CONSERVATION CENTER),289,0,289,320,90.3,320
3061,2003,5,CCWF (CENTRAL CA WOMEN'S FAC),3235,6,3241,2004,161.7,3233
3062,2003,5,"CRC (CAL REHAB CTR, WOMEN)",378,262,640,500,128.0,680
3063,2003,5,CIW (CA INSTITUTION FOR WOMEN),1683,7,1690,1026,164.7,1564
3064,2003,5,WSP (WASCO SP),6016,17,6033,2984,202.2,5797
3065,2003,5,SCC (SIERRA CONSERVATION CENTER),6050,0,6050,3606,167.8,5869
3066,2003,5,SVSP (SALINAS VALLEY SP),3978,0,3978,2224,178.9,4552
3067,2003,5,RJD (RJ DONOVAN CORRECTIONAL FAC),4223,1,4224,2200,192.0,4443
3068,2003,5,PVSP (PLEASANT VALLEY SP),4681,0,4681,2208,212.0,4573
3069,2003,5,PBSP (PELICAN BAY SP),3181,0,3181,2280,139.5,3442
3070,2003,5,NKSP (NORTH KERN SP),4984,2,4986,2692,185.2,5089
3071,2003,5,MCSP (MULE CREEK SP),3640,0,3640,1700,214.1,3671
3072,2003,5,ISP (IRONWOOD SP),4675,0,4675,2200,212.5,4445
3073,2003,5,HDSP (HIGH DESERT SP),4228,1,4229,2344,180.4,4140
3074,2003,5,FOL (FOLSOM SP) (MALE),3779,0,3779,2072,182.4,3725
3075,2003,5,DVI (DEUEL VOCATIONAL INSTITUTION),3850,22,3872,1787,216.7,3941
3076,2003,5,CTF (CORRECTIONAL TRAINING FAC),7110,0,7110,3281,216.7,7001
3077,2003,5,CVSP (CHUCKAWALLA VALLEY SP),3601,0,3601,1738,207.2,3639
3078,2003,5,SATF (CA SUBSTANCE ABUSE TREAT FAC),6361,6,6367,3324,191.5,6535
3079,2003,5,"SOL (CA SP, SOLANO)",5752,0,5752,2610,220.4,5852
3080,2003,5,SQ (SAN QUENTIN SP),5714,11,5725,3273,174.9,5533
3081,2003,5,"SAC (CA SP, SACRAMENTO)",3033,0,3033,1728,175.5,2962
3082,2003,5,"LAC (CA SP, LOS ANGELES COUNTY)",4404,0,4404,2200,200.2,4455
3083,2003,5,"COR (CA SP, CORCORAN)",4968,0,4968,3016,164.7,4904
3084,2003,5,CEN (CENTINELA SP),4551,0,4551,2208,206.1,4643
3085,2003,5,CAL (CALIPATRIA SP),4131,0,4131,2208,187.1,4043
3086,2003,5,"CRC (CAL REHAB CTR, MEN)",2943,1079,4022,1814,221.7,3952
3087,2003,5,CMC (CA MEN'S COLONY),6443,1,6444,3884,165.9,6604
3088,2003,5,CMF (CA MEDICAL FAC),3290,0,3290,2315,142.1,3401
3089,2003,5,CIM (CA INSTITUTION FOR MEN),6427,37,6464,3078,210.0,6265
3090,2003,5,CCI (CA CORRECTIONAL INSTITUTION),5372,0,5372,2781,193.2,5600
3091,2003,5,CCC (CA CORRECTIONAL CENTER),5861,0,5861,3682,159.2,5642
3092,2003,5,ASP (AVENAL SP),6891,0,6891,2920,236.0,6578
3093,2003,6,VSP (VALLEY SP),3527,13,3540,1980,178.8,3737
3094,2003,6,SCC (SIERRA CONSERVATION CENTER),262,0,262,320,81.9,320
3095,2003,6,CCWF (CENTRAL CA WOMEN'S FAC),3365,5,3370,2004,168.2,3233
3096,2003,6,"CRC (CAL REHAB CTR, WOMEN)",451,245,696,500,139.2,680
3097,2003,6,CIW (CA INSTITUTION FOR WOMEN),1739,6,1745,1026,170.1,1564
3098,2003,6,WSP (WASCO SP),6088,12,6100,2984,204.4,5958
3099,2003,6,SCC (SIERRA CONSERVATION CENTER),6072,0,6072,3606,168.4,5977
3100,2003,6,SVSP (SALINAS VALLEY SP),4176,0,4176,2224,187.8,4720
3101,2003,6,RJD (RJ DONOVAN CORRECTIONAL FAC),4364,0,4364,2200,198.4,4443
3102,2003,6,PVSP (PLEASANT VALLEY SP),4891,0,4891,2208,221.5,4863
3103,2003,6,PBSP (PELICAN BAY SP),3207,0,3207,2280,140.7,3492
3104,2003,6,NKSP (NORTH KERN SP),5008,2,5010,2692,186.1,5139
3105,2003,6,MCSP (MULE CREEK SP),3612,0,3612,1700,212.5,3671
3106,2003,6,ISP (IRONWOOD SP),4651,0,4651,2200,211.4,4565
3107,2003,6,HDSP (HIGH DESERT SP),4202,1,4203,2344,179.3,4190
3108,2003,6,FOL (FOLSOM SP) (MALE),3739,0,3739,2072,180.5,3725
3109,2003,6,DVI (DEUEL VOCATIONAL INSTITUTION),3813,27,3840,1787,214.9,3941
3110,2003,6,CTF (CORRECTIONAL TRAINING FAC),7080,0,7080,3281,215.8,7001
3111,2003,6,CVSP (CHUCKAWALLA VALLEY SP),3712,0,3712,1738,213.6,3664
3112,2003,6,SATF (CA SUBSTANCE ABUSE TREAT FAC),6386,4,6390,3324,192.2,6535
3113,2003,6,"SOL (CA SP, SOLANO)",5727,0,5727,2610,219.4,5852
3114,2003,6,SQ (SAN QUENTIN SP),5745,5,5750,3273,175.7,5533
3115,2003,6,"SAC (CA SP, SACRAMENTO)",3024,0,3024,1728,175.0,3058
3116,2003,6,"LAC (CA SP, LOS ANGELES COUNTY)",4281,0,4281,2200,194.6,4455
3117,2003,6,"COR (CA SP, CORCORAN)",5069,0,5069,3016,168.1,5284
3118,2003,6,CEN (CENTINELA SP),4543,0,4543,2208,205.8,4693
3119,2003,6,CAL (CALIPATRIA SP),4152,0,4152,2208,188.0,4118
3120,2003,6,"CRC (CAL REHAB CTR, MEN)",2974,1017,3991,1814,220.0,3952
3121,2003,6,CMC (CA MEN'S COLONY),6492,0,6492,3884,167.1,6604
3122,2003,6,CMF (CA MEDICAL FAC),3315,0,3315,2315,143.2,3401
3123,2003,6,CIM (CA INSTITUTION FOR MEN),6399,35,6434,3078,209.0,6365
3124,2003,6,CCI (CA CORRECTIONAL INSTITUTION),5308,0,5308,2781,190.9,5600
3125,2003,6,CCC (CA CORRECTIONAL CENTER),5908,0,5908,3682,160.5,5642
3126,2003,6,ASP (AVENAL SP),6929,0,6929,2920,237.3,6778
3127,2003,7,VSP (VALLEY SP),3536,12,3548,1980,179.2,3737
3128,2003,7,SCC (SIERRA CONSERVATION CENTER),250,0,250,320,78.1,320
3129,2003,7,CCWF (CENTRAL CA WOMEN'S FAC),3484,3,3487,2004,174.0,3233
3130,2003,7,"CRC (CAL REHAB CTR, WOMEN)",473,259,732,500,146.4,680
3131,2003,7,CIW (CA INSTITUTION FOR WOMEN),1792,10,1802,1026,175.6,1564
3132,2003,7,WSP (WASCO SP),6008,22,6030,2984,202.1,5958
3133,2003,7,SCC (SIERRA CONSERVATION CENTER),6041,1,6042,3606,167.6,5977
3134,2003,7,SVSP (SALINAS VALLEY SP),4367,0,4367,2224,196.4,4720
3135,2003,7,RJD (RJ DONOVAN CORRECTIONAL FAC),4271,0,4271,2200,194.1,4443
3136,2003,7,PVSP (PLEASANT VALLEY SP),4791,0,4791,2208,217.0,5053
3137,2003,7,PBSP (PELICAN BAY SP),3164,0,3164,2280,138.8,3492
3138,2003,7,NKSP (NORTH KERN SP),4952,5,4957,2692,184.1,5139
3139,2003,7,MCSP (MULE CREEK SP),3580,0,3580,1700,210.6,3671
3140,2003,7,ISP (IRONWOOD SP),4652,0,4652,2200,211.5,4565
3141,2003,7,HDSP (HIGH DESERT SP),4322,1,4323,2344,184.4,4190
3142,2003,7,FOL (FOLSOM SP) (MALE),3753,0,3753,2072,181.1,3846
3143,2003,7,DVI (DEUEL VOCATIONAL INSTITUTION),3919,15,3934,1787,220.1,3941
3144,2003,7,CTF (CORRECTIONAL TRAINING FAC),7150,0,7150,3281,217.9,7001
3145,2003,7,CVSP (CHUCKAWALLA VALLEY SP),3778,0,3778,1738,217.4,3764
3146,2003,7,SATF (CA SUBSTANCE ABUSE TREAT FAC),6545,4,6549,3324,197.0,6535
3147,2003,7,"SOL (CA SP, SOLANO)",5817,0,5817,2610,222.9,5852
3148,2003,7,SQ (SAN QUENTIN SP),5333,12,5345,3273,163.3,5533
3149,2003,7,"SAC (CA SP, SACRAMENTO)",3002,0,3002,1728,173.7,3058
3150,2003,7,"LAC (CA SP, LOS ANGELES COUNTY)",4244,0,4244,2200,192.9,4455
3151,2003,7,"COR (CA SP, CORCORAN)",5062,0,5062,3016,167.8,5184
3152,2003,7,CEN (CENTINELA SP),4581,0,4581,2208,207.5,4883
3153,2003,7,CAL (CALIPATRIA SP),4162,0,4162,2208,188.5,4308
3154,2003,7,"CRC (CAL REHAB CTR, MEN)",2935,1024,3959,1814,218.2,3952
3155,2003,7,CMC (CA MEN'S COLONY),6500,0,6500,3884,167.4,6604
3156,2003,7,CMF (CA MEDICAL FAC),3292,0,3292,2315,142.2,3401
3157,2003,7,CIM (CA INSTITUTION FOR MEN),6483,33,6516,3078,211.7,6465
3158,2003,7,CCI (CA CORRECTIONAL INSTITUTION),5398,0,5398,2781,194.1,5600
3159,2003,7,CCC (CA CORRECTIONAL CENTER),5992,0,5992,3682,162.7,5642
3160,2003,7,ASP (AVENAL SP),6880,0,6880,2920,235.6,6828
3161,2003,8,VSP (VALLEY SP),3555,7,3562,1980,179.9,3737
3162,2003,8,SCC (SIERRA CONSERVATION CENTER),272,0,272,320,85.0,320
3163,2003,8,CCWF (CENTRAL CA WOMEN'S FAC),3409,5,3414,2004,170.4,3233
3164,2003,8,"CRC (CAL REHAB CTR, WOMEN)",454,262,716,500,143.2,680
3165,2003,8,CIW (CA INSTITUTION FOR WOMEN),1790,12,1802,1026,175.6,1564
3166,2003,8,WSP (WASCO SP),6048,17,6065,2984,203.3,5958
3167,2003,8,SCC (SIERRA CONSERVATION CENTER),6021,0,6021,3606,167.0,5977
3168,2003,8,SVSP (SALINAS VALLEY SP),4339,0,4339,2224,195.1,4720
3169,2003,8,RJD (RJ DONOVAN CORRECTIONAL FAC),4167,0,4167,2200,189.4,4443
3170,2003,8,PVSP (PLEASANT VALLEY SP),4937,0,4937,2208,223.6,4863
3171,2003,8,PBSP (PELICAN BAY SP),3205,0,3205,2280,140.6,3492
3172,2003,8,NKSP (NORTH KERN SP),5023,7,5030,2692,186.8,5139
3173,2003,8,MCSP (MULE CREEK SP),3619,0,3619,1700,212.9,3671
3174,2003,8,ISP (IRONWOOD SP),4608,0,4608,2200,209.5,4565
3175,2003,8,HDSP (HIGH DESERT SP),4262,2,4264,2344,181.9,4190
3176,2003,8,FOL (FOLSOM SP) (MALE),3789,0,3789,2072,182.9,3846
3177,2003,8,DVI (DEUEL VOCATIONAL INSTITUTION),3850,23,3873,1787,216.7,3941
3178,2003,8,CTF (CORRECTIONAL TRAINING FAC),7110,0,7110,3281,216.7,7001
3179,2003,8,CVSP (CHUCKAWALLA VALLEY SP),3753,0,3753,1738,215.9,3764
3180,2003,8,SATF (CA SUBSTANCE ABUSE TREAT FAC),6610,4,6614,3324,199.0,6535
3181,2003,8,"SOL (CA SP, SOLANO)",5707,0,5707,2610,218.7,5852
3182,2003,8,SQ (SAN QUENTIN SP),5365,14,5379,3273,164.3,5533
3183,2003,8,"SAC (CA SP, SACRAMENTO)",2994,0,2994,1728,173.3,3058
3184,2003,8,"LAC (CA SP, LOS ANGELES COUNTY)",4333,0,4333,2200,197.0,4455
3185,2003,8,"COR (CA SP, CORCORAN)",5098,0,5098,3016,169.0,5184
3186,2003,8,CEN (CENTINELA SP),4751,0,4751,2208,215.2,4883
3187,2003,8,CAL (CALIPATRIA SP),4130,0,4130,2208,187.0,4308
3188,2003,8,"CRC (CAL REHAB CTR, MEN)",2922,1034,3956,1814,218.1,3952
3189,2003,8,CMC (CA MEN'S COLONY),6512,0,6512,3884,167.7,6604
3190,2003,8,CMF (CA MEDICAL FAC),3254,0,3254,2315,140.6,3401
3191,2003,8,CIM (CA INSTITUTION FOR MEN),6434,30,6464,3078,210.0,6465
3192,2003,8,CCI (CA CORRECTIONAL INSTITUTION),5383,0,5383,2781,193.6,5600
3193,2003,8,CCC (CA CORRECTIONAL CENTER),5912,1,5913,3682,160.6,5642
3194,2003,8,ASP (AVENAL SP),6956,0,6956,2920,238.2,6828
3195,2003,9,VSP (VALLEY SP),3767,10,3777,1980,190.8,3737
3196,2003,9,SCC (SIERRA CONSERVATION CENTER),287,0,287,320,89.7,320
3197,2003,9,CCWF (CENTRAL CA WOMEN'S FAC),3365,4,3369,2004,168.1,3233
3198,2003,9,"CRC (CAL REHAB CTR, WOMEN)",418,272,690,500,138.0,680
3199,2003,9,CIW (CA INSTITUTION FOR WOMEN),1773,11,1784,1026,173.9,1564
3200,2003,9,WSP (WASCO SP),5965,24,5989,2984,200.7,5958
3201,2003,9,SCC (SIERRA CONSERVATION CENTER),6045,0,6045,3606,167.6,5977
3202,2003,9,SVSP (SALINAS VALLEY SP),4263,0,4263,2224,191.7,4720
3203,2003,9,RJD (RJ DONOVAN CORRECTIONAL FAC),4285,0,4285,2200,194.8,4443
3204,2003,9,PVSP (PLEASANT VALLEY SP),4899,0,4899,2208,221.9,4863
3205,2003,9,PBSP (PELICAN BAY SP),3241,0,3241,2280,142.1,3492
3206,2003,9,NKSP (NORTH KERN SP),4993,5,4998,2692,185.7,5139
3207,2003,9,MCSP (MULE CREEK SP),3658,0,3658,1700,215.2,3671
3208,2003,9,ISP (IRONWOOD SP),4552,0,4552,2200,206.9,4565
3209,2003,9,HDSP (HIGH DESERT SP),4314,2,4316,2344,184.1,4190
3210,2003,9,FOL (FOLSOM SP) (MALE),3821,0,3821,2072,184.4,3846
3211,2003,9,DVI (DEUEL VOCATIONAL INSTITUTION),3387,14,3401,1787,190.3,3941
3212,2003,9,CTF (CORRECTIONAL TRAINING FAC),7115,0,7115,3281,216.9,7001
3213,2003,9,CVSP (CHUCKAWALLA VALLEY SP),3737,0,3737,1738,215.0,3764
3214,2003,9,SATF (CA SUBSTANCE ABUSE TREAT FAC),6802,4,6806,3324,204.8,6535
3215,2003,9,"SOL (CA SP, SOLANO)",5788,0,5788,2610,221.8,5852
3216,2003,9,SQ (SAN QUENTIN SP),5507,6,5513,3273,168.4,5533
3217,2003,9,"SAC (CA SP, SACRAMENTO)",3053,0,3053,1728,176.7,3058
3218,2003,9,"LAC (CA SP, LOS ANGELES COUNTY)",4316,0,4316,2200,196.2,4455
3219,2003,9,"COR (CA SP, CORCORAN)",5176,0,5176,3016,171.6,5184
3220,2003,9,CEN (CENTINELA SP),4635,0,4635,2208,209.9,4883
3221,2003,9,CAL (CALIPATRIA SP),4161,0,4161,2208,188.5,4308
3222,2003,9,"CRC (CAL REHAB CTR, MEN)",2940,1033,3973,1814,219.0,3952
3223,2003,9,CMC (CA MEN'S COLONY),6452,0,6452,3884,166.1,6604
3224,2003,9,CMF (CA MEDICAL FAC),3248,0,3248,2315,140.3,3401
3225,2003,9,CIM (CA INSTITUTION FOR MEN),6303,30,6333,3078,205.8,6465
3226,2003,9,CCI (CA CORRECTIONAL INSTITUTION),5357,0,5357,2781,192.6,5600
3227,2003,9,CCC (CA CORRECTIONAL CENTER),5953,0,5953,3682,161.7,5642
3228,2003,9,ASP (AVENAL SP),7027,0,7027,2920,240.7,6828
3229,2003,10,VSP (VALLEY SP),3651,9,3660,1980,184.8,3737
3230,2003,10,SCC (SIERRA CONSERVATION CENTER),304,0,304,320,95.0,320
3231,2003,10,CCWF (CENTRAL CA WOMEN'S FAC),3588,5,3593,2004,179.3,3233
3232,2003,10,"CRC (CAL REHAB CTR, WOMEN)",374,274,648,500,129.6,680
3233,2003,10,CIW (CA INSTITUTION FOR WOMEN),1723,9,1732,1026,168.8,1564
3234,2003,10,WSP (WASCO SP),6105,45,6150,2984,206.1,5958
3235,2003,10,SCC (SIERRA CONSERVATION CENTER),6024,0,6024,3606,167.1,5977
3236,2003,10,SVSP (SALINAS VALLEY SP),4322,0,4322,2224,194.3,4720
3237,2003,10,RJD (RJ DONOVAN CORRECTIONAL FAC),4372,0,4372,2200,198.7,4443
3238,2003,10,PVSP (PLEASANT VALLEY SP),4888,0,4888,2208,221.4,4848
3239,2003,10,PBSP (PELICAN BAY SP),3224,0,3224,2280,141.4,3492
3240,2003,10,NKSP (NORTH KERN SP),5031,7,5038,2692,187.1,5139
3241,2003,10,MCSP (MULE CREEK SP),3632,0,3632,1700,213.6,3671
3242,2003,10,ISP (IRONWOOD SP),4638,0,4638,2200,210.8,4565
3243,2003,10,HDSP (HIGH DESERT SP),4514,0,4514,2344,192.6,4290
3244,2003,10,FOL (FOLSOM SP) (MALE),3753,0,3753,2072,181.1,3846
3245,2003,10,DVI (DEUEL VOCATIONAL INSTITUTION),3495,18,3513,1787,196.6,3941
3246,2003,10,CTF (CORRECTIONAL TRAINING FAC),7103,0,7103,3281,216.5,7001
3247,2003,10,CVSP (CHUCKAWALLA VALLEY SP),3786,0,3786,1738,217.8,3764
3248,2003,10,SATF (CA SUBSTANCE ABUSE TREAT FAC),6731,5,6736,3324,202.6,6655
3249,2003,10,"SOL (CA SP, SOLANO)",5773,0,5773,2610,221.2,5852
3250,2003,10,SQ (SAN QUENTIN SP),5560,3,5563,3273,170.0,5533
3251,2003,10,"SAC (CA SP, SACRAMENTO)",3061,0,3061,1728,177.1,3198
3252,2003,10,"LAC (CA SP, LOS ANGELES COUNTY)",4345,0,4345,2200,197.5,4415
3253,2003,10,"COR (CA SP, CORCORAN)",5166,0,5166,3016,171.3,5184
3254,2003,10,CEN (CENTINELA SP),4759,0,4759,2208,215.5,4883
3255,2003,10,CAL (CALIPATRIA SP),4273,0,4273,2208,193.5,4268
3256,2003,10,"CRC (CAL REHAB CTR, MEN)",2911,1042,3953,1814,217.9,3952
3257,2003,10,CMC (CA MEN'S COLONY),6548,0,6548,3884,168.6,6604
3258,2003,10,CMF (CA MEDICAL FAC),3248,0,3248,2315,140.3,3401
3259,2003,10,CIM (CA INSTITUTION FOR MEN),6472,30,6502,3078,211.2,6665
3260,2003,10,CCI (CA CORRECTIONAL INSTITUTION),5446,0,5446,2781,195.8,5600
3261,2003,10,CCC (CA CORRECTIONAL CENTER),5978,0,5978,3682,162.4,5642
3262,2003,10,ASP (AVENAL SP),7063,0,7063,2920,241.9,6928
3263,2003,11,VSP (VALLEY SP),3585,5,3590,1980,181.3,3737
3264,2003,11,SCC (SIERRA CONSERVATION CENTER),328,0,328,320,102.5,320
3265,2003,11,CCWF (CENTRAL CA WOMEN'S FAC),3589,3,3592,2004,179.2,3233
3266,2003,11,"CRC (CAL REHAB CTR, WOMEN)",419,288,707,500,141.4,680
3267,2003,11,CIW (CA INSTITUTION FOR WOMEN),1667,10,1677,1026,163.5,1564
3268,2003,11,WSP (WASCO SP),5894,42,5936,2984,198.9,5958
3269,2003,11,SCC (SIERRA CONSERVATION CENTER),6019,0,6019,3606,166.9,5977
3270,2003,11,SVSP (SALINAS VALLEY SP),4371,0,4371,2224,196.5,4720
3271,2003,11,RJD (RJ DONOVAN CORRECTIONAL FAC),4339,0,4339,2200,197.2,4443
3272,2003,11,PVSP (PLEASANT VALLEY SP),4898,0,4898,2208,221.8,4848
3273,2003,11,PBSP (PELICAN BAY SP),3288,0,3288,2280,144.2,3492
3274,2003,11,NKSP (NORTH KERN SP),5001,2,5003,2692,185.8,5139
3275,2003,11,MCSP (MULE CREEK SP),3619,0,3619,1700,212.9,3671
3276,2003,11,ISP (IRONWOOD SP),4649,0,4649,2200,211.3,4565
3277,2003,11,HDSP (HIGH DESERT SP),4494,1,4495,2344,191.8,4530
3278,2003,11,FOL (FOLSOM SP) (MALE),3731,0,3731,2072,180.1,3846
3279,2003,11,DVI (DEUEL VOCATIONAL INSTITUTION),3425,12,3437,1787,192.3,3551
3280,2003,11,CTF (CORRECTIONAL TRAINING FAC),7048,0,7048,3281,214.8,7001
3281,2003,11,CVSP (CHUCKAWALLA VALLEY SP),4017,0,4017,1738,231.1,3764
3282,2003,11,SATF (CA SUBSTANCE ABUSE TREAT FAC),6902,6,6908,3324,207.8,6655
3283,2003,11,"SOL (CA SP, SOLANO)",5815,0,5815,2610,222.8,5852
3284,2003,11,SQ (SAN QUENTIN SP),5695,10,5705,3273,174.3,5683
3285,2003,11,"SAC (CA SP, SACRAMENTO)",3062,0,3062,1728,177.2,3198
3286,2003,11,"LAC (CA SP, LOS ANGELES COUNTY)",4365,0,4365,2200,198.4,4440
3287,2003,11,"COR (CA SP, CORCORAN)",5206,0,5206,3016,172.6,5184
3288,2003,11,CEN (CENTINELA SP),4716,0,4716,2208,213.6,4883
3289,2003,11,CAL (CALIPATRIA SP),4222,0,4222,2208,191.2,4318
3290,2003,11,"CRC (CAL REHAB CTR, MEN)",2869,1045,3914,1814,215.8,3952
3291,2003,11,CMC (CA MEN'S COLONY),6490,0,6490,3884,167.1,6604
3292,2003,11,CMF (CA MEDICAL FAC),3212,0,3212,2315,138.7,3401
3293,2003,11,CIM (CA INSTITUTION FOR MEN),6315,29,6344,3078,206.1,6665
3294,2003,11,CCI (CA CORRECTIONAL INSTITUTION),5404,0,5404,2781,194.3,5600
3295,2003,11,CCC (CA CORRECTIONAL CENTER),5852,0,5852,3682,158.9,5642
3296,2003,11,ASP (AVENAL SP),7129,0,7129,2920,244.1,6928
3297,2003,12,VSP (VALLEY SP),3581,14,3595,1980,181.6,3814
3298,2003,12,SCC (SIERRA CONSERVATION CENTER),331,0,331,320,103.4,320
3299,2003,12,CCWF (CENTRAL CA WOMEN'S FAC),3631,3,3634,2004,181.3,3336
3300,2003,12,"CRC (CAL REHAB CTR, WOMEN)",452,281,733,500,146.6,680
3301,2003,12,CIW (CA INSTITUTION FOR WOMEN),1691,6,1697,1026,165.4,1564
3302,2003,12,WSP (WASCO SP),5994,25,6019,2984,201.7,5958
3303,2003,12,SCC (SIERRA CONSERVATION CENTER),6038,0,6038,3606,167.4,5977
3304,2003,12,SVSP (SALINAS VALLEY SP),4467,0,4467,2224,200.9,4720
3305,2003,12,RJD (RJ DONOVAN CORRECTIONAL FAC),4345,0,4345,2200,197.5,4443
3306,2003,12,PVSP (PLEASANT VALLEY SP),4904,0,4904,2208,222.1,4848
3307,2003,12,PBSP (PELICAN BAY SP),3343,0,3343,2280,146.6,3582
3308,2003,12,NKSP (NORTH KERN SP),4842,4,4846,2692,180.0,5139
3309,2003,12,MCSP (MULE CREEK SP),3657,0,3657,1700,215.1,3697
3310,2003,12,ISP (IRONWOOD SP),4644,0,4644,2200,211.1,4565
3311,2003,12,HDSP (HIGH DESERT SP),4512,6,4518,2344,192.7,4530
3312,2003,12,FOL (FOLSOM SP) (MALE),3728,0,3728,2072,179.9,3846
3313,2003,12,DVI (DEUEL VOCATIONAL INSTITUTION),3384,19,3403,1787,190.4,3551
3314,2003,12,CTF (CORRECTIONAL TRAINING FAC),7061,0,7061,3281,215.2,7001
3315,2003,12,CVSP (CHUCKAWALLA VALLEY SP),4166,0,4166,1738,239.7,4052
3316,2003,12,SATF (CA SUBSTANCE ABUSE TREAT FAC),6963,7,6970,3324,209.7,6655
3317,2003,12,"SOL (CA SP, SOLANO)",5993,0,5993,2610,229.6,5852
3318,2003,12,SQ (SAN QUENTIN SP),5429,2,5431,3273,165.9,5683
3319,2003,12,"SAC (CA SP, SACRAMENTO)",3104,0,3104,1728,179.6,3198
3320,2003,12,"LAC (CA SP, LOS ANGELES COUNTY)",4411,0,4411,2200,200.5,4440
3321,2003,12,"COR (CA SP, CORCORAN)",5196,0,5196,3016,172.3,5184
3322,2003,12,CEN (CENTINELA SP),4772,0,4772,2208,216.1,4883
3323,2003,12,CAL (CALIPATRIA SP),4214,0,4214,2508,168.0,4318
3324,2003,12,"CRC (CAL REHAB CTR, MEN)",2860,1014,3874,1814,213.6,3952
3325,2003,12,CMC (CA MEN'S COLONY),6519,0,6519,3884,167.8,6604
3326,2003,12,CMF (CA MEDICAL FAC),3221,0,3221,2315,139.1,3401
3327,2003,12,CIM (CA INSTITUTION FOR MEN),6461,42,6503,3078,211.3,6665
3328,2003,12,CCI (CA CORRECTIONAL INSTITUTION),5473,0,5473,2781,196.8,5600
3329,2003,12,CCC (CA CORRECTIONAL CENTER),5968,0,5968,3682,162.1,5642
3330,2003,12,ASP (AVENAL SP),7256,0,7256,2920,248.5,7078
3331,2004,1,VSP (VALLEY SP),3531,9,3540,1980,178.8,3814
3332,2004,1,SCC (SIERRA CONSERVATION CENTER),336,0,336,320,105.0,320
3333,2004,1,CCWF (CENTRAL CA WOMEN'S FAC),3656,3,3659,2004,182.6,3413
3334,2004,1,"CRC (CAL REHAB CTR, WOMEN)",445,282,727,500,145.4,680
3335,2004,1,CIW (CA INSTITUTION FOR WOMEN),1609,5,1614,1026,157.3,1806
3336,2004,1,WSP (WASCO SP),6067,31,6098,2984,204.4,5958
3337,2004,1,SCC (SIERRA CONSERVATION CENTER),6029,0,6029,3606,167.2,5977
3338,2004,1,SVSP (SALINAS VALLEY SP),4447,0,4447,2224,200.0,4720
3339,2004,1,RJD (RJ DONOVAN CORRECTIONAL FAC),4410,0,4410,2200,200.5,4443
3340,2004,1,PVSP (PLEASANT VALLEY SP),4871,0,4871,2208,220.6,4848
3341,2004,1,PBSP (PELICAN BAY SP),3358,0,3358,2280,147.3,3582
3342,2004,1,NKSP (NORTH KERN SP),5113,1,5114,2692,190.0,5139
3343,2004,1,MCSP (MULE CREEK SP),3641,0,3641,1700,214.2,3697
3344,2004,1,ISP (IRONWOOD SP),4667,0,4667,2200,212.1,4665
3345,2004,1,HDSP (HIGH DESERT SP),4547,2,4549,2344,194.1,4530
3346,2004,1,FOL (FOLSOM SP) (MALE),3760,0,3760,2072,181.5,3846
3347,2004,1,DVI (DEUEL VOCATIONAL INSTITUTION),3571,9,3580,1787,200.3,3551
3348,2004,1,CTF (CORRECTIONAL TRAINING FAC),7068,0,7068,3281,215.4,7001
3349,2004,1,CVSP (CHUCKAWALLA VALLEY SP),4030,0,4030,1738,231.9,4196
3350,2004,1,SATF (CA SUBSTANCE ABUSE TREAT FAC),6861,8,6869,3324,206.6,6775
3351,2004,1,"SOL (CA SP, SOLANO)",5942,0,5942,2610,227.7,6044
3352,2004,1,SQ (SAN QUENTIN SP),5559,8,5567,3273,170.1,5683
3353,2004,1,"SAC (CA SP, SACRAMENTO)",3088,0,3088,1728,178.7,3244
3354,2004,1,"LAC (CA SP, LOS ANGELES COUNTY)",4213,0,4213,2200,191.5,4540
3355,2004,1,"COR (CA SP, CORCORAN)",5156,0,5156,3016,171.0,5184
3356,2004,1,CEN (CENTINELA SP),4899,0,4899,2208,221.9,4983
3357,2004,1,CAL (CALIPATRIA SP),4178,0,4178,2508,166.6,4318
3358,2004,1,"CRC (CAL REHAB CTR, MEN)",2873,995,3868,1814,213.2,3952
3359,2004,1,CMC (CA MEN'S COLONY),6472,0,6472,3884,166.6,6604
3360,2004,1,CMF (CA MEDICAL FAC),3214,0,3214,2315,138.8,3401
3361,2004,1,CIM (CA INSTITUTION FOR MEN),6370,40,6410,3078,208.3,6665
3362,2004,1,CCI (CA CORRECTIONAL INSTITUTION),5482,1,5483,2781,197.2,5600
3363,2004,1,CCC (CA CORRECTIONAL CENTER),5892,0,5892,3682,160.0,5642
3364,2004,1,ASP (AVENAL SP),7029,0,7029,2920,240.7,7128
3365,2004,2,VSP (VALLEY SP),3546,14,3560,1980,179.8,3814
3366,2004,2,SCC (SIERRA CONSERVATION CENTER),340,0,340,320,106.3,320
3367,2004,2,CCWF (CENTRAL CA WOMEN'S FAC),3578,6,3584,2004,178.8,3413
3368,2004,2,"CRC (CAL REHAB CTR, WOMEN)",427,282,709,500,141.8,680
3369,2004,2,CIW (CA INSTITUTION FOR WOMEN),1589,10,1599,1026,155.8,1806
3370,2004,2,WSP (WASCO SP),6086,25,6111,2984,204.8,5958
3371,2004,2,SCC (SIERRA CONSERVATION CENTER),5925,0,5925,3606,164.3,5977
3372,2004,2,SVSP (SALINAS VALLEY SP),4411,0,4411,2224,198.3,4720
3373,2004,2,RJD (RJ DONOVAN CORRECTIONAL FAC),4354,0,4354,2200,197.9,4443
3374,2004,2,PVSP (PLEASANT VALLEY SP),4880,0,4880,2208,221.0,4848
3375,2004,2,PBSP (PELICAN BAY SP),3436,0,3436,2280,150.7,3582
3376,2004,2,NKSP (NORTH KERN SP),5052,5,5057,2692,187.9,5139
3377,2004,2,MCSP (MULE CREEK SP),3608,0,3608,1700,212.2,3697
3378,2004,2,ISP (IRONWOOD SP),4706,0,4706,2200,213.9,4665
3379,2004,2,HDSP (HIGH DESERT SP),4511,6,4517,2344,192.7,4530
3380,2004,2,FOL (FOLSOM SP) (MALE),3832,0,3832,2072,184.9,3846
3381,2004,2,DVI (DEUEL VOCATIONAL INSTITUTION),3515,21,3536,1787,197.9,3551
3382,2004,2,CTF (CORRECTIONAL TRAINING FAC),7048,0,7048,3281,214.8,7001
3383,2004,2,CVSP (CHUCKAWALLA VALLEY SP),3891,0,3891,1738,223.9,4052
3384,2004,2,SATF (CA SUBSTANCE ABUSE TREAT FAC),6923,7,6930,3324,208.5,6775
3385,2004,2,"SOL (CA SP, SOLANO)",5869,0,5869,2610,224.9,5852
3386,2004,2,SQ (SAN QUENTIN SP),5581,10,5591,3273,170.8,5683
3387,2004,2,"SAC (CA SP, SACRAMENTO)",3124,0,3124,1728,180.8,3244
3388,2004,2,"LAC (CA SP, LOS ANGELES COUNTY)",4130,0,4130,2200,187.7,4540
3389,2004,2,"COR (CA SP, CORCORAN)",5146,0,5146,3016,170.6,5184
3390,2004,2,CEN (CENTINELA SP),4827,0,4827,2208,218.6,4983
3391,2004,2,CAL (CALIPATRIA SP),4216,0,4216,2508,168.1,4318
3392,2004,2,"CRC (CAL REHAB CTR, MEN)",2958,995,3953,1814,217.9,3952
3393,2004,2,CMC (CA MEN'S COLONY),6507,0,6507,3884,167.5,6604
3394,2004,2,CMF (CA MEDICAL FAC),3251,0,3251,2315,140.4,3401
3395,2004,2,CIM (CA INSTITUTION FOR MEN),6438,36,6474,3078,210.3,6665
3396,2004,2,CCI (CA CORRECTIONAL INSTITUTION),5438,0,5438,2781,195.5,5600
3397,2004,2,CCC (CA CORRECTIONAL CENTER),5915,0,5915,3682,160.6,5642
3398,2004,2,ASP (AVENAL SP),7044,0,7044,2920,241.2,6978
3399,2004,3,VSP (VALLEY SP),3606,7,3613,1980,182.5,3814
3400,2004,3,SCC (SIERRA CONSERVATION CENTER),334,0,334,320,104.4,320
3401,2004,3,CCWF (CENTRAL CA WOMEN'S FAC),3528,3,3531,2004,176.2,3413
3402,2004,3,"CRC (CAL REHAB CTR, WOMEN)",392,294,686,500,137.2,680
3403,2004,3,CIW (CA INSTITUTION FOR WOMEN),1664,11,1675,1026,163.3,1806
3404,2004,3,WSP (WASCO SP),5910,25,5935,2984,198.9,5958
3405,2004,3,SCC (SIERRA CONSERVATION CENTER),6026,0,6026,3606,167.1,5977
3406,2004,3,SVSP (SALINAS VALLEY SP),4461,0,4461,2224,200.6,4720
3407,2004,3,RJD (RJ DONOVAN CORRECTIONAL FAC),4272,1,4273,2200,194.2,4443
3408,2004,3,PVSP (PLEASANT VALLEY SP),4914,0,4914,2208,222.6,4848
3409,2004,3,PBSP (PELICAN BAY SP),3460,0,3460,2280,151.8,3582
3410,2004,3,NKSP (NORTH KERN SP),4985,4,4989,2692,185.3,5139
3411,2004,3,MCSP (MULE CREEK SP),3598,0,3598,1700,211.6,3697
3412,2004,3,ISP (IRONWOOD SP),4695,0,4695,2200,213.4,4665
3413,2004,3,HDSP (HIGH DESERT SP),4596,2,4598,2344,196.2,4530
3414,2004,3,FOL (FOLSOM SP) (MALE),3947,0,3947,2475,159.5,4249
3415,2004,3,DVI (DEUEL VOCATIONAL INSTITUTION),3431,21,3452,1787,193.2,3551
3416,2004,3,CTF (CORRECTIONAL TRAINING FAC),7051,0,7051,3281,214.9,7001
3417,2004,3,CVSP (CHUCKAWALLA VALLEY SP),3839,0,3839,1738,220.9,4052
3418,2004,3,SATF (CA SUBSTANCE ABUSE TREAT FAC),6837,5,6842,3324,205.8,6775
3419,2004,3,"SOL (CA SP, SOLANO)",5920,0,5920,2610,226.8,5852
3420,2004,3,SQ (SAN QUENTIN SP),5697,7,5704,3273,174.3,5683
3421,2004,3,"SAC (CA SP, SACRAMENTO)",3199,0,3199,1728,185.1,3244
3422,2004,3,"LAC (CA SP, LOS ANGELES COUNTY)",4509,0,4509,2200,205.0,4540
3423,2004,3,"COR (CA SP, CORCORAN)",5157,0,5157,3016,171.0,5184
3424,2004,3,CEN (CENTINELA SP),4778,0,4778,2208,216.4,4983
3425,2004,3,CAL (CALIPATRIA SP),4195,0,4195,2508,167.3,4318
3426,2004,3,"CRC (CAL REHAB CTR, MEN)",2902,1065,3967,1814,218.7,3952
3427,2004,3,CMC (CA MEN'S COLONY),6541,0,6541,3884,168.4,6604
3428,2004,3,CMF (CA MEDICAL FAC),3244,0,3244,2315,140.1,3401
3429,2004,3,CIM (CA INSTITUTION FOR MEN),6554,25,6579,3078,213.7,6665
3430,2004,3,CCI (CA CORRECTIONAL INSTITUTION),5451,0,5451,2781,196.0,5600
3431,2004,3,CCC (CA CORRECTIONAL CENTER),5984,0,5984,3682,162.5,5642
3432,2004,3,ASP (AVENAL SP),6967,0,6967,2920,238.6,6978
3433,2004,4,VSP (VALLEY SP),3628,7,3635,1980,183.6,3814
3434,2004,4,SCC (SIERRA CONSERVATION CENTER),332,0,332,320,103.8,320
3435,2004,4,CCWF (CENTRAL CA WOMEN'S FAC),3461,2,3463,2004,172.8,3413
3436,2004,4,"CRC (CAL REHAB CTR, WOMEN)",368,287,655,500,131.0,680
3437,2004,4,CIW (CA INSTITUTION FOR WOMEN),1849,11,1860,1026,181.3,1806
3438,2004,4,WSP (WASCO SP),6209,19,6228,2984,208.7,5958
3439,2004,4,SCC (SIERRA CONSERVATION CENTER),6031,0,6031,3606,167.2,5977
3440,2004,4,SVSP (SALINAS VALLEY SP),4427,0,4427,2224,199.1,4720
3441,2004,4,RJD (RJ DONOVAN CORRECTIONAL FAC),4326,0,4326,2200,196.6,4443
3442,2004,4,PVSP (PLEASANT VALLEY SP),4657,0,4657,2208,210.9,4848
3443,2004,4,PBSP (PELICAN BAY SP),3427,0,3427,2280,150.3,3582
3444,2004,4,NKSP (NORTH KERN SP),5065,5,5070,2692,188.3,5139
3445,2004,4,MCSP (MULE CREEK SP),3618,0,3618,1700,212.8,3697
3446,2004,4,ISP (IRONWOOD SP),4686,0,4686,2200,213.0,4665
3447,2004,4,HDSP (HIGH DESERT SP),4598,3,4601,2344,196.3,4530
3448,2004,4,FOL (FOLSOM SP) (MALE),3868,0,3868,2475,156.3,4249
3449,2004,4,DVI (DEUEL VOCATIONAL INSTITUTION),3495,28,3523,1787,197.1,3551
3450,2004,4,CTF (CORRECTIONAL TRAINING FAC),6937,0,6937,3281,211.4,7001
3451,2004,4,CVSP (CHUCKAWALLA VALLEY SP),4106,0,4106,1738,236.2,4052
3452,2004,4,SATF (CA SUBSTANCE ABUSE TREAT FAC),6885,5,6890,3324,207.3,6775
3453,2004,4,"SOL (CA SP, SOLANO)",5970,0,5970,2610,228.7,5852
3454,2004,4,SQ (SAN QUENTIN SP),5773,10,5783,3273,176.7,5683
3455,2004,4,"SAC (CA SP, SACRAMENTO)",3193,0,3193,1728,184.8,3244
3456,2004,4,"LAC (CA SP, LOS ANGELES COUNTY)",4470,0,4470,2200,203.2,4540
3457,2004,4,"COR (CA SP, CORCORAN)",5113,0,5113,3016,169.5,5184
3458,2004,4,CEN (CENTINELA SP),4871,0,4871,2208,220.6,4983
3459,2004,4,CAL (CALIPATRIA SP),4167,0,4167,2508,166.1,4318
3460,2004,4,"CRC (CAL REHAB CTR, MEN)",2857,1041,3898,1814,214.9,3952
3461,2004,4,CMC (CA MEN'S COLONY),6543,0,6543,3884,168.5,6604
3462,2004,4,CMF (CA MEDICAL FAC),3221,0,3221,2315,139.1,3401
3463,2004,4,CIM (CA INSTITUTION FOR MEN),6600,35,6635,3078,215.6,6665
3464,2004,4,CCI (CA CORRECTIONAL INSTITUTION),5406,0,5406,2781,194.4,5600
3465,2004,4,CCC (CA CORRECTIONAL CENTER),5968,0,5968,3682,162.1,5642
3466,2004,4,ASP (AVENAL SP),7171,0,7171,2920,245.6,6978
3467,2004,5,VSP (VALLEY SP),3659,6,3665,1980,185.1,3814
3468,2004,5,SCC (SIERRA CONSERVATION CENTER),335,0,335,320,104.7,320
3469,2004,5,CCWF (CENTRAL CA WOMEN'S FAC),3590,3,3593,2004,179.3,3413
3470,2004,5,"CRC (CAL REHAB CTR, WOMEN)",351,272,623,500,124.6,680
3471,2004,5,CIW (CA INSTITUTION FOR WOMEN),1845,10,1855,1026,180.8,1806
3472,2004,5,WSP (WASCO SP),6163,19,6182,2984,207.2,5958
3473,2004,5,SCC (SIERRA CONSERVATION CENTER),6063,0,6063,3606,168.1,5977
3474,2004,5,SVSP (SALINAS VALLEY SP),4488,0,4488,2224,201.8,4720
3475,2004,5,RJD (RJ DONOVAN CORRECTIONAL FAC),4336,0,4336,2200,197.1,4443
3476,2004,5,PVSP (PLEASANT VALLEY SP),4446,0,4446,2208,201.4,4848
3477,2004,5,PBSP (PELICAN BAY SP),3477,0,3477,2280,152.5,3582
3478,2004,5,NKSP (NORTH KERN SP),5229,1,5230,2692,194.3,5139
3479,2004,5,MCSP (MULE CREEK SP),3646,0,3646,1700,214.5,3697
3480,2004,5,ISP (IRONWOOD SP),4669,0,4669,2200,212.2,4665
3481,2004,5,HDSP (HIGH DESERT SP),4593,2,4595,2344,196.0,4530
3482,2004,5,FOL (FOLSOM SP) (MALE),3927,0,3927,2475,158.7,4249
3483,2004,5,DVI (DEUEL VOCATIONAL INSTITUTION),3547,19,3566,1787,199.6,3551
3484,2004,5,CTF (CORRECTIONAL TRAINING FAC),6949,0,6949,3281,211.8,7001
3485,2004,5,CVSP (CHUCKAWALLA VALLEY SP),4132,0,4132,1738,237.7,4196
3486,2004,5,SATF (CA SUBSTANCE ABUSE TREAT FAC),6832,5,6837,3324,205.7,6775
3487,2004,5,"SOL (CA SP, SOLANO)",6043,0,6043,2610,231.5,5996
3488,2004,5,SQ (SAN QUENTIN SP),5829,5,5834,3273,178.2,5683
3489,2004,5,"SAC (CA SP, SACRAMENTO)",3237,0,3237,1728,187.3,3244
3490,2004,5,"LAC (CA SP, LOS ANGELES COUNTY)",4481,0,4481,2200,203.7,4540
3491,2004,5,"COR (CA SP, CORCORAN)",5147,0,5147,3016,170.7,5184
3492,2004,5,CEN (CENTINELA SP),4844,0,4844,2208,219.4,4983
3493,2004,5,CAL (CALIPATRIA SP),4175,0,4175,2508,166.5,4318
3494,2004,5,"CRC (CAL REHAB CTR, MEN)",2891,1030,3921,1814,216.2,3952
3495,2004,5,CMC (CA MEN'S COLONY),6533,0,6533,3884,168.2,6604
3496,2004,5,CMF (CA MEDICAL FAC),3183,0,3183,2315,137.5,3401
3497,2004,5,CIM (CA INSTITUTION FOR MEN),6543,37,6580,3078,213.8,6665
3498,2004,5,CCI (CA CORRECTIONAL INSTITUTION),5456,1,5457,2781,196.2,5756
3499,2004,5,CCC (CA CORRECTIONAL CENTER),5903,0,5903,3682,160.3,5642
3500,2004,5,ASP (AVENAL SP),7200,0,7200,2920,246.6,7128
3501,2004,6,VSP (VALLEY SP),3636,6,3642,1980,183.9,3814
3502,2004,6,SCC (SIERRA CONSERVATION CENTER),329,0,329,320,102.8,320
3503,2004,6,CCWF (CENTRAL CA WOMEN'S FAC),3640,2,3642,2004,181.7,3413
3504,2004,6,"CRC (CAL REHAB CTR, WOMEN)",367,240,607,500,121.4,680
3505,2004,6,CIW (CA INSTITUTION FOR WOMEN),1947,13,1960,1026,191.0,1806
3506,2004,6,WSP (WASCO SP),6082,17,6099,2984,204.4,5958
3507,2004,6,SCC (SIERRA CONSERVATION CENTER),5996,0,5996,3606,166.3,5977
3508,2004,6,SVSP (SALINAS VALLEY SP),4562,0,4562,2224,205.1,4600
3509,2004,6,RJD (RJ DONOVAN CORRECTIONAL FAC),4280,2,4282,2200,194.6,4443
3510,2004,6,PVSP (PLEASANT VALLEY SP),4463,0,4463,2208,202.1,4848
3511,2004,6,PBSP (PELICAN BAY SP),3533,0,3533,2280,155.0,3582
3512,2004,6,NKSP (NORTH KERN SP),5127,3,5130,2692,190.6,5139
3513,2004,6,MCSP (MULE CREEK SP),3672,0,3672,1700,216.0,3697
3514,2004,6,ISP (IRONWOOD SP),4689,0,4689,2200,213.1,4665
3515,2004,6,HDSP (HIGH DESERT SP),4666,4,4670,2344,199.2,4530
3516,2004,6,FOL (FOLSOM SP) (MALE),3995,0,3995,2475,161.4,4249
3517,2004,6,DVI (DEUEL VOCATIONAL INSTITUTION),3623,10,3633,1787,203.3,3551
3518,2004,6,CTF (CORRECTIONAL TRAINING FAC),7081,4,7085,3281,215.9,7001
3519,2004,6,CVSP (CHUCKAWALLA VALLEY SP),4216,0,4216,1738,242.6,4196
3520,2004,6,SATF (CA SUBSTANCE ABUSE TREAT FAC),6844,3,6847,3324,206.0,6775
3521,2004,6,"SOL (CA SP, SOLANO)",6083,0,6083,2610,233.1,5996
3522,2004,6,SQ (SAN QUENTIN SP),5753,8,5761,3273,176.0,5731
3523,2004,6,"SAC (CA SP, SACRAMENTO)",3359,0,3359,1728,194.4,3244
3524,2004,6,"LAC (CA SP, LOS ANGELES COUNTY)",4474,0,4474,2200,203.4,4540
3525,2004,6,"COR (CA SP, CORCORAN)",5139,0,5139,3016,170.4,5184
3526,2004,6,CEN (CENTINELA SP),4862,0,4862,2208,220.2,4983
3527,2004,6,CAL (CALIPATRIA SP),4094,0,4094,2508,163.2,4318
3528,2004,6,"CRC (CAL REHAB CTR, MEN)",2917,996,3913,1814,215.7,3952
3529,2004,6,CMC (CA MEN'S COLONY),6540,0,6540,3884,168.4,6604
3530,2004,6,CMF (CA MEDICAL FAC),3227,0,3227,2315,139.4,3401
3531,2004,6,CIM (CA INSTITUTION FOR MEN),6599,39,6638,3078,215.7,6665
3532,2004,6,CCI (CA CORRECTIONAL INSTITUTION),5388,0,5388,2781,193.7,5597
3533,2004,6,CCC (CA CORRECTIONAL CENTER),5957,0,5957,3682,161.8,5642
3534,2004,6,ASP (AVENAL SP),7252,0,7252,2920,248.4,7128
3535,2004,7,VSP (VALLEY SP),3646,17,3663,1980,185.0,3814
3536,2004,7,SCC (SIERRA CONSERVATION CENTER),329,0,329,320,102.8,320
3537,2004,7,CCWF (CENTRAL CA WOMEN'S FAC),3598,4,3602,2004,179.7,3490
3538,2004,7,"CRC (CAL REHAB CTR, WOMEN)",454,240,694,500,138.8,680
3539,2004,7,CIW (CA INSTITUTION FOR WOMEN),1941,12,1953,1026,190.4,1950
3540,2004,7,WSP (WASCO SP),6033,33,6066,2984,203.3,5958
3541,2004,7,SCC (SIERRA CONSERVATION CENTER),6059,0,6059,3606,168.0,5977
3542,2004,7,SVSP (SALINAS VALLEY SP),4538,0,4538,2224,204.0,4600
3543,2004,7,RJD (RJ DONOVAN CORRECTIONAL FAC),4387,0,4387,2200,199.4,4443
3544,2004,7,PVSP (PLEASANT VALLEY SP),4598,0,4598,2208,208.2,4848
3545,2004,7,PBSP (PELICAN BAY SP),3498,1,3499,2280,153.5,3582
3546,2004,7,NKSP (NORTH KERN SP),5268,4,5272,2692,195.8,5387
3547,2004,7,MCSP (MULE CREEK SP),3770,0,3770,1700,221.8,3837
3548,2004,7,ISP (IRONWOOD SP),4714,0,4714,2200,214.3,4773
3549,2004,7,HDSP (HIGH DESERT SP),4827,8,4835,2344,206.3,4788
3550,2004,7,FOL (FOLSOM SP) (MALE),3987,0,3987,2475,161.1,4249
3551,2004,7,DVI (DEUEL VOCATIONAL INSTITUTION),3438,16,3454,1787,193.3,3551
3552,2004,7,CTF (CORRECTIONAL TRAINING FAC),6927,0,6927,3281,211.1,7001
3553,2004,7,CVSP (CHUCKAWALLA VALLEY SP),4160,0,4160,1738,239.4,4292
3554,2004,7,SATF (CA SUBSTANCE ABUSE TREAT FAC),6969,4,6973,3324,209.8,7003
3555,2004,7,"SOL (CA SP, SOLANO)",6089,0,6089,2610,233.3,5996
3556,2004,7,SQ (SAN QUENTIN SP),5833,11,5844,3273,178.6,5731
3557,2004,7,"SAC (CA SP, SACRAMENTO)",3347,0,3347,1728,193.7,3244
3558,2004,7,"LAC (CA SP, LOS ANGELES COUNTY)",4579,5,4584,2200,208.4,4540
3559,2004,7,"COR (CA SP, CORCORAN)",5123,0,5123,3016,169.9,5184
3560,2004,7,CEN (CENTINELA SP),4895,0,4895,2208,221.7,5091
3561,2004,7,CAL (CALIPATRIA SP),4106,0,4106,2508,163.7,4318
3562,2004,7,"CRC (CAL REHAB CTR, MEN)",3048,946,3994,1814,220.2,3952
3563,2004,7,CMC (CA MEN'S COLONY),6488,0,6488,3884,167.0,6604
3564,2004,7,CMF (CA MEDICAL FAC),3263,0,3263,2315,141.0,3401
3565,2004,7,CIM (CA INSTITUTION FOR MEN),6515,29,6544,3078,212.6,6665
3566,2004,7,CCI (CA CORRECTIONAL INSTITUTION),5454,0,5454,2781,196.1,5597
3567,2004,7,CCC (CA CORRECTIONAL CENTER),5965,0,5965,3682,162.0,5642
3568,2004,7,ASP (AVENAL SP),7186,0,7186,2920,246.1,7128
3569,2004,8,VSP (VALLEY SP),3688,10,3698,1980,186.8,3814
3570,2004,8,SCC (SIERRA CONSERVATION CENTER),311,0,311,320,97.2,320
3571,2004,8,CCWF (CENTRAL CA WOMEN'S FAC),3702,3,3705,2004,184.9,3490
3572,2004,8,"CRC (CAL REHAB CTR, WOMEN)",526,249,775,500,155.0,680
3573,2004,8,CIW (CA INSTITUTION FOR WOMEN),1946,11,1957,1026,190.7,1950
3574,2004,8,WSP (WASCO SP),6071,12,6083,2984,203.9,5958
3575,2004,8,SCC (SIERRA CONSERVATION CENTER),6078,0,6078,3606,168.6,5977
3576,2004,8,SVSP (SALINAS VALLEY SP),4553,0,4553,2224,204.7,4600
3577,2004,8,RJD (RJ DONOVAN CORRECTIONAL FAC),4378,0,4378,2200,199.0,4443
3578,2004,8,PVSP (PLEASANT VALLEY SP),4896,0,4896,2208,221.7,4848
3579,2004,8,PBSP (PELICAN BAY SP),3424,0,3424,2280,150.2,3582
3580,2004,8,NKSP (NORTH KERN SP),5240,7,5247,2692,194.9,5387
3581,2004,8,MCSP (MULE CREEK SP),3785,0,3785,1700,222.6,3837
3582,2004,8,ISP (IRONWOOD SP),4707,0,4707,2200,214.0,4773
3583,2004,8,HDSP (HIGH DESERT SP),4969,4,4973,2344,212.2,4788
3584,2004,8,FOL (FOLSOM SP) (MALE),3988,0,3988,2475,161.1,4249
3585,2004,8,DVI (DEUEL VOCATIONAL INSTITUTION),3621,20,3641,1787,203.7,3551
3586,2004,8,CTF (CORRECTIONAL TRAINING FAC),7054,0,7054,3281,215.0,7001
3587,2004,8,CVSP (CHUCKAWALLA VALLEY SP),4045,0,4045,1738,232.7,4292
3588,2004,8,SATF (CA SUBSTANCE ABUSE TREAT FAC),6875,2,6877,3324,206.9,7003
3589,2004,8,"SOL (CA SP, SOLANO)",6148,0,6148,2610,235.6,5996
3590,2004,8,SQ (SAN QUENTIN SP),5889,8,5897,3273,180.2,5731
3591,2004,8,"SAC (CA SP, SACRAMENTO)",3339,0,3339,1728,193.2,3244
3592,2004,8,"LAC (CA SP, LOS ANGELES COUNTY)",4590,0,4590,2200,208.6,4540
3593,2004,8,"COR (CA SP, CORCORAN)",5093,0,5093,3016,168.9,5184
3594,2004,8,CEN (CENTINELA SP),4956,0,4956,2208,224.5,5091
3595,2004,8,CAL (CALIPATRIA SP),4179,0,4179,2508,166.6,4318
3596,2004,8,"CRC (CAL REHAB CTR, MEN)",3006,937,3943,1814,217.4,3952
3597,2004,8,CMC (CA MEN'S COLONY),6482,0,6482,3884,166.9,6604
3598,2004,8,CMF (CA MEDICAL FAC),3262,0,3262,2315,140.9,3401
3599,2004,8,CIM (CA INSTITUTION FOR MEN),6547,30,6577,3078,213.7,6665
3600,2004,8,CCI (CA CORRECTIONAL INSTITUTION),5417,0,5417,2781,194.8,5597
3601,2004,8,CCC (CA CORRECTIONAL CENTER),6003,0,6003,3682,163.0,5642
3602,2004,8,ASP (AVENAL SP),7206,0,7206,2920,246.8,7128
3603,2004,9,VSP (VALLEY SP),3725,10,3735,1980,188.6,3814
3604,2004,9,SCC (SIERRA CONSERVATION CENTER),291,0,291,320,90.9,320
3605,2004,9,CCWF (CENTRAL CA WOMEN'S FAC),3722,2,3724,2004,185.8,3490
3606,2004,9,"CRC (CAL REHAB CTR, WOMEN)",523,251,774,500,154.8,680
3607,2004,9,CIW (CA INSTITUTION FOR WOMEN),1998,5,2003,1026,195.2,1950
3608,2004,9,WSP (WASCO SP),6091,11,6102,2984,204.5,5958
3609,2004,9,SCC (SIERRA CONSERVATION CENTER),6002,0,6002,3606,166.4,5977
3610,2004,9,SVSP (SALINAS VALLEY SP),4597,0,4597,2224,206.7,4600
3611,2004,9,RJD (RJ DONOVAN CORRECTIONAL FAC),4303,0,4303,2200,195.6,4443
3612,2004,9,PVSP (PLEASANT VALLEY SP),4856,0,4856,2208,219.9,4848
3613,2004,9,PBSP (PELICAN BAY SP),3428,0,3428,2280,150.4,3582
3614,2004,9,NKSP (NORTH KERN SP),5321,6,5327,2692,197.9,5387
3615,2004,9,MCSP (MULE CREEK SP),3729,0,3729,1700,219.4,3837
3616,2004,9,ISP (IRONWOOD SP),4711,0,4711,2200,214.1,4773
3617,2004,9,HDSP (HIGH DESERT SP),4962,3,4965,2344,211.8,4788
3618,2004,9,FOL (FOLSOM SP) (MALE),3981,0,3981,2475,160.8,4249
3619,2004,9,DVI (DEUEL VOCATIONAL INSTITUTION),3635,19,3654,1787,204.5,3551
3620,2004,9,CTF (CORRECTIONAL TRAINING FAC),7089,0,7089,3281,216.1,7001
3621,2004,9,CVSP (CHUCKAWALLA VALLEY SP),4123,0,4123,1738,237.2,4292
3622,2004,9,SATF (CA SUBSTANCE ABUSE TREAT FAC),7172,2,7174,3324,215.8,7003
3623,2004,9,"SOL (CA SP, SOLANO)",6172,0,6172,2610,236.5,5996
3624,2004,9,SQ (SAN QUENTIN SP),5841,14,5855,3273,178.9,5731
3625,2004,9,"SAC (CA SP, SACRAMENTO)",3369,0,3369,1728,195.0,3244
3626,2004,9,"LAC (CA SP, LOS ANGELES COUNTY)",4652,0,4652,2200,211.5,4540
3627,2004,9,"COR (CA SP, CORCORAN)",5010,0,5010,3016,166.1,5184
3628,2004,9,CEN (CENTINELA SP),4981,0,4981,2208,225.6,5091
3629,2004,9,CAL (CALIPATRIA SP),4120,0,4120,2508,164.3,4318
3630,2004,9,"CRC (CAL REHAB CTR, MEN)",2967,929,3896,1814,214.8,3952
3631,2004,9,CMC (CA MEN'S COLONY),6517,0,6517,3884,167.8,6604
3632,2004,9,CMF (CA MEDICAL FAC),3216,0,3216,2315,138.9,3401
3633,2004,9,CIM (CA INSTITUTION FOR MEN),6638,35,6673,3078,216.8,6665
3634,2004,9,CCI (CA CORRECTIONAL INSTITUTION),5506,0,5506,2781,198.0,5597
3635,2004,9,CCC (CA CORRECTIONAL CENTER),5968,0,5968,3682,162.1,5642
3636,2004,9,ASP (AVENAL SP),7231,0,7231,2920,247.6,7128
3637,2004,10,VSP (VALLEY SP),3729,12,3741,1980,188.9,3814
3638,2004,10,SCC (SIERRA CONSERVATION CENTER),294,0,294,320,91.9,320
3639,2004,10,CCWF (CENTRAL CA WOMEN'S FAC),3691,3,3694,2004,184.3,3490
3640,2004,10,"CRC (CAL REHAB CTR, WOMEN)",509,234,743,500,148.6,680
3641,2004,10,CIW (CA INSTITUTION FOR WOMEN),2029,5,2034,1026,198.2,1950
3642,2004,10,WSP (WASCO SP),6196,16,6212,2984,208.2,5958
3643,2004,10,SCC (SIERRA CONSERVATION CENTER),6008,0,6008,3606,166.6,5977
3644,2004,10,SVSP (SALINAS VALLEY SP),4617,0,4617,2224,207.6,4600
3645,2004,10,RJD (RJ DONOVAN CORRECTIONAL FAC),4367,0,4367,2200,198.5,4443
3646,2004,10,PVSP (PLEASANT VALLEY SP),5002,0,5002,2208,226.5,4848
3647,2004,10,PBSP (PELICAN BAY SP),3429,0,3429,2280,150.4,3582
3648,2004,10,NKSP (NORTH KERN SP),5470,4,5474,2692,203.3,5387
3649,2004,10,MCSP (MULE CREEK SP),3748,0,3748,1700,220.5,3837
3650,2004,10,ISP (IRONWOOD SP),4648,0,4648,2200,211.3,4773
3651,2004,10,HDSP (HIGH DESERT SP),4909,4,4913,2344,209.6,4788
3652,2004,10,FOL (FOLSOM SP) (MALE),4002,0,4002,2475,161.7,4249
3653,2004,10,DVI (DEUEL VOCATIONAL INSTITUTION),3504,21,3525,1787,197.3,3551
3654,2004,10,CTF (CORRECTIONAL TRAINING FAC),6926,0,6926,3281,211.1,7001
3655,2004,10,CVSP (CHUCKAWALLA VALLEY SP),4023,0,4023,1738,231.5,4292
3656,2004,10,SATF (CA SUBSTANCE ABUSE TREAT FAC),7263,2,7265,3324,218.6,7003
3657,2004,10,"SOL (CA SP, SOLANO)",5996,0,5996,2610,229.7,5996
3658,2004,10,SQ (SAN QUENTIN SP),5708,5,5713,3273,174.5,5731
3659,2004,10,"SAC (CA SP, SACRAMENTO)",3318,0,3318,1728,192.0,3244
3660,2004,10,"LAC (CA SP, LOS ANGELES COUNTY)",4660,0,4660,2200,211.8,4540
3661,2004,10,"COR (CA SP, CORCORAN)",5079,0,5079,3016,168.4,5184
3662,2004,10,CEN (CENTINELA SP),4948,0,4948,2208,224.1,5091
3663,2004,10,CAL (CALIPATRIA SP),4080,0,4080,2508,162.7,4318
3664,2004,10,"CRC (CAL REHAB CTR, MEN)",2922,934,3856,1814,212.6,3952
3665,2004,10,CMC (CA MEN'S COLONY),6387,0,6387,3884,164.4,6604
3666,2004,10,CMF (CA MEDICAL FAC),3212,0,3212,2315,138.7,3401
3667,2004,10,CIM (CA INSTITUTION FOR MEN),6541,33,6574,3078,213.6,6665
3668,2004,10,CCI (CA CORRECTIONAL INSTITUTION),5487,0,5487,2781,197.3,5597
3669,2004,10,CCC (CA CORRECTIONAL CENTER),5976,0,5976,3682,162.3,5642
3670,2004,10,ASP (AVENAL SP),7161,0,7161,2920,245.2,7128
3671,2004,11,VSP (VALLEY SP),3675,10,3685,1980,186.1,3814
3672,2004,11,SCC (SIERRA CONSERVATION CENTER),294,0,294,320,91.9,320
3673,2004,11,CCWF (CENTRAL CA WOMEN'S FAC),3795,3,3798,2004,189.5,3490
3674,2004,11,"CRC (CAL REHAB CTR, WOMEN)",488,228,716,500,143.2,680
3675,2004,11,CIW (CA INSTITUTION FOR WOMEN),1967,6,1973,1026,192.3,1950
3676,2004,11,WSP (WASCO SP),6210,13,6223,2984,208.5,5958
3677,2004,11,SCC (SIERRA CONSERVATION CENTER),5990,0,5990,3606,166.1,5977
3678,2004,11,SVSP (SALINAS VALLEY SP),4626,0,4626,2224,208.0,4600
3679,2004,11,RJD (RJ DONOVAN CORRECTIONAL FAC),4317,0,4317,2200,196.2,4443
3680,2004,11,PVSP (PLEASANT VALLEY SP),5002,0,5002,2208,226.5,4848
3681,2004,11,PBSP (PELICAN BAY SP),3403,0,3403,2280,149.3,3582
3682,2004,11,NKSP (NORTH KERN SP),5436,4,5440,2692,202.1,5387
3683,2004,11,MCSP (MULE CREEK SP),3713,0,3713,1700,218.4,3837
3684,2004,11,ISP (IRONWOOD SP),4665,0,4665,2200,212.0,4773
3685,2004,11,HDSP (HIGH DESERT SP),4809,1,4810,2344,205.2,4788
3686,2004,11,FOL (FOLSOM SP) (MALE),4007,0,4007,2475,161.9,4249
3687,2004,11,DVI (DEUEL VOCATIONAL INSTITUTION),3583,13,3596,1787,201.2,3551
3688,2004,11,CTF (CORRECTIONAL TRAINING FAC),6990,0,6990,3281,213.0,7001
3689,2004,11,CVSP (CHUCKAWALLA VALLEY SP),3996,0,3996,1738,229.9,4292
3690,2004,11,SATF (CA SUBSTANCE ABUSE TREAT FAC),7025,2,7027,3324,211.4,7003
3691,2004,11,"SOL (CA SP, SOLANO)",5885,0,5885,2610,225.5,5996
3692,2004,11,SQ (SAN QUENTIN SP),5804,3,5807,3273,177.4,5731
3693,2004,11,"SAC (CA SP, SACRAMENTO)",3253,0,3253,1728,188.3,3244
3694,2004,11,"LAC (CA SP, LOS ANGELES COUNTY)",4682,0,4682,2200,212.8,4540
3695,2004,11,"COR (CA SP, CORCORAN)",5075,0,5075,3016,168.3,5184
3696,2004,11,CEN (CENTINELA SP),4818,0,4818,2208,218.2,5091
3697,2004,11,CAL (CALIPATRIA SP),4172,0,4172,2508,166.3,4318
3698,2004,11,"CRC (CAL REHAB CTR, MEN)",2978,954,3932,1814,216.8,3952
3699,2004,11,CMC (CA MEN'S COLONY),6390,0,6390,3884,164.5,6604
3700,2004,11,CMF (CA MEDICAL FAC),3228,0,3228,2315,139.4,3401
3701,2004,11,CIM (CA INSTITUTION FOR MEN),6373,27,6400,3078,207.9,6665
3702,2004,11,CCI (CA CORRECTIONAL INSTITUTION),5568,0,5568,2781,200.2,5597
3703,2004,11,CCC (CA CORRECTIONAL CENTER),5912,0,5912,3682,160.6,5642
3704,2004,11,ASP (AVENAL SP),7191,0,7191,2920,246.3,7128
3705,2004,12,VSP (VALLEY SP),3696,16,3712,1980,187.5,3814
3706,2004,12,SCC (SIERRA CONSERVATION CENTER),290,0,290,320,90.6,320
3707,2004,12,CCWF (CENTRAL CA WOMEN'S FAC),3784,3,3787,2004,189.0,3490
3708,2004,12,"CRC (CAL REHAB CTR, WOMEN)",474,234,708,500,141.6,680
3709,2004,12,CIW (CA INSTITUTION FOR WOMEN),1983,5,1988,1026,193.8,1950
3710,2004,12,WSP (WASCO SP),6096,8,6104,2984,204.6,5958
3711,2004,12,SCC (SIERRA CONSERVATION CENTER),6119,0,6119,3606,169.7,5977
3712,2004,12,SVSP (SALINAS VALLEY SP),4628,0,4628,2224,208.1,4600
3713,2004,12,RJD (RJ DONOVAN CORRECTIONAL FAC),4484,0,4484,2200,203.8,4443
3714,2004,12,PVSP (PLEASANT VALLEY SP),5038,0,5038,2208,228.2,4848
3715,2004,12,PBSP (PELICAN BAY SP),3427,0,3427,2280,150.3,3582
3716,2004,12,NKSP (NORTH KERN SP),5225,6,5231,2692,194.3,5387
3717,2004,12,MCSP (MULE CREEK SP),3741,0,3741,1700,220.1,3837
3718,2004,12,ISP (IRONWOOD SP),4566,0,4566,2200,207.5,4773
3719,2004,12,HDSP (HIGH DESERT SP),4686,3,4689,2344,200.0,4788
3720,2004,12,FOL (FOLSOM SP) (MALE),3999,0,3999,2475,161.6,4249
3721,2004,12,DVI (DEUEL VOCATIONAL INSTITUTION),3597,19,3616,1787,202.4,3551
3722,2004,12,CTF (CORRECTIONAL TRAINING FAC),6992,0,6992,3281,213.1,7001
3723,2004,12,CVSP (CHUCKAWALLA VALLEY SP),3862,0,3862,1738,222.2,4292
3724,2004,12,SATF (CA SUBSTANCE ABUSE TREAT FAC),6980,2,6982,3324,210.0,7003
3725,2004,12,"SOL (CA SP, SOLANO)",5943,0,5943,2610,227.7,5996
3726,2004,12,SQ (SAN QUENTIN SP),5798,2,5800,3273,177.2,5731
3727,2004,12,"SAC (CA SP, SACRAMENTO)",3294,0,3294,1728,190.6,3244
3728,2004,12,"LAC (CA SP, LOS ANGELES COUNTY)",4698,0,4698,2200,213.5,4540
3729,2004,12,"COR (CA SP, CORCORAN)",5104,0,5104,3016,169.2,5184
3730,2004,12,CEN (CENTINELA SP),4664,0,4664,2208,211.2,5091
3731,2004,12,CAL (CALIPATRIA SP),4284,0,4284,2508,170.8,4318
3732,2004,12,"CRC (CAL REHAB CTR, MEN)",3000,918,3918,1814,216.0,3952
3733,2004,12,CMC (CA MEN'S COLONY),6389,0,6389,3884,164.5,6604
3734,2004,12,CMF (CA MEDICAL FAC),3176,0,3176,2315,137.2,3401
3735,2004,12,CIM (CA INSTITUTION FOR MEN),6533,36,6569,3078,213.4,6665
3736,2004,12,CCI (CA CORRECTIONAL INSTITUTION),5506,0,5506,2781,198.0,5597
3737,2004,12,CCC (CA CORRECTIONAL CENTER),5801,0,5801,3682,157.6,5642
3738,2004,12,ASP (AVENAL SP),7104,0,7104,2920,243.3,7128
3739,2005,1,VSP (VALLEY SP),3649,37,3686,1980,186.2,3686
3740,2005,1,SCC (SIERRA CONSERVATION CENTER),281,0,281,320,87.8,320
3741,2005,1,CCWF (CENTRAL CA WOMEN'S FAC),3673,6,3679,2004,183.6,3490
3742,2005,1,"CRC (CAL REHAB CTR, WOMEN)",438,219,657,500,131.4,680
3743,2005,1,CIW (CA INSTITUTION FOR WOMEN),1921,7,1928,1026,187.9,1950
3744,2005,1,WSP (WASCO SP),6025,18,6043,2984,202.5,6066
3745,2005,1,SCC (SIERRA CONSERVATION CENTER),6025,0,6025,3606,167.1,6107
3746,2005,1,SVSP (SALINAS VALLEY SP),4539,0,4539,2224,204.1,4510
3747,2005,1,RJD (RJ DONOVAN CORRECTIONAL FAC),4380,0,4380,2200,199.1,4443
3748,2005,1,PVSP (PLEASANT VALLEY SP),5015,0,5015,2208,227.1,5028
3749,2005,1,PBSP (PELICAN BAY SP),3408,0,3408,2280,149.5,3582
3750,2005,1,NKSP (NORTH KERN SP),5266,8,5274,2692,195.9,5387
3751,2005,1,MCSP (MULE CREEK SP),3513,0,3513,1700,206.6,3837
3752,2005,1,ISP (IRONWOOD SP),4659,0,4659,2200,211.8,4653
3753,2005,1,HDSP (HIGH DESERT SP),4667,10,4677,2344,199.5,4752
3754,2005,1,FOL (FOLSOM SP) (MALE),3999,0,3999,2475,161.6,4249
3755,2005,1,DVI (DEUEL VOCATIONAL INSTITUTION),3582,18,3600,1787,201.5,3551
3756,2005,1,CTF (CORRECTIONAL TRAINING FAC),6908,0,6908,3281,210.5,7001
3757,2005,1,CVSP (CHUCKAWALLA VALLEY SP),3729,0,3729,1738,214.6,3860
3758,2005,1,SATF (CA SUBSTANCE ABUSE TREAT FAC),7037,2,7039,3324,211.8,7027
3759,2005,1,"SOL (CA SP, SOLANO)",5830,0,5830,2610,223.4,5660
3760,2005,1,SQ (SAN QUENTIN SP),5836,11,5847,3273,178.6,5681
3761,2005,1,"SAC (CA SP, SACRAMENTO)",3300,0,3300,1728,191.0,3244
3762,2005,1,"LAC (CA SP, LOS ANGELES COUNTY)",4629,0,4629,2200,210.4,4684
3763,2005,1,"COR (CA SP, CORCORAN)",5087,0,5087,3016,168.7,5134
3764,2005,1,CEN (CENTINELA SP),4654,0,4654,2208,210.8,5103
3765,2005,1,CAL (CALIPATRIA SP),4249,0,4249,2508,169.4,4268
3766,2005,1,"CRC (CAL REHAB CTR, MEN)",2794,879,3673,1814,202.5,3952
3767,2005,1,CMC (CA MEN'S COLONY),6435,0,6435,3884,165.7,6604
3768,2005,1,CMF (CA MEDICAL FAC),3119,1,3120,2315,134.8,3351
3769,2005,1,CIM (CA INSTITUTION FOR MEN),6228,39,6267,3078,203.6,6615
3770,2005,1,CCI (CA CORRECTIONAL INSTITUTION),5524,0,5524,2699,204.7,5824
3771,2005,1,CCC (CA CORRECTIONAL CENTER),5807,0,5807,3682,157.7,5750
3772,2005,1,ASP (AVENAL SP),7034,0,7034,2920,240.9,7028
3773,2005,2,VSP (VALLEY SP),3589,21,3610,1980,182.3,3686
3774,2005,2,SCC (SIERRA CONSERVATION CENTER),291,0,291,320,90.9,320
3775,2005,2,CCWF (CENTRAL CA WOMEN'S FAC),3717,2,3719,2004,185.6,3490
3776,2005,2,"CRC (CAL REHAB CTR, WOMEN)",409,223,632,500,126.4,680
3777,2005,2,CIW (CA INSTITUTION FOR WOMEN),1891,11,1902,1026,185.4,1950
3778,2005,2,WSP (WASCO SP),5991,22,6013,2984,201.5,6066
3779,2005,2,SCC (SIERRA CONSERVATION CENTER),6051,0,6051,3606,167.8,6107
3780,2005,2,SVSP (SALINAS VALLEY SP),4558,0,4558,2224,204.9,4510
3781,2005,2,RJD (RJ DONOVAN CORRECTIONAL FAC),4421,0,4421,2200,201.0,4443
3782,2005,2,PVSP (PLEASANT VALLEY SP),4971,0,4971,2208,225.1,5028
3783,2005,2,PBSP (PELICAN BAY SP),3371,0,3371,2280,147.9,3582
3784,2005,2,NKSP (NORTH KERN SP),5289,4,5293,2692,196.6,5387
3785,2005,2,MCSP (MULE CREEK SP),3659,0,3659,1700,215.2,3837
3786,2005,2,ISP (IRONWOOD SP),4678,0,4678,2200,212.6,4653
3787,2005,2,HDSP (HIGH DESERT SP),4602,4,4606,2344,196.5,4752
3788,2005,2,FOL (FOLSOM SP) (MALE),4089,0,4089,2475,165.2,4249
3789,2005,2,DVI (DEUEL VOCATIONAL INSTITUTION),3515,27,3542,1787,198.2,3551
3790,2005,2,CTF (CORRECTIONAL TRAINING FAC),6930,0,6930,3281,211.2,7001
3791,2005,2,CVSP (CHUCKAWALLA VALLEY SP),3703,0,3703,1738,213.1,3860
3792,2005,2,SATF (CA SUBSTANCE ABUSE TREAT FAC),7050,2,7052,3324,212.2,7027
3793,2005,2,"SOL (CA SP, SOLANO)",5772,0,5772,2610,221.1,5660
3794,2005,2,SQ (SAN QUENTIN SP),5622,8,5630,3273,172.0,5681
3795,2005,2,"SAC (CA SP, SACRAMENTO)",3308,0,3308,1728,191.4,3244
3796,2005,2,"LAC (CA SP, LOS ANGELES COUNTY)",4609,0,4609,2200,209.5,4684
3797,2005,2,"COR (CA SP, CORCORAN)",5091,0,5091,3016,168.8,5134
3798,2005,2,CEN (CENTINELA SP),4719,0,4719,2208,213.7,5103
3799,2005,2,CAL (CALIPATRIA SP),4189,0,4189,2508,167.0,4268
3800,2005,2,"CRC (CAL REHAB CTR, MEN)",3058,866,3924,1814,216.3,3952
3801,2005,2,CMC (CA MEN'S COLONY),6534,0,6534,3884,168.2,6604
3802,2005,2,CMF (CA MEDICAL FAC),3122,0,3122,2315,134.9,3351
3803,2005,2,CIM (CA INSTITUTION FOR MEN),6121,41,6162,3078,200.2,6615
3804,2005,2,CCI (CA CORRECTIONAL INSTITUTION),5464,0,5464,2699,202.4,5824
3805,2005,2,CCC (CA CORRECTIONAL CENTER),5810,0,5810,3682,157.8,5750
3806,2005,2,ASP (AVENAL SP),6991,0,6991,2920,239.4,7028
3807,2005,3,VSP (VALLEY SP),3656,9,3665,1980,185.1,3686
3808,2005,3,SCC (SIERRA CONSERVATION CENTER),292,0,292,320,91.3,320
3809,2005,3,CCWF (CENTRAL CA WOMEN'S FAC),3722,2,3724,2004,185.8,3490
3810,2005,3,"CRC (CAL REHAB CTR, WOMEN)",389,247,636,500,127.2,680
3811,2005,3,CIW (CA INSTITUTION FOR WOMEN),1968,14,1982,1026,193.2,1950
3812,2005,3,WSP (WASCO SP),5882,16,5898,2984,197.7,6066
3813,2005,3,SCC (SIERRA CONSERVATION CENTER),6137,0,6137,3606,170.2,6107
3814,2005,3,SVSP (SALINAS VALLEY SP),4459,0,4459,2224,200.5,4510
3815,2005,3,RJD (RJ DONOVAN CORRECTIONAL FAC),4502,0,4502,2200,204.6,4443
3816,2005,3,PVSP (PLEASANT VALLEY SP),4925,0,4925,2208,223.1,5028
3817,2005,3,PBSP (PELICAN BAY SP),3314,0,3314,2280,145.4,3582
3818,2005,3,NKSP (NORTH KERN SP),5209,2,5211,2692,193.6,5387
3819,2005,3,MCSP (MULE CREEK SP),3707,0,3707,1700,218.1,3837
3820,2005,3,ISP (IRONWOOD SP),4561,0,4561,2200,207.3,4653
3821,2005,3,HDSP (HIGH DESERT SP),4475,5,4480,2344,191.1,4752
3822,2005,3,FOL (FOLSOM SP) (MALE),4096,0,4096,2475,165.5,4249
3823,2005,3,DVI (DEUEL VOCATIONAL INSTITUTION),3582,31,3613,1787,202.2,3551
3824,2005,3,CTF (CORRECTIONAL TRAINING FAC),6936,0,6936,3281,211.4,7001
3825,2005,3,CVSP (CHUCKAWALLA VALLEY SP),3664,0,3664,1738,210.8,3860
3826,2005,3,SATF (CA SUBSTANCE ABUSE TREAT FAC),7047,2,7049,3324,212.1,7027
3827,2005,3,"SOL (CA SP, SOLANO)",5757,0,5757,2610,220.6,5660
3828,2005,3,SQ (SAN QUENTIN SP),5784,6,5790,3273,176.9,5681
3829,2005,3,"SAC (CA SP, SACRAMENTO)",3292,0,3292,1728,190.5,3244
3830,2005,3,"LAC (CA SP, LOS ANGELES COUNTY)",4646,0,4646,2200,211.2,4684
3831,2005,3,"COR (CA SP, CORCORAN)",5079,0,5079,3016,168.4,5134
3832,2005,3,CEN (CENTINELA SP),4575,0,4575,2208,207.2,5103
3833,2005,3,CAL (CALIPATRIA SP),4263,0,4263,2508,170.0,4268
3834,2005,3,"CRC (CAL REHAB CTR, MEN)",3012,874,3886,1814,214.2,3952
3835,2005,3,CMC (CA MEN'S COLONY),6495,0,6495,3884,167.2,6604
3836,2005,3,CMF (CA MEDICAL FAC),3132,0,3132,2315,135.3,3351
3837,2005,3,CIM (CA INSTITUTION FOR MEN),6313,43,6356,3078,206.5,6615
3838,2005,3,CCI (CA CORRECTIONAL INSTITUTION),5701,0,5701,2699,211.2,5824
3839,2005,3,CCC (CA CORRECTIONAL CENTER),5842,0,5842,3682,158.7,5750
3840,2005,3,ASP (AVENAL SP),6946,0,6946,2920,237.9,7028
3841,2005,4,VSP (VALLEY SP),3670,18,3688,1980,186.3,3686
3842,2005,4,SCC (SIERRA CONSERVATION CENTER),276,0,276,320,86.3,320
3843,2005,4,CCWF (CENTRAL CA WOMEN'S FAC),3675,4,3679,2004,183.6,3490
3844,2005,4,"CRC (CAL REHAB CTR, WOMEN)",364,236,600,500,120.0,680
3845,2005,4,CIW (CA INSTITUTION FOR WOMEN),1981,15,1996,1026,194.5,1950
3846,2005,4,WSP (WASCO SP),5998,14,6012,2984,201.5,6066
3847,2005,4,SCC (SIERRA CONSERVATION CENTER),6185,0,6185,3606,171.5,6107
3848,2005,4,SVSP (SALINAS VALLEY SP),4362,0,4362,2224,196.1,4510
3849,2005,4,RJD (RJ DONOVAN CORRECTIONAL FAC),4584,0,4584,2200,208.4,4443
3850,2005,4,PVSP (PLEASANT VALLEY SP),4902,0,4902,2208,222.0,5028
3851,2005,4,PBSP (PELICAN BAY SP),3290,0,3290,2280,144.3,3582
3852,2005,4,NKSP (NORTH KERN SP),5179,3,5182,2692,192.5,5387
3853,2005,4,MCSP (MULE CREEK SP),3679,0,3679,1700,216.4,3837
3854,2005,4,ISP (IRONWOOD SP),4579,0,4579,2200,208.1,4653
3855,2005,4,HDSP (HIGH DESERT SP),4610,2,4612,2344,196.8,4752
3856,2005,4,FOL (FOLSOM SP) (MALE),4084,0,4084,2475,165.0,4249
3857,2005,4,DVI (DEUEL VOCATIONAL INSTITUTION),3655,31,3686,1787,206.3,3551
3858,2005,4,CTF (CORRECTIONAL TRAINING FAC),6840,0,6840,3281,208.5,7001
3859,2005,4,CVSP (CHUCKAWALLA VALLEY SP),3688,0,3688,1738,212.2,3860
3860,2005,4,SATF (CA SUBSTANCE ABUSE TREAT FAC),7054,3,7057,3324,212.3,7027
3861,2005,4,"SOL (CA SP, SOLANO)",5807,0,5807,2610,222.5,5660
3862,2005,4,SQ (SAN QUENTIN SP),5713,4,5717,3273,174.7,5681
3863,2005,4,"SAC (CA SP, SACRAMENTO)",3280,0,3280,1728,189.8,3244
3864,2005,4,"LAC (CA SP, LOS ANGELES COUNTY)",4644,0,4644,2200,211.1,4684
3865,2005,4,"COR (CA SP, CORCORAN)",5103,1,5104,3016,169.2,5134
3866,2005,4,CEN (CENTINELA SP),4472,0,4472,2208,202.5,5103
3867,2005,4,CAL (CALIPATRIA SP),4216,0,4216,2508,168.1,4268
3868,2005,4,"CRC (CAL REHAB CTR, MEN)",3065,867,3932,1814,216.8,3952
3869,2005,4,CMC (CA MEN'S COLONY),6477,0,6477,3884,166.8,6604
3870,2005,4,CMF (CA MEDICAL FAC),3133,0,3133,2315,135.3,3351
3871,2005,4,CIM (CA INSTITUTION FOR MEN),6311,39,6350,3078,206.3,6615
3872,2005,4,CCI (CA CORRECTIONAL INSTITUTION),5582,0,5582,2699,206.8,5824
3873,2005,4,CCC (CA CORRECTIONAL CENTER),5858,0,5858,3682,159.1,5750
3874,2005,4,ASP (AVENAL SP),7014,0,7014,2920,240.2,7028
3875,2005,5,VSP (VALLEY SP),3679,15,3694,1980,186.6,3686
3876,2005,5,SCC (SIERRA CONSERVATION CENTER),288,0,288,320,90.0,320
3877,2005,5,CCWF (CENTRAL CA WOMEN'S FAC),3702,2,3704,2004,184.8,3490
3878,2005,5,"CRC (CAL REHAB CTR, WOMEN)",350,240,590,500,118.0,680
3879,2005,5,CIW (CA INSTITUTION FOR WOMEN),1995,11,2006,1026,195.5,1950
3880,2005,5,WSP (WASCO SP),6013,13,6026,2984,201.9,6066
3881,2005,5,SCC (SIERRA CONSERVATION CENTER),6099,0,6099,3606,169.1,6107
3882,2005,5,SVSP (SALINAS VALLEY SP),4315,0,4315,2224,194.0,4510
3883,2005,5,RJD (RJ DONOVAN CORRECTIONAL FAC),4549,1,4550,2200,206.8,4443
3884,2005,5,PVSP (PLEASANT VALLEY SP),4988,0,4988,2208,225.9,5028
3885,2005,5,PBSP (PELICAN BAY SP),3367,0,3367,2280,147.7,3582
3886,2005,5,NKSP (NORTH KERN SP),5085,5,5090,2692,189.1,5387
3887,2005,5,MCSP (MULE CREEK SP),3863,0,3863,1700,227.2,3837
3888,2005,5,ISP (IRONWOOD SP),4527,0,4527,2200,205.8,4653
3889,2005,5,HDSP (HIGH DESERT SP),4652,4,4656,2344,198.6,4752
3890,2005,5,FOL (FOLSOM SP) (MALE),4071,0,4071,2475,164.5,4249
3891,2005,5,DVI (DEUEL VOCATIONAL INSTITUTION),3818,16,3834,1787,214.5,3551
3892,2005,5,CTF (CORRECTIONAL TRAINING FAC),6876,0,6876,3281,209.6,7001
3893,2005,5,CVSP (CHUCKAWALLA VALLEY SP),3642,0,3642,1738,209.6,3860
3894,2005,5,SATF (CA SUBSTANCE ABUSE TREAT FAC),7098,4,7102,3324,213.7,7027
3895,2005,5,"SOL (CA SP, SOLANO)",5781,0,5781,2610,221.5,5660
3896,2005,5,SQ (SAN QUENTIN SP),5359,6,5365,3273,163.9,5681
3897,2005,5,"SAC (CA SP, SACRAMENTO)",3218,0,3218,1728,186.2,3244
3898,2005,5,"LAC (CA SP, LOS ANGELES COUNTY)",4682,0,4682,2200,212.8,4684
3899,2005,5,"COR (CA SP, CORCORAN)",5142,0,5142,3016,170.5,5134
3900,2005,5,CEN (CENTINELA SP),4725,0,4725,2208,214.0,5103
3901,2005,5,CAL (CALIPATRIA SP),4188,0,4188,2508,167.0,4268
3902,2005,5,"CRC (CAL REHAB CTR, MEN)",3045,854,3899,1814,214.9,3952
3903,2005,5,CMC (CA MEN'S COLONY),6496,0,6496,3884,167.3,6604
3904,2005,5,CMF (CA MEDICAL FAC),3139,1,3140,2315,135.6,3351
3905,2005,5,CIM (CA INSTITUTION FOR MEN),6680,35,6715,3078,218.2,6615
3906,2005,5,CCI (CA CORRECTIONAL INSTITUTION),5607,0,5607,2699,207.7,5824
3907,2005,5,CCC (CA CORRECTIONAL CENTER),5941,0,5941,3682,161.4,5750
3908,2005,5,ASP (AVENAL SP),7009,0,7009,2920,240.0,7028
3909,2005,6,VSP (VALLEY SP),3672,12,3684,1980,186.1,3686
3910,2005,6,SCC (SIERRA CONSERVATION CENTER),291,0,291,320,90.9,320
3911,2005,6,CCWF (CENTRAL CA WOMEN'S FAC),3693,1,3694,2004,184.3,3490
3912,2005,6,"CRC (CAL REHAB CTR, WOMEN)",439,260,699,500,139.8,680
3913,2005,6,CIW (CA INSTITUTION FOR WOMEN),1975,10,1985,1026,193.5,1950
3914,2005,6,WSP (WASCO SP),5986,13,5999,2984,201.0,6066
3915,2005,6,SCC (SIERRA CONSERVATION CENTER),6159,0,6159,3606,170.8,6107
3916,2005,6,SVSP (SALINAS VALLEY SP),4319,0,4319,2224,194.2,4510
3917,2005,6,RJD (RJ DONOVAN CORRECTIONAL FAC),4672,1,4673,2200,212.4,4443
3918,2005,6,PVSP (PLEASANT VALLEY SP),4995,0,4995,2208,226.2,5028
3919,2005,6,PBSP (PELICAN BAY SP),3383,0,3383,2280,148.4,3582
3920,2005,6,NKSP (NORTH KERN SP),5039,0,5039,2692,187.2,5387
3921,2005,6,MCSP (MULE CREEK SP),3854,0,3854,1700,226.7,3837
3922,2005,6,KVSP (KERN VALLEY SP),67,0,67,200,33.5,200
3923,2005,6,ISP (IRONWOOD SP),4561,0,4561,2200,207.3,4653
3924,2005,6,HDSP (HIGH DESERT SP),4513,5,4518,2344,192.7,4752
3925,2005,6,FOL (FOLSOM SP) (MALE),3938,0,3938,2475,159.1,4249
3926,2005,6,DVI (DEUEL VOCATIONAL INSTITUTION),3886,34,3920,1787,219.4,3551
3927,2005,6,CTF (CORRECTIONAL TRAINING FAC),7068,0,7068,3281,215.4,7001
3928,2005,6,CVSP (CHUCKAWALLA VALLEY SP),3684,0,3684,1738,212.0,3860
3929,2005,6,SATF (CA SUBSTANCE ABUSE TREAT FAC),7495,4,7499,3324,225.6,7027
3930,2005,6,"SOL (CA SP, SOLANO)",5907,0,5907,2610,226.3,5660
3931,2005,6,SQ (SAN QUENTIN SP),5542,9,5551,3273,169.6,5681
3932,2005,6,"SAC (CA SP, SACRAMENTO)",3164,0,3164,1728,183.1,3244
3933,2005,6,"LAC (CA SP, LOS ANGELES COUNTY)",4701,0,4701,2200,213.7,4684
3934,2005,6,"COR (CA SP, CORCORAN)",5125,2,5127,3016,170.0,5134
3935,2005,6,CEN (CENTINELA SP),4704,0,4704,2208,213.0,5103
3936,2005,6,CAL (CALIPATRIA SP),4212,0,4212,2508,167.9,4268
3937,2005,6,"CRC (CAL REHAB CTR, MEN)",3119,864,3983,1814,219.6,3952
3938,2005,6,CMC (CA MEN'S COLONY),6483,0,6483,3884,166.9,6604
3939,2005,6,CMF (CA MEDICAL FAC),3250,0,3250,2315,140.4,3351
3940,2005,6,CIM (CA INSTITUTION FOR MEN),6536,34,6570,3078,213.5,6615
3941,2005,6,CCI (CA CORRECTIONAL INSTITUTION),5668,0,5668,2699,210.0,5824
3942,2005,6,CCC (CA CORRECTIONAL CENTER),6191,0,6191,3682,168.1,5750
3943,2005,6,ASP (AVENAL SP),7039,0,7039,2920,241.1,7028
3944,2005,7,VSP (VALLEY SP),3644,19,3663,1980,185.0,3686
3945,2005,7,SCC (SIERRA CONSERVATION CENTER),287,0,287,320,89.7,320
3946,2005,7,CCWF (CENTRAL CA WOMEN'S FAC),3793,3,3796,2004,189.4,3490
3947,2005,7,"CRC (CAL REHAB CTR, WOMEN)",473,275,748,500,149.6,680
3948,2005,7,CIW (CA INSTITUTION FOR WOMEN),1981,12,1993,1026,194.2,1950
3949,2005,7,WSP (WASCO SP),6039,21,6060,2984,203.1,6066
3950,2005,7,SCC (SIERRA CONSERVATION CENTER),6200,0,6200,3606,171.9,6107
3951,2005,7,SVSP (SALINAS VALLEY SP),4270,0,4270,2224,192.0,4510
3952,2005,7,RJD (RJ DONOVAN CORRECTIONAL FAC),4698,0,4698,2200,213.5,4443
3953,2005,7,PVSP (PLEASANT VALLEY SP),4929,0,4929,2208,223.2,5028
3954,2005,7,PBSP (PELICAN BAY SP),3428,0,3428,2280,150.4,3582
3955,2005,7,NKSP (NORTH KERN SP),5297,7,5304,2692,197.0,5387
3956,2005,7,MCSP (MULE CREEK SP),3804,0,3804,1700,223.8,3837
3957,2005,7,KVSP (KERN VALLEY SP),617,0,617,2448,25.2,4366
3958,2005,7,ISP (IRONWOOD SP),4537,0,4537,2200,206.2,4653
3959,2005,7,HDSP (HIGH DESERT SP),4583,1,4584,2344,195.6,4752
3960,2005,7,FOL (FOLSOM SP) (MALE),3967,0,3967,2475,160.3,4249
3961,2005,7,DVI (DEUEL VOCATIONAL INSTITUTION),3872,23,3895,1787,218.0,3551
3962,2005,7,CTF (CORRECTIONAL TRAINING FAC),7095,0,7095,3281,216.2,7001
3963,2005,7,CVSP (CHUCKAWALLA VALLEY SP),3644,0,3644,1738,209.7,3860
3964,2005,7,SATF (CA SUBSTANCE ABUSE TREAT FAC),7472,4,7476,3324,224.9,7027
3965,2005,7,"SOL (CA SP, SOLANO)",6075,0,6075,2610,232.8,5660
3966,2005,7,SQ (SAN QUENTIN SP),5440,3,5443,3273,166.3,5681
3967,2005,7,"SAC (CA SP, SACRAMENTO)",3191,0,3191,1728,184.7,3244
3968,2005,7,"LAC (CA SP, LOS ANGELES COUNTY)",4669,0,4669,2200,212.2,4684
3969,2005,7,"COR (CA SP, CORCORAN)",4928,1,4929,3016,163.4,5134
3970,2005,7,CEN (CENTINELA SP),4801,0,4801,2208,217.4,5103
3971,2005,7,CAL (CALIPATRIA SP),4133,0,4133,2508,164.8,4268
3972,2005,7,"CRC (CAL REHAB CTR, MEN)",3054,878,3932,1814,216.8,3952
3973,2005,7,CMC (CA MEN'S COLONY),6506,1,6507,3884,167.5,6604
3974,2005,7,CMF (CA MEDICAL FAC),3217,0,3217,2315,139.0,3351
3975,2005,7,CIM (CA INSTITUTION FOR MEN),6643,24,6667,3078,216.6,6615
3976,2005,7,CCI (CA CORRECTIONAL INSTITUTION),5637,0,5637,2699,208.9,5824
3977,2005,7,CCC (CA CORRECTIONAL CENTER),6103,0,6103,3682,165.8,5750
3978,2005,7,ASP (AVENAL SP),6722,0,6722,2920,230.2,7028
3979,2005,8,VSP (VALLEY SP),3852,20,3872,1980,195.6,3686
3980,2005,8,SCC (SIERRA CONSERVATION CENTER),296,0,296,320,92.5,320
3981,2005,8,CCWF (CENTRAL CA WOMEN'S FAC),3736,1,3737,2004,186.5,3490
3982,2005,8,"CRC (CAL REHAB CTR, WOMEN)",501,279,780,500,156.0,680
3983,2005,8,CIW (CA INSTITUTION FOR WOMEN),2041,6,2047,1026,199.5,1950
3984,2005,8,WSP (WASCO SP),6046,16,6062,2984,203.2,6066
3985,2005,8,SCC (SIERRA CONSERVATION CENTER),6152,0,6152,3606,170.6,6107
3986,2005,8,SVSP (SALINAS VALLEY SP),4257,0,4257,2224,191.4,4510
3987,2005,8,RJD (RJ DONOVAN CORRECTIONAL FAC),4654,1,4655,2200,211.6,4443
3988,2005,8,PVSP (PLEASANT VALLEY SP),4927,0,4927,2208,223.1,5028
3989,2005,8,PBSP (PELICAN BAY SP),3440,0,3440,2280,150.9,3582
3990,2005,8,NKSP (NORTH KERN SP),5220,3,5223,2692,194.0,5387
3991,2005,8,MCSP (MULE CREEK SP),3779,0,3779,1700,222.3,3837
3992,2005,8,KVSP (KERN VALLEY SP),995,0,995,2448,40.6,4366
3993,2005,8,ISP (IRONWOOD SP),4574,0,4574,2200,207.9,4653
3994,2005,8,HDSP (HIGH DESERT SP),4576,3,4579,2344,195.3,4752
3995,2005,8,FOL (FOLSOM SP) (MALE),3965,0,3965,2275,174.3,4049
3996,2005,8,DVI (DEUEL VOCATIONAL INSTITUTION),3769,11,3780,1787,211.5,3551
3997,2005,8,CTF (CORRECTIONAL TRAINING FAC),7124,3,7127,3281,217.2,7001
3998,2005,8,CVSP (CHUCKAWALLA VALLEY SP),3824,0,3824,1738,220.0,3860
3999,2005,8,SATF (CA SUBSTANCE ABUSE TREAT FAC),7481,5,7486,3324,225.2,7027
4000,2005,8,"SOL (CA SP, SOLANO)",6127,0,6127,2610,234.8,5660
4001,2005,8,SQ (SAN QUENTIN SP),5345,9,5354,3273,163.6,5681
4002,2005,8,"SAC (CA SP, SACRAMENTO)",3172,0,3172,1728,183.6,3244
4003,2005,8,"LAC (CA SP, LOS ANGELES COUNTY)",4600,0,4600,2200,209.1,4684
4004,2005,8,"COR (CA SP, CORCORAN)",5058,0,5058,3016,167.7,5134
4005,2005,8,CEN (CENTINELA SP),4863,0,4863,2208,220.2,5103
4006,2005,8,CAL (CALIPATRIA SP),4152,0,4152,2508,165.6,4268
4007,2005,8,"CRC (CAL REHAB CTR, MEN)",3002,887,3889,1814,214.4,3952
4008,2005,8,CMC (CA MEN'S COLONY),6532,1,6533,3884,168.2,6604
4009,2005,8,CMF (CA MEDICAL FAC),3225,0,3225,2315,139.3,3351
4010,2005,8,CIM (CA INSTITUTION FOR MEN),6684,21,6705,3078,217.8,6615
4011,2005,8,CCI (CA CORRECTIONAL INSTITUTION),5712,0,5712,2509,227.7,5558
4012,2005,8,CCC (CA CORRECTIONAL CENTER),6206,0,6206,3682,168.5,5750
4013,2005,8,ASP (AVENAL SP),6926,0,6926,2920,237.2,7028
4014,2005,9,VSP (VALLEY SP),3836,19,3855,1980,194.7,3686
4015,2005,9,CCWF (CENTRAL CA WOMEN'S FAC),3833,1,3834,2004,191.3,3490
4016,2005,9,"CRC (CAL REHAB CTR, WOMEN)",509,283,792,500,158.4,680
4017,2005,9,CIW (CA INSTITUTION FOR WOMEN),2301,6,2307,1346,171.4,2270
4018,2005,9,WSP (WASCO SP),6030,22,6052,2984,202.8,6066
4019,2005,9,SCC (SIERRA CONSERVATION CENTER),6022,0,6022,3606,167.0,6107
4020,2005,9,SVSP (SALINAS VALLEY SP),4017,0,4017,2224,180.6,4510
4021,2005,9,RJD (RJ DONOVAN CORRECTIONAL FAC),4716,0,4716,2200,214.4,4443
4022,2005,9,PVSP (PLEASANT VALLEY SP),4864,0,4864,2208,220.3,5028
4023,2005,9,PBSP (PELICAN BAY SP),3443,0,3443,2280,151.0,3582
4024,2005,9,NKSP (NORTH KERN SP),5238,4,5242,2692,194.7,5387
4025,2005,9,MCSP (MULE CREEK SP),3699,0,3699,1700,217.6,3837
4026,2005,9,KVSP (KERN VALLEY SP),1648,0,1648,2448,67.3,4366
4027,2005,9,ISP (IRONWOOD SP),4572,0,4572,2200,207.8,4653
4028,2005,9,HDSP (HIGH DESERT SP),4622,3,4625,2344,197.3,4752
4029,2005,9,FOL (FOLSOM SP) (MALE),3949,0,3949,2275,173.6,4049
4030,2005,9,DVI (DEUEL VOCATIONAL INSTITUTION),3852,10,3862,1787,216.1,3551
4031,2005,9,CTF (CORRECTIONAL TRAINING FAC),7039,0,7039,3281,214.5,7001
4032,2005,9,CVSP (CHUCKAWALLA VALLEY SP),3828,0,3828,1738,220.3,3860
4033,2005,9,SATF (CA SUBSTANCE ABUSE TREAT FAC),7278,5,7283,3324,219.1,7027
4034,2005,9,"SOL (CA SP, SOLANO)",6106,0,6106,2610,233.9,5660
4035,2005,9,SQ (SAN QUENTIN SP),5502,9,5511,3273,168.4,5681
4036,2005,9,"SAC (CA SP, SACRAMENTO)",3321,0,3321,1728,192.2,3244
4037,2005,9,"LAC (CA SP, LOS ANGELES COUNTY)",4629,0,4629,2200,210.4,4684
4038,2005,9,"COR (CA SP, CORCORAN)",5193,0,5193,3016,172.2,5134
4039,2005,9,CEN (CENTINELA SP),4891,0,4891,2208,221.5,5103
4040,2005,9,CAL (CALIPATRIA SP),4266,0,4266,2508,170.1,4268
4041,2005,9,"CRC (CAL REHAB CTR, MEN)",3009,906,3915,1814,215.8,3952
4042,2005,9,CMC (CA MEN'S COLONY),6524,3,6527,3884,168.0,6604
4043,2005,9,CMF (CA MEDICAL FAC),3151,0,3151,2315,136.1,3351
4044,2005,9,CIM (CA INSTITUTION FOR MEN),6567,16,6583,3078,213.9,6615
4045,2005,9,CCI (CA CORRECTIONAL INSTITUTION),5609,0,5609,2509,223.6,5558
4046,2005,9,CCC (CA CORRECTIONAL CENTER),6191,0,6191,3682,168.1,5750
4047,2005,9,ASP (AVENAL SP),7122,0,7122,2920,243.9,7028
4048,2005,10,VSP (VALLEY SP),3893,17,3910,1980,197.5,3686
4049,2005,10,CCWF (CENTRAL CA WOMEN'S FAC),3844,1,3845,2004,191.9,3490
4050,2005,10,"CRC (CAL REHAB CTR, WOMEN)",464,297,761,500,152.2,680
4051,2005,10,CIW (CA INSTITUTION FOR WOMEN),2305,5,2310,1346,171.6,2270
4052,2005,10,WSP (WASCO SP),6021,10,6031,2984,202.1,6066
4053,2005,10,SCC (SIERRA CONSERVATION CENTER),6164,0,6164,3606,170.9,6107
4054,2005,10,SVSP (SALINAS VALLEY SP),4055,0,4055,2224,182.3,4510
4055,2005,10,RJD (RJ DONOVAN CORRECTIONAL FAC),4671,0,4671,2200,212.3,4443
4056,2005,10,PVSP (PLEASANT VALLEY SP),4844,0,4844,2208,219.4,5028
4057,2005,10,PBSP (PELICAN BAY SP),3500,0,3500,2280,153.5,3582
4058,2005,10,NKSP (NORTH KERN SP),5316,4,5320,2692,197.6,5387
4059,2005,10,MCSP (MULE CREEK SP),3641,0,3641,1700,214.2,3837
4060,2005,10,KVSP (KERN VALLEY SP),2060,0,2060,2448,84.2,4366
4061,2005,10,ISP (IRONWOOD SP),4628,0,4628,2200,210.4,4653
4062,2005,10,HDSP (HIGH DESERT SP),4578,7,4585,2344,195.6,4752
4063,2005,10,FOL (FOLSOM SP) (MALE),4064,0,4064,2275,178.6,4049
4064,2005,10,DVI (DEUEL VOCATIONAL INSTITUTION),3844,16,3860,1787,216.0,3551
4065,2005,10,CTF (CORRECTIONAL TRAINING FAC),7087,0,7087,3281,216.0,7001
4066,2005,10,CVSP (CHUCKAWALLA VALLEY SP),3841,0,3841,1738,221.0,3860
4067,2005,10,SATF (CA SUBSTANCE ABUSE TREAT FAC),7136,4,7140,3324,214.8,7027
4068,2005,10,"SOL (CA SP, SOLANO)",6098,0,6098,2610,233.6,5660
4069,2005,10,SQ (SAN QUENTIN SP),5412,7,5419,3273,165.6,5681
4070,2005,10,"SAC (CA SP, SACRAMENTO)",3388,0,3388,1728,196.1,3244
4071,2005,10,"LAC (CA SP, LOS ANGELES COUNTY)",4472,0,4472,2200,203.3,4684
4072,2005,10,"COR (CA SP, CORCORAN)",5171,0,5171,3016,171.5,5134
4073,2005,10,CEN (CENTINELA SP),4823,0,4823,2208,218.4,5103
4074,2005,10,CAL (CALIPATRIA SP),4231,0,4231,2508,168.7,4268
4075,2005,10,"CRC (CAL REHAB CTR, MEN)",2975,924,3899,1814,214.9,3952
4076,2005,10,CMC (CA MEN'S COLONY),6477,3,6480,3884,166.8,6604
4077,2005,10,CMF (CA MEDICAL FAC),3139,0,3139,2315,135.6,3351
4078,2005,10,CIM (CA INSTITUTION FOR MEN),6708,14,6722,3078,218.4,6615
4079,2005,10,CCI (CA CORRECTIONAL INSTITUTION),5655,1,5656,2509,225.4,5558
4080,2005,10,CCC (CA CORRECTIONAL CENTER),6159,0,6159,3682,167.3,5750
4081,2005,10,ASP (AVENAL SP),7193,0,7193,2920,246.3,7028
4082,2005,11,VSP (VALLEY SP),3822,21,3843,2015,190.7,3686
4083,2005,11,CCWF (CENTRAL CA WOMEN'S FAC),3827,2,3829,2029,188.7,3490
4084,2005,11,"CRC (CAL REHAB CTR, WOMEN)",451,313,764,500,152.8,680
4085,2005,11,CIW (CA INSTITUTION FOR WOMEN),2417,3,2420,1346,179.8,2270
4086,2005,11,WSP (WASCO SP),5897,13,5910,3314,178.3,6066
4087,2005,11,SCC (SIERRA CONSERVATION CENTER),6165,0,6165,3606,171.0,6107
4088,2005,11,SVSP (SALINAS VALLEY SP),4188,0,4188,2914,143.7,4510
4089,2005,11,RJD (RJ DONOVAN CORRECTIONAL FAC),4520,0,4520,2308,195.8,4443
4090,2005,11,PVSP (PLEASANT VALLEY SP),4806,0,4806,2298,209.1,5028
4091,2005,11,PBSP (PELICAN BAY SP),3516,1,3517,2376,148.0,3582
4092,2005,11,NKSP (NORTH KERN SP),5301,6,5307,2918,181.9,5387
4093,2005,11,MCSP (MULE CREEK SP),3599,0,3599,1700,211.7,3837
4094,2005,11,KVSP (KERN VALLEY SP),2656,0,2656,2448,108.5,4366
4095,2005,11,ISP (IRONWOOD SP),4593,0,4593,2200,208.8,4653
4096,2005,11,HDSP (HIGH DESERT SP),4570,2,4572,2534,180.4,4752
4097,2005,11,FOL (FOLSOM SP) (MALE),4168,0,4168,2275,183.2,4049
4098,2005,11,DVI (DEUEL VOCATIONAL INSTITUTION),3886,6,3892,1787,217.8,3551
4099,2005,11,CTF (CORRECTIONAL TRAINING FAC),7070,1,7071,3319,213.0,7001
4100,2005,11,CVSP (CHUCKAWALLA VALLEY SP),3803,0,3803,1738,218.8,3860
4101,2005,11,SATF (CA SUBSTANCE ABUSE TREAT FAC),7065,3,7068,3591,196.8,7027
4102,2005,11,"SOL (CA SP, SOLANO)",6052,0,6052,2658,227.7,5660
4103,2005,11,SQ (SAN QUENTIN SP),5410,8,5418,3661,148.0,5681
4104,2005,11,"SAC (CA SP, SACRAMENTO)",3299,0,3299,1898,173.8,3244
4105,2005,11,"LAC (CA SP, LOS ANGELES COUNTY)",4321,0,4321,2200,196.4,4684
4106,2005,11,"COR (CA SP, CORCORAN)",5249,0,5249,3016,174.0,5134
4107,2005,11,CEN (CENTINELA SP),4893,0,4893,2316,211.3,5103
4108,2005,11,CAL (CALIPATRIA SP),4297,0,4297,2508,171.3,4268
4109,2005,11,"CRC (CAL REHAB CTR, MEN)",2997,930,3927,1814,216.5,3952
4110,2005,11,CMC (CA MEN'S COLONY),6538,1,6539,3884,168.4,6604
4111,2005,11,CMF (CA MEDICAL FAC),3197,0,3197,2315,138.1,3351
4112,2005,11,CIM (CA INSTITUTION FOR MEN),6505,7,6512,3078,211.6,6615
4113,2005,11,CCI (CA CORRECTIONAL INSTITUTION),5689,1,5690,3020,188.4,5558
4114,2005,11,CCC (CA CORRECTIONAL CENTER),6196,0,6196,3682,168.3,5750
4115,2005,11,ASP (AVENAL SP),7295,0,7295,3114,234.3,7028
4116,2005,12,VSP (VALLEY SP),3801,25,3826,2015,189.9,3686
4117,2005,12,CCWF (CENTRAL CA WOMEN'S FAC),3880,1,3881,2029,191.3,3490
4118,2005,12,"CRC (CAL REHAB CTR, WOMEN)",454,311,765,500,153.0,680
4119,2005,12,CIW (CA INSTITUTION FOR WOMEN),2463,6,2469,1346,183.4,2270
4120,2005,12,WSP (WASCO SP),6057,5,6062,3314,182.9,6066
4121,2005,12,SCC (SIERRA CONSERVATION CENTER),6165,1,6166,3606,171.0,6107
4122,2005,12,SVSP (SALINAS VALLEY SP),4332,0,4332,2914,148.7,4510
4123,2005,12,RJD (RJ DONOVAN CORRECTIONAL FAC),4470,0,4470,2308,193.7,4443
4124,2005,12,PVSP (PLEASANT VALLEY SP),4851,0,4851,2298,211.1,5028
4125,2005,12,PBSP (PELICAN BAY SP),3459,0,3459,2376,145.6,3582
4126,2005,12,NKSP (NORTH KERN SP),5373,9,5382,2918,184.4,5387
4127,2005,12,MCSP (MULE CREEK SP),3755,0,3755,1700,220.9,3837
4128,2005,12,KVSP (KERN VALLEY SP),3028,0,3028,2718,111.4,4636
4129,2005,12,ISP (IRONWOOD SP),4622,0,4622,2200,210.1,4653
4130,2005,12,HDSP (HIGH DESERT SP),4581,5,4586,2534,181.0,4752
4131,2005,12,FOL (FOLSOM SP) (MALE),4064,0,4064,2475,164.2,4249
4132,2005,12,DVI (DEUEL VOCATIONAL INSTITUTION),3861,14,3875,1787,216.8,3551
4133,2005,12,CTF (CORRECTIONAL TRAINING FAC),7075,0,7075,3319,213.2,7001
4134,2005,12,CVSP (CHUCKAWALLA VALLEY SP),4037,0,4037,1738,232.3,3860
4135,2005,12,SATF (CA SUBSTANCE ABUSE TREAT FAC),7197,2,7199,3591,200.5,7027
4136,2005,12,"SOL (CA SP, SOLANO)",6013,0,6013,2658,226.2,5660
4137,2005,12,SQ (SAN QUENTIN SP),5447,9,5456,3661,149.0,5681
4138,2005,12,"SAC (CA SP, SACRAMENTO)",3233,0,3233,1898,170.3,3244
4139,2005,12,"LAC (CA SP, LOS ANGELES COUNTY)",329,0,329,400,82.3,400
4140,2005,12,"LAC (CA SP, LOS ANGELES COUNTY)",4042,0,4042,2200,183.7,4684
4141,2005,12,"COR (CA SP, CORCORAN)",5277,0,5277,3016,175.0,5134
4142,2005,12,CEN (CENTINELA SP),4943,0,4943,2316,213.4,5103
4143,2005,12,CAL (CALIPATRIA SP),4299,0,4299,2508,171.4,4268
4144,2005,12,"CRC (CAL REHAB CTR, MEN)",3010,913,3923,1814,216.3,3952
4145,2005,12,CMC (CA MEN'S COLONY),6516,1,6517,3884,167.8,6604
4146,2005,12,CMF (CA MEDICAL FAC),3197,0,3197,2315,138.1,3351
4147,2005,12,CIM (CA INSTITUTION FOR MEN),6396,10,6406,3078,208.1,6615
4148,2005,12,CCI (CA CORRECTIONAL INSTITUTION),5712,0,5712,3020,189.1,5558
4149,2005,12,CCC (CA CORRECTIONAL CENTER),6127,0,6127,3682,166.4,5750
4150,2005,12,ASP (AVENAL SP),7172,0,7172,3114,230.3,7028
4151,2006,1,VSP (VALLEY SP),3781,22,3803,2015,188.7,3686
4152,2006,1,CCWF (CENTRAL CA WOMEN'S FAC),3782,0,3782,2029,186.4,3490
4153,2006,1,"CRC (CAL REHAB CTR, WOMEN)",439,315,754,500,150.8,680
4154,2006,1,CIW (CA INSTITUTION FOR WOMEN),2509,5,2514,1346,186.8,2270
4155,2006,1,WSP (WASCO SP),5897,5,5902,3314,178.1,6066
4156,2006,1,SCC (SIERRA CONSERVATION CENTER),6135,1,6136,3606,170.2,6107
4157,2006,1,SVSP (SALINAS VALLEY SP),4327,0,4327,2914,148.5,4510
4158,2006,1,RJD (RJ DONOVAN CORRECTIONAL FAC),4526,0,4526,2308,196.1,4443
4159,2006,1,PVSP (PLEASANT VALLEY SP),4900,0,4900,2298,213.2,5028
4160,2006,1,PBSP (PELICAN BAY SP),3462,0,3462,2376,145.7,3582
4161,2006,1,NKSP (NORTH KERN SP),5266,8,5274,2918,180.7,5387
4162,2006,1,MCSP (MULE CREEK SP),3866,0,3866,1700,227.4,3837
4163,2006,1,KVSP (KERN VALLEY SP),3348,0,3348,2448,136.8,4366
4164,2006,1,ISP (IRONWOOD SP),4667,0,4667,2200,212.1,4653
4165,2006,1,HDSP (HIGH DESERT SP),4647,3,4650,2534,183.5,4752
4166,2006,1,FOL (FOLSOM SP) (MALE),4085,0,4085,2475,165.1,4249
4167,2006,1,DVI (DEUEL VOCATIONAL INSTITUTION),3740,10,3750,1787,209.8,3551
4168,2006,1,CTF (CORRECTIONAL TRAINING FAC),7061,0,7061,3319,212.7,7001
4169,2006,1,CVSP (CHUCKAWALLA VALLEY SP),4083,0,4083,1738,234.9,3860
4170,2006,1,SATF (CA SUBSTANCE ABUSE TREAT FAC),7267,0,7267,3591,202.4,7027
4171,2006,1,"SOL (CA SP, SOLANO)",5914,0,5914,2658,222.5,5660
4172,2006,1,SQ (SAN QUENTIN SP),5481,13,5494,3661,150.1,5681
4173,2006,1,"SAC (CA SP, SACRAMENTO)",3288,0,3288,1898,173.2,3244
4174,2006,1,"LAC (CA SP, LOS ANGELES COUNTY)",609,0,609,400,152.3,400
4175,2006,1,"LAC (CA SP, LOS ANGELES COUNTY)",3737,0,3737,2200,169.9,4684
4176,2006,1,"COR (CA SP, CORCORAN)",5179,0,5179,3016,171.7,5134
4177,2006,1,CEN (CENTINELA SP),4919,0,4919,2316,212.4,5103
4178,2006,1,CAL (CALIPATRIA SP),4242,0,4242,2508,169.1,4268
4179,2006,1,"CRC (CAL REHAB CTR, MEN)",3048,876,3924,1814,216.3,3952
4180,2006,1,CMC (CA MEN'S COLONY),6499,1,6500,3884,167.4,6604
4181,2006,1,CMF (CA MEDICAL FAC),3158,0,3158,2315,136.4,3351
4182,2006,1,CIM (CA INSTITUTION FOR MEN),6492,14,6506,3078,211.4,6615
4183,2006,1,CCI (CA CORRECTIONAL INSTITUTION),5681,0,5681,3020,188.1,5558
4184,2006,1,CCC (CA CORRECTIONAL CENTER),6043,0,6043,3682,164.1,5750
4185,2006,1,ASP (AVENAL SP),7108,0,7108,3114,228.3,7028
4186,2006,2,VSP (VALLEY SP),3842,20,3862,2015,191.7,3686
4187,2006,2,CCWF (CENTRAL CA WOMEN'S FAC),3768,0,3768,2029,185.7,3490
4188,2006,2,"CRC (CAL REHAB CTR, WOMEN)",438,305,743,500,148.6,680
4189,2006,2,CIW (CA INSTITUTION FOR WOMEN),2566,8,2574,1346,191.2,2270
4190,2006,2,WSP (WASCO SP),5619,17,5636,3314,170.1,6066
4191,2006,2,SCC (SIERRA CONSERVATION CENTER),6229,1,6230,3606,172.8,6107
4192,2006,2,SVSP (SALINAS VALLEY SP),4375,0,4375,2914,150.1,4510
4193,2006,2,RJD (RJ DONOVAN CORRECTIONAL FAC),4587,0,4587,2308,198.7,4443
4194,2006,2,PVSP (PLEASANT VALLEY SP),4991,0,4991,2298,217.2,5028
4195,2006,2,PBSP (PELICAN BAY SP),3426,0,3426,2376,144.2,3582
4196,2006,2,NKSP (NORTH KERN SP),5387,9,5396,2918,184.9,5387
4197,2006,2,MCSP (MULE CREEK SP),3861,0,3861,1700,227.1,3837
4198,2006,2,KVSP (KERN VALLEY SP),3863,0,3863,2448,157.8,4366
4199,2006,2,ISP (IRONWOOD SP),4665,0,4665,2200,212.0,4653
4200,2006,2,HDSP (HIGH DESERT SP),4694,4,4698,2534,185.4,4752
4201,2006,2,FOL (FOLSOM SP) (MALE),4110,0,4110,2475,166.1,4249
4202,2006,2,DVI (DEUEL VOCATIONAL INSTITUTION),3728,14,3742,1787,209.4,3551
4203,2006,2,CTF (CORRECTIONAL TRAINING FAC),7057,0,7057,3319,212.6,7001
4204,2006,2,CVSP (CHUCKAWALLA VALLEY SP),4181,0,4181,1738,240.6,3860
4205,2006,2,SATF (CA SUBSTANCE ABUSE TREAT FAC),7216,0,7216,3591,200.9,7027
4206,2006,2,"SOL (CA SP, SOLANO)",5822,0,5822,2658,219.0,5660
4207,2006,2,SQ (SAN QUENTIN SP),5365,13,5378,3661,146.9,5681
4208,2006,2,"SAC (CA SP, SACRAMENTO)",3263,0,3263,1898,171.9,3244
4209,2006,2,"LAC (CA SP, LOS ANGELES COUNTY)",1201,0,1201,400,300.2,400
4210,2006,2,"LAC (CA SP, LOS ANGELES COUNTY)",3388,0,3388,2200,154.0,4684
4211,2006,2,"COR (CA SP, CORCORAN)",5223,3,5226,3016,173.3,5134
4212,2006,2,CEN (CENTINELA SP),4900,0,4900,2316,211.6,5103
4213,2006,2,CAL (CALIPATRIA SP),4212,0,4212,2508,167.9,4268
4214,2006,2,"CRC (CAL REHAB CTR, MEN)",3058,840,3898,1814,214.9,3952
4215,2006,2,CMC (CA MEN'S COLONY),6510,1,6511,3884,167.6,6604
4216,2006,2,CMF (CA MEDICAL FAC),3078,0,3078,2315,133.0,3351
4217,2006,2,CIM (CA INSTITUTION FOR MEN),6444,18,6462,3078,209.9,6615
4218,2006,2,CCI (CA CORRECTIONAL INSTITUTION),5707,0,5707,3020,189.0,5558
4219,2006,2,CCC (CA CORRECTIONAL CENTER),6054,0,6054,3682,164.4,5750
4220,2006,2,ASP (AVENAL SP),7288,0,7288,3114,234.0,7028
4221,2006,3,VSP (VALLEY SP),3901,17,3918,2015,194.4,3686
4222,2006,3,CCWF (CENTRAL CA WOMEN'S FAC),3900,1,3901,2029,192.3,3490
4223,2006,3,"CRC (CAL REHAB CTR, WOMEN)",408,308,716,500,143.2,680
4224,2006,3,CIW (CA INSTITUTION FOR WOMEN),2595,14,2609,1346,193.8,2270
4225,2006,3,WSP (WASCO SP),6048,23,6071,3314,183.2,6066
4226,2006,3,SCC (SIERRA CONSERVATION CENTER),6258,0,6258,3606,173.5,6107
4227,2006,3,SVSP (SALINAS VALLEY SP),4603,0,4603,2914,158.0,4510
4228,2006,3,RJD (RJ DONOVAN CORRECTIONAL FAC),4744,0,4744,2308,205.5,4443
4229,2006,3,PVSP (PLEASANT VALLEY SP),4960,0,4960,2298,215.8,5028
4230,2006,3,PBSP (PELICAN BAY SP),3411,0,3411,2376,143.6,3582
4231,2006,3,NKSP (NORTH KERN SP),5390,10,5400,2918,185.1,5387
4232,2006,3,MCSP (MULE CREEK SP),3886,0,3886,1700,228.6,3837
4233,2006,3,KVSP (KERN VALLEY SP),4160,0,4160,2448,169.9,4366
4234,2006,3,ISP (IRONWOOD SP),4722,0,4722,2200,214.6,4653
4235,2006,3,HDSP (HIGH DESERT SP),4711,10,4721,2534,186.3,4752
4236,2006,3,FOL (FOLSOM SP) (MALE),4085,0,4085,2475,165.1,4249
4237,2006,3,DVI (DEUEL VOCATIONAL INSTITUTION),3989,9,3998,1787,223.7,3551
4238,2006,3,CTF (CORRECTIONAL TRAINING FAC),7142,0,7142,3319,215.2,7001
4239,2006,3,CVSP (CHUCKAWALLA VALLEY SP),4274,0,4274,1738,245.9,3860
4240,2006,3,SATF (CA SUBSTANCE ABUSE TREAT FAC),7369,0,7369,3591,205.2,7027
4241,2006,3,"SOL (CA SP, SOLANO)",5800,0,5800,2658,218.2,5660
4242,2006,3,SQ (SAN QUENTIN SP),5177,14,5191,3661,141.8,5681
4243,2006,3,"SAC (CA SP, SACRAMENTO)",3282,0,3282,1898,172.9,3244
4244,2006,3,"LAC (CA SP, LOS ANGELES COUNTY)",1165,0,1165,400,291.2,400
4245,2006,3,"LAC (CA SP, LOS ANGELES COUNTY)",3372,0,3372,2200,153.3,4684
4246,2006,3,"COR (CA SP, CORCORAN)",5220,1,5221,3016,173.1,5134
4247,2006,3,CEN (CENTINELA SP),4962,0,4962,2316,214.2,5103
4248,2006,3,CAL (CALIPATRIA SP),4227,0,4227,2508,168.5,4268
4249,2006,3,"CRC (CAL REHAB CTR, MEN)",3062,829,3891,1814,214.5,3952
4250,2006,3,CMC (CA MEN'S COLONY),6558,0,6558,3884,168.8,6604
4251,2006,3,CMF (CA MEDICAL FAC),3097,0,3097,2315,133.8,3351
4252,2006,3,CIM (CA INSTITUTION FOR MEN),6346,18,6364,3078,206.8,6615
4253,2006,3,CCI (CA CORRECTIONAL INSTITUTION),5654,0,5654,3020,187.2,5558
4254,2006,3,CCC (CA CORRECTIONAL CENTER),6080,0,6080,3682,165.1,5750
4255,2006,3,ASP (AVENAL SP),7363,0,7363,3114,236.4,7028
4256,2006,4,VSP (VALLEY SP),3877,15,3892,2015,193.2,3686
4257,2006,4,CCWF (CENTRAL CA WOMEN'S FAC),3809,2,3811,2029,187.8,3490
4258,2006,4,"CRC (CAL REHAB CTR, WOMEN)",460,315,775,500,155.0,680
4259,2006,4,CIW (CA INSTITUTION FOR WOMEN),2605,13,2618,1346,194.5,2270
4260,2006,4,WSP (WASCO SP),6033,14,6047,3314,182.5,6066
4261,2006,4,SCC (SIERRA CONSERVATION CENTER),6221,0,6221,3606,172.5,6107
4262,2006,4,SVSP (SALINAS VALLEY SP),4588,0,4588,2914,157.4,4510
4263,2006,4,RJD (RJ DONOVAN CORRECTIONAL FAC),4695,0,4695,2308,203.4,4443
4264,2006,4,PVSP (PLEASANT VALLEY SP),5050,0,5050,2298,219.8,5028
4265,2006,4,PBSP (PELICAN BAY SP),3415,0,3415,2376,143.7,3582
4266,2006,4,NKSP (NORTH KERN SP),5295,9,5304,2918,181.8,5387
4267,2006,4,MCSP (MULE CREEK SP),3888,0,3888,1700,228.7,3837
4268,2006,4,KVSP (KERN VALLEY SP),4342,0,4342,2448,177.4,4366
4269,2006,4,ISP (IRONWOOD SP),4695,0,4695,2200,213.4,4653
4270,2006,4,HDSP (HIGH DESERT SP),4636,14,4650,2534,183.5,4752
4271,2006,4,FOL (FOLSOM SP) (MALE),4127,0,4127,2475,166.7,4249
4272,2006,4,DVI (DEUEL VOCATIONAL INSTITUTION),3884,10,3894,1787,217.9,3551
4273,2006,4,CTF (CORRECTIONAL TRAINING FAC),7104,0,7104,3319,214.0,7001
4274,2006,4,CVSP (CHUCKAWALLA VALLEY SP),4233,0,4233,1738,243.6,3860
4275,2006,4,SATF (CA SUBSTANCE ABUSE TREAT FAC),7362,0,7362,3591,205.0,7027
4276,2006,4,"SOL (CA SP, SOLANO)",5853,0,5853,2658,220.2,5660
4277,2006,4,SQ (SAN QUENTIN SP),5109,7,5116,3661,139.7,5681
4278,2006,4,"SAC (CA SP, SACRAMENTO)",3253,0,3253,1898,171.4,3244
4279,2006,4,"LAC (CA SP, LOS ANGELES COUNTY)",1136,0,1136,400,284.0,400
4280,2006,4,"LAC (CA SP, LOS ANGELES COUNTY)",3382,0,3382,2200,153.7,4684
4281,2006,4,"COR (CA SP, CORCORAN)",5229,2,5231,3016,173.4,5134
4282,2006,4,CEN (CENTINELA SP),4949,0,4949,2316,213.7,5103
4283,2006,4,CAL (CALIPATRIA SP),4269,0,4269,2508,170.2,4268
4284,2006,4,"CRC (CAL REHAB CTR, MEN)",3121,854,3975,1814,219.1,3952
4285,2006,4,CMC (CA MEN'S COLONY),6544,0,6544,3884,168.5,6604
4286,2006,4,CMF (CA MEDICAL FAC),3044,0,3044,2315,131.5,3351
4287,2006,4,CIM (CA INSTITUTION FOR MEN),6352,19,6371,3078,207.0,6615
4288,2006,4,CCI (CA CORRECTIONAL INSTITUTION),5453,0,5453,3020,180.6,5558
4289,2006,4,CCC (CA CORRECTIONAL CENTER),6089,0,6089,3682,165.4,5750
4290,2006,4,ASP (AVENAL SP),7353,0,7353,3114,236.1,7028
4291,2006,5,VSP (VALLEY SP),3803,26,3829,2015,190.0,3686
4292,2006,5,CCWF (CENTRAL CA WOMEN'S FAC),3803,2,3805,2029,187.5,3490
4293,2006,5,"CRC (CAL REHAB CTR, WOMEN)",446,309,755,500,151.0,680
4294,2006,5,CIW (CA INSTITUTION FOR WOMEN),2646,15,2661,1346,197.7,2270
4295,2006,5,WSP (WASCO SP),6103,12,6115,3314,184.5,6066
4296,2006,5,SCC (SIERRA CONSERVATION CENTER),6101,0,6101,3606,169.2,6107
4297,2006,5,SVSP (SALINAS VALLEY SP),4602,0,4602,2914,157.9,4510
4298,2006,5,RJD (RJ DONOVAN CORRECTIONAL FAC),4696,0,4696,2308,203.5,4443
4299,2006,5,PVSP (PLEASANT VALLEY SP),5007,0,5007,2298,217.9,5028
4300,2006,5,PBSP (PELICAN BAY SP),3427,0,3427,2376,144.2,3582
4301,2006,5,NKSP (NORTH KERN SP),5150,8,5158,2918,176.8,5387
4302,2006,5,MCSP (MULE CREEK SP),3928,0,3928,1700,231.1,3837
4303,2006,5,KVSP (KERN VALLEY SP),4411,0,4411,2448,180.2,4366
4304,2006,5,ISP (IRONWOOD SP),4648,0,4648,2200,211.3,4653
4305,2006,5,HDSP (HIGH DESERT SP),4692,3,4695,2534,185.3,4752
4306,2006,5,FOL (FOLSOM SP) (MALE),4132,0,4132,2475,166.9,4249
4307,2006,5,DVI (DEUEL VOCATIONAL INSTITUTION),3734,8,3742,1787,209.4,3551
4308,2006,5,CTF (CORRECTIONAL TRAINING FAC),7066,2,7068,3319,213.0,7001
4309,2006,5,CVSP (CHUCKAWALLA VALLEY SP),4242,0,4242,1738,244.1,3860
4310,2006,5,SATF (CA SUBSTANCE ABUSE TREAT FAC),7427,0,7427,3591,206.8,7027
4311,2006,5,"SOL (CA SP, SOLANO)",6045,0,6045,2658,227.4,5660
4312,2006,5,SQ (SAN QUENTIN SP),5031,4,5035,3661,137.5,5681
4313,2006,5,"SAC (CA SP, SACRAMENTO)",3220,0,3220,1898,169.7,3244
4314,2006,5,"LAC (CA SP, LOS ANGELES COUNTY)",1145,0,1145,400,286.2,400
4315,2006,5,"LAC (CA SP, LOS ANGELES COUNTY)",3330,0,3330,2200,151.4,4684
4316,2006,5,"COR (CA SP, CORCORAN)",5227,0,5227,3016,173.3,5134
4317,2006,5,CEN (CENTINELA SP),4886,0,4886,2316,211.0,5103
4318,2006,5,CAL (CALIPATRIA SP),4263,0,4263,2508,170.0,4268
4319,2006,5,"CRC (CAL REHAB CTR, MEN)",3054,894,3948,1814,217.6,3952
4320,2006,5,CMC (CA MEN'S COLONY),6519,0,6519,3884,167.8,6604
4321,2006,5,CMF (CA MEDICAL FAC),3057,0,3057,2315,132.1,3351
4322,2006,5,CIM (CA INSTITUTION FOR MEN),6526,15,6541,3078,212.5,6615
4323,2006,5,CCI (CA CORRECTIONAL INSTITUTION),5457,0,5457,3020,180.7,5558
4324,2006,5,CCC (CA CORRECTIONAL CENTER),6088,0,6088,3682,165.3,5750
4325,2006,5,ASP (AVENAL SP),7299,0,7299,3114,234.4,7028
4326,2006,6,VSP (VALLEY SP),3821,25,3846,2015,190.9,3686
4327,2006,6,SBRN (SAN BRUNO CO. JAIL),3,0,3,60,5.0,200
4328,2006,6,CCWF (CENTRAL CA WOMEN'S FAC),3871,8,3879,2029,191.2,3490
4329,2006,6,"CRC (CAL REHAB CTR, WOMEN)",414,317,731,500,146.2,680
4330,2006,6,CIW (CA INSTITUTION FOR WOMEN),2647,16,2663,1346,197.8,2270
4331,2006,6,WSP (WASCO SP),6185,20,6205,3314,187.2,6066
4332,2006,6,SCC (SIERRA CONSERVATION CENTER),6251,0,6251,3606,173.3,6107
4333,2006,6,SBRN (SAN BRUNO CO. JAIL),108,0,108,60,180.0,200
4334,2006,6,SVSP (SALINAS VALLEY SP),4515,0,4515,2914,154.9,4510
4335,2006,6,RJD (RJ DONOVAN CORRECTIONAL FAC),4678,0,4678,2308,202.7,4443
4336,2006,6,PVSP (PLEASANT VALLEY SP),5070,0,5070,2298,220.6,5028
4337,2006,6,PBSP (PELICAN BAY SP),3418,0,3418,2376,143.9,3582
4338,2006,6,NKSP (NORTH KERN SP),5353,5,5358,2918,183.6,5387
4339,2006,6,MCSP (MULE CREEK SP),3946,0,3946,1700,232.1,3837
4340,2006,6,KVSP (KERN VALLEY SP),4649,0,4649,2718,171.0,4636
4341,2006,6,ISP (IRONWOOD SP),4631,0,4631,2200,210.5,4653
4342,2006,6,HDSP (HIGH DESERT SP),4691,7,4698,2534,185.4,4752
4343,2006,6,FOL (FOLSOM SP) (MALE),4141,0,4141,2475,167.3,4249
4344,2006,6,DVI (DEUEL VOCATIONAL INSTITUTION),3875,12,3887,1787,217.5,3551
4345,2006,6,CTF (CORRECTIONAL TRAINING FAC),7114,0,7114,3319,214.3,7001
4346,2006,6,CVSP (CHUCKAWALLA VALLEY SP),4267,0,4267,1738,245.5,3860
4347,2006,6,SATF (CA SUBSTANCE ABUSE TREAT FAC),7511,1,7512,3591,209.2,7027
4348,2006,6,"SOL (CA SP, SOLANO)",6053,0,6053,2658,227.7,5660
4349,2006,6,SQ (SAN QUENTIN SP),5128,9,5137,3661,140.3,5681
4350,2006,6,"SAC (CA SP, SACRAMENTO)",3172,0,3172,1898,167.1,3244
4351,2006,6,"LAC (CA SP, LOS ANGELES COUNTY)",1157,0,1157,400,289.2,400
4352,2006,6,"LAC (CA SP, LOS ANGELES COUNTY)",3395,0,3395,2200,154.3,4684
4353,2006,6,"COR (CA SP, CORCORAN)",5321,1,5322,3016,176.5,5134
4354,2006,6,CEN (CENTINELA SP),4949,0,4949,2316,213.7,5103
4355,2006,6,CAL (CALIPATRIA SP),4246,0,4246,2508,169.3,4268
4356,2006,6,"CRC (CAL REHAB CTR, MEN)",3185,837,4022,1814,221.7,3952
4357,2006,6,CMC (CA MEN'S COLONY),6557,0,6557,3884,168.8,6604
4358,2006,6,CMF (CA MEDICAL FAC),3034,0,3034,2315,131.1,3351
4359,2006,6,CIM (CA INSTITUTION FOR MEN),6570,16,6586,3078,214.0,6615
4360,2006,6,CCI (CA CORRECTIONAL INSTITUTION),5508,0,5508,3020,182.4,5558
4361,2006,6,CCC (CA CORRECTIONAL CENTER),6139,0,6139,3682,166.7,5750
4362,2006,6,ASP (AVENAL SP),7491,0,7491,3114,240.6,7028
4363,2006,7,VSP (VALLEY SP),3809,29,3838,2015,190.5,3686
4364,2006,7,SBRN (SAN BRUNO CO. JAIL),3,0,3,60,5.0,200
4365,2006,7,CCWF (CENTRAL CA WOMEN'S FAC),3808,4,3812,2029,187.9,3490
4366,2006,7,"CRC (CAL REHAB CTR, WOMEN)",385,306,691,500,138.2,680
4367,2006,7,CIW (CA INSTITUTION FOR WOMEN),2621,11,2632,1346,195.5,2270
4368,2006,7,WSP (WASCO SP),5988,9,5997,3314,181.0,6066
4369,2006,7,SCC (SIERRA CONSERVATION CENTER),6079,0,6079,3606,168.6,6107
4370,2006,7,SBRN (SAN BRUNO CO. JAIL),143,0,143,60,238.3,200
4371,2006,7,SVSP (SALINAS VALLEY SP),4579,0,4579,2914,157.1,4510
4372,2006,7,RJD (RJ DONOVAN CORRECTIONAL FAC),4566,0,4566,2308,197.8,4443
4373,2006,7,PVSP (PLEASANT VALLEY SP),5041,0,5041,2298,219.4,5028
4374,2006,7,PBSP (PELICAN BAY SP),3455,0,3455,2376,145.4,3582
4375,2006,7,NKSP (NORTH KERN SP),5375,9,5384,2918,184.5,5387
4376,2006,7,MCSP (MULE CREEK SP),3938,0,3938,1700,231.6,3837
4377,2006,7,KVSP (KERN VALLEY SP),4737,1,4738,2718,174.3,4636
4378,2006,7,ISP (IRONWOOD SP),4597,0,4597,2200,209.0,4653
4379,2006,7,HDSP (HIGH DESERT SP),4729,2,4731,2534,186.7,4752
4380,2006,7,FOL (FOLSOM SP) (MALE),4075,0,4075,2475,164.6,4249
4381,2006,7,DVI (DEUEL VOCATIONAL INSTITUTION),3839,15,3854,1787,215.7,3551
4382,2006,7,CTF (CORRECTIONAL TRAINING FAC),7117,0,7117,3319,214.4,7001
4383,2006,7,CVSP (CHUCKAWALLA VALLEY SP),4224,0,4224,1738,243.0,3860
4384,2006,7,SATF (CA SUBSTANCE ABUSE TREAT FAC),7431,1,7432,3591,207.0,7027
4385,2006,7,"SOL (CA SP, SOLANO)",6063,0,6063,2658,228.1,5660
4386,2006,7,SQ (SAN QUENTIN SP),5038,10,5048,3661,137.9,5681
4387,2006,7,"SAC (CA SP, SACRAMENTO)",3117,0,3117,1898,164.2,3244
4388,2006,7,"LAC (CA SP, LOS ANGELES COUNTY)",4512,0,4512,2600,173.5,5084
4389,2006,7,"COR (CA SP, CORCORAN)",5314,0,5314,3016,176.2,5134
4390,2006,7,CEN (CENTINELA SP),4943,0,4943,2316,213.4,5103
4391,2006,7,CAL (CALIPATRIA SP),4271,0,4271,2508,170.3,4268
4392,2006,7,"CRC (CAL REHAB CTR, MEN)",3146,845,3991,1814,220.0,3952
4393,2006,7,CMC (CA MEN'S COLONY),6555,0,6555,3884,168.8,6604
4394,2006,7,CMF (CA MEDICAL FAC),3035,0,3035,2315,131.1,3351
4395,2006,7,CIM (CA INSTITUTION FOR MEN),6539,26,6565,3078,213.3,6615
4396,2006,7,CCI (CA CORRECTIONAL INSTITUTION),5413,0,5413,3020,179.2,5558
4397,2006,7,CCC (CA CORRECTIONAL CENTER),6117,0,6117,3682,166.1,5750
4398,2006,7,ASP (AVENAL SP),7523,0,7523,3114,241.6,7028
4399,2006,8,VSP (VALLEY SP),3789,11,3800,2015,188.6,3686
4400,2006,8,SBRN (SAN BRUNO CO. JAIL),12,0,12,60,20.0,200
4401,2006,8,CCWF (CENTRAL CA WOMEN'S FAC),3885,5,3890,2029,191.7,3490
4402,2006,8,"CRC (CAL REHAB CTR, WOMEN)",401,319,720,500,144.0,680
4403,2006,8,CIW (CA INSTITUTION FOR WOMEN),2673,12,2685,2372,113.2,4220
4404,2006,8,WSP (WASCO SP),5796,24,5820,3314,175.6,6066
4405,2006,8,SCC (SIERRA CONSERVATION CENTER),6157,1,6158,3606,170.8,6107
4406,2006,8,SBRN (SAN BRUNO CO. JAIL),161,0,161,60,268.3,200
4407,2006,8,SVSP (SALINAS VALLEY SP),4542,0,4542,2914,155.9,4510
4408,2006,8,RJD (RJ DONOVAN CORRECTIONAL FAC),4733,0,4733,2308,205.1,4443
4409,2006,8,PVSP (PLEASANT VALLEY SP),5042,0,5042,2298,219.4,5028
4410,2006,8,PBSP (PELICAN BAY SP),3457,1,3458,2376,145.5,3582
4411,2006,8,NKSP (NORTH KERN SP),5325,2,5327,2918,182.6,5387
4412,2006,8,MCSP (MULE CREEK SP),3941,0,3941,1700,231.8,3837
4413,2006,8,KVSP (KERN VALLEY SP),4667,1,4668,2718,171.7,4636
4414,2006,8,ISP (IRONWOOD SP),4659,0,4659,2200,211.8,4653
4415,2006,8,HDSP (HIGH DESERT SP),4768,5,4773,2534,188.4,4752
4416,2006,8,FOL (FOLSOM SP) (MALE),4083,0,4083,2475,165.0,4249
4417,2006,8,DVI (DEUEL VOCATIONAL INSTITUTION),3984,6,3990,1787,223.3,3551
4418,2006,8,CTF (CORRECTIONAL TRAINING FAC),7082,0,7082,3319,213.4,7001
4419,2006,8,CVSP (CHUCKAWALLA VALLEY SP),3882,0,3882,1738,223.4,3860
4420,2006,8,SATF (CA SUBSTANCE ABUSE TREAT FAC),7438,2,7440,3591,207.2,7027
4421,2006,8,"SOL (CA SP, SOLANO)",6107,0,6107,2658,229.8,5660
4422,2006,8,SQ (SAN QUENTIN SP),5101,6,5107,3661,139.5,5681
4423,2006,8,"SAC (CA SP, SACRAMENTO)",3157,0,3157,1898,166.3,3244
4424,2006,8,"LAC (CA SP, LOS ANGELES COUNTY)",4479,0,4479,2600,172.3,5084
4425,2006,8,"COR (CA SP, CORCORAN)",5345,1,5346,3016,177.3,5134
4426,2006,8,CEN (CENTINELA SP),4972,1,4973,2316,214.7,5103
4427,2006,8,CAL (CALIPATRIA SP),4210,0,4210,2508,167.9,4268
4428,2006,8,"CRC (CAL REHAB CTR, MEN)",3178,811,3989,1814,219.9,3952
4429,2006,8,CMC (CA MEN'S COLONY),6568,0,6568,3884,169.1,6604
4430,2006,8,CMF (CA MEDICAL FAC),3017,0,3017,2315,130.3,3351
4431,2006,8,CIM (CA INSTITUTION FOR MEN),6727,24,6751,3078,219.3,6615
4432,2006,8,CCI (CA CORRECTIONAL INSTITUTION),5728,0,5728,3020,189.7,5558
4433,2006,8,CCC (CA CORRECTIONAL CENTER),6169,0,6169,3682,167.5,5750
4434,2006,8,ASP (AVENAL SP),7507,0,7507,3114,241.1,7028
4435,2006,9,VSP (VALLEY SP),3842,16,3858,2015,191.5,3686
4436,2006,9,SBRN (SAN BRUNO CO. JAIL),2,0,2,60,3.3,200
4437,2006,9,CCWF (CENTRAL CA WOMEN'S FAC),3941,6,3947,2029,194.5,3490
4438,2006,9,"CRC (CAL REHAB CTR, WOMEN)",430,334,764,500,152.8,680
4439,2006,9,CIW (CA INSTITUTION FOR WOMEN),2651,8,2659,2372,112.1,4220
4440,2006,9,WSP (WASCO SP),5778,21,5799,3314,175.0,6066
4441,2006,9,SCC (SIERRA CONSERVATION CENTER),6226,1,6227,3606,172.7,6107
4442,2006,9,SBRN (SAN BRUNO CO. JAIL),158,0,158,60,263.3,200
4443,2006,9,SVSP (SALINAS VALLEY SP),4639,0,4639,2914,159.2,4510
4444,2006,9,RJD (RJ DONOVAN CORRECTIONAL FAC),4782,0,4782,2308,207.2,4443
4445,2006,9,PVSP (PLEASANT VALLEY SP),5123,0,5123,2298,222.9,5028
4446,2006,9,PBSP (PELICAN BAY SP),3462,1,3463,2376,145.7,3582
4447,2006,9,NKSP (NORTH KERN SP),5472,3,5475,2918,187.6,5387
4448,2006,9,MCSP (MULE CREEK SP),3962,0,3962,1700,233.1,3837
4449,2006,9,KVSP (KERN VALLEY SP),4800,1,4801,2718,176.6,4636
4450,2006,9,ISP (IRONWOOD SP),4636,0,4636,2200,210.7,4653
4451,2006,9,HDSP (HIGH DESERT SP),4755,8,4763,2534,188.0,4752
4452,2006,9,FOL (FOLSOM SP) (MALE),3953,0,3953,2475,159.7,4249
4453,2006,9,DVI (DEUEL VOCATIONAL INSTITUTION),3860,6,3866,1787,216.3,3551
4454,2006,9,CTF (CORRECTIONAL TRAINING FAC),7074,0,7074,3319,213.1,7001
4455,2006,9,CVSP (CHUCKAWALLA VALLEY SP),4042,0,4042,1738,232.6,3860
4456,2006,9,SATF (CA SUBSTANCE ABUSE TREAT FAC),7486,3,7489,3591,208.5,7027
4457,2006,9,"SOL (CA SP, SOLANO)",6063,0,6063,2658,228.1,5660
4458,2006,9,SQ (SAN QUENTIN SP),5188,6,5194,3661,141.9,5681
4459,2006,9,"SAC (CA SP, SACRAMENTO)",3153,0,3153,1898,166.1,3244
4460,2006,9,"LAC (CA SP, LOS ANGELES COUNTY)",4540,0,4540,2600,174.6,5084
4461,2006,9,"COR (CA SP, CORCORAN)",5396,1,5397,3016,178.9,5134
4462,2006,9,CEN (CENTINELA SP),4940,0,4940,2316,213.3,5103
4463,2006,9,CAL (CALIPATRIA SP),4282,0,4282,2508,170.7,4268
4464,2006,9,"CRC (CAL REHAB CTR, MEN)",3169,828,3997,1814,220.3,3952
4465,2006,9,CMC (CA MEN'S COLONY),6534,0,6534,3884,168.2,6604
4466,2006,9,CMF (CA MEDICAL FAC),3041,0,3041,2315,131.4,3351
4467,2006,9,CIM (CA INSTITUTION FOR MEN),6320,22,6342,3078,206.0,6615
4468,2006,9,CCI (CA CORRECTIONAL INSTITUTION),5829,0,5829,3476,167.7,5824
4469,2006,9,CCC (CA CORRECTIONAL CENTER),6169,0,6169,3682,167.5,5750
4470,2006,9,ASP (AVENAL SP),7497,0,7497,3114,240.8,7028
4471,2006,10,VSP (VALLEY SP),3865,13,3878,1980,195.9,3902
4472,2006,10,SBRN (SAN BRUNO CO. JAIL),2,0,2,60,3.3,60
4473,2006,10,CCWF (CENTRAL CA WOMEN'S FAC),3838,3,3841,2004,191.7,3943
4474,2006,10,"CRC (CAL REHAB CTR, WOMEN)",432,331,763,500,152.6,780
4475,2006,10,CIW (CA INSTITUTION FOR WOMEN),2624,8,2632,1346,195.5,2703
4476,2006,10,WSP (WASCO SP),5632,20,5652,2834,199.4,5717
4477,2006,10,SCC (SIERRA CONSERVATION CENTER),6192,0,6192,3736,165.7,6215
4478,2006,10,SBRN (SAN BRUNO CO. JAIL),147,0,147,60,245.0,60
4479,2006,10,SVSP (SALINAS VALLEY SP),4624,0,4624,1798,257.2,3176
4480,2006,10,RJD (RJ DONOVAN CORRECTIONAL FAC),4793,0,4793,2200,217.9,4756
4481,2006,10,PVSP (PLEASANT VALLEY SP),5120,0,5120,1808,283.2,4012
4482,2006,10,PBSP (PELICAN BAY SP),3474,0,3474,2252,154.3,3316
4483,2006,10,NKSP (NORTH KERN SP),5486,3,5489,2692,203.9,5401
4484,2006,10,MCSP (MULE CREEK SP),3951,0,3951,1700,232.4,3609
4485,2006,10,KVSP (KERN VALLEY SP),4782,1,4783,2625,182.2,4989
4486,2006,10,ISP (IRONWOOD SP),4721,0,4721,2200,214.6,4809
4487,2006,10,HDSP (HIGH DESERT SP),4674,6,4680,2444,191.5,4706
4488,2006,10,FOL (FOLSOM SP) (MALE),4030,0,4030,2236,180.2,4078
4489,2006,10,DVI (DEUEL VOCATIONAL INSTITUTION),3822,7,3829,2270,168.7,4455
4490,2006,10,CTF (CORRECTIONAL TRAINING FAC),7129,0,7129,3301,216.0,6527
4491,2006,10,CVSP (CHUCKAWALLA VALLEY SP),4224,0,4224,1738,243.0,4292
4492,2006,10,SATF (CA SUBSTANCE ABUSE TREAT FAC),7501,3,7504,3424,219.2,7593
4493,2006,10,"SOL (CA SP, SOLANO)",6002,0,6002,2610,230.0,6083
4494,2006,10,SQ (SAN QUENTIN SP),5276,13,5289,3109,170.1,5220
4495,2006,10,"SAC (CA SP, SACRAMENTO)",3102,0,3102,1532,202.5,2781
4496,2006,10,"LAC (CA SP, LOS ANGELES COUNTY)",4470,0,4470,2300,194.3,4418
4497,2006,10,"COR (CA SP, CORCORAN)",5449,1,5450,3116,174.9,5087
4498,2006,10,CEN (CENTINELA SP),4942,0,4942,4408,112.1,9504
4499,2006,10,CAL (CALIPATRIA SP),4262,0,4262,2308,184.7,4318
4500,2006,10,"CRC (CAL REHAB CTR, MEN)",3112,844,3956,1814,218.1,4000
4501,2006,10,CMC (CA MEN'S COLONY),6552,0,6552,3840,170.6,6574
4502,2006,10,CMF (CA MEDICAL FAC),3073,0,3073,2307,133.2,3316
4503,2006,10,CIM (CA INSTITUTION FOR MEN),6353,18,6371,3207,198.7,6464
4504,2006,10,CCI (CA CORRECTIONAL INSTITUTION),5816,2,5818,2985,194.9,6073
4505,2006,10,CCC (CA CORRECTIONAL CENTER),6114,0,6114,3882,157.5,6073
4506,2006,10,ASP (AVENAL SP),7651,0,7651,2920,262.0,7710
4507,2006,11,VSP (VALLEY SP),3817,8,3825,1980,193.2,3902
4508,2006,11,SBRN (SAN BRUNO CO. JAIL),2,0,2,60,3.3,60
4509,2006,11,CCWF (CENTRAL CA WOMEN'S FAC),3866,3,3869,2004,193.1,3943
4510,2006,11,"CRC (CAL REHAB CTR, WOMEN)",430,327,757,500,151.4,780
4511,2006,11,CIW (CA INSTITUTION FOR WOMEN),2662,8,2670,1346,198.4,2703
4512,2006,11,WSP (WASCO SP),5752,14,5766,2834,203.5,5717
4513,2006,11,SCC (SIERRA CONSERVATION CENTER),6217,1,6218,3736,166.4,6215
4514,2006,11,SBRN (SAN BRUNO CO. JAIL),121,0,121,60,201.7,60
4515,2006,11,SVSP (SALINAS VALLEY SP),4619,0,4619,1798,256.9,3176
4516,2006,11,RJD (RJ DONOVAN CORRECTIONAL FAC),4345,0,4345,2200,197.5,4756
4517,2006,11,PVSP (PLEASANT VALLEY SP),5066,0,5066,1808,280.2,4012
4518,2006,11,PBSP (PELICAN BAY SP),3490,0,3490,2252,155.0,3316
4519,2006,11,NKSP (NORTH KERN SP),5454,2,5456,2692,202.7,5401
4520,2006,11,MCSP (MULE CREEK SP),3998,0,3998,1700,235.2,3609
4521,2006,11,KVSP (KERN VALLEY SP),4843,1,4844,2625,184.5,4989
4522,2006,11,ISP (IRONWOOD SP),4751,0,4751,2200,216.0,4809
4523,2006,11,HDSP (HIGH DESERT SP),4638,2,4640,2444,189.9,4706
4524,2006,11,FOL (FOLSOM SP) (MALE),4027,0,4027,2236,180.1,4078
4525,2006,11,DVI (DEUEL VOCATIONAL INSTITUTION),3823,10,3833,2270,168.9,4455
4526,2006,11,CTF (CORRECTIONAL TRAINING FAC),7098,0,7098,3301,215.0,6527
4527,2006,11,CVSP (CHUCKAWALLA VALLEY SP),4150,0,4150,1738,238.8,4292
4528,2006,11,SATF (CA SUBSTANCE ABUSE TREAT FAC),7470,3,7473,3424,218.3,7593
4529,2006,11,"SOL (CA SP, SOLANO)",5960,0,5960,2610,228.4,6083
4530,2006,11,SQ (SAN QUENTIN SP),5214,5,5219,3109,167.9,5220
4531,2006,11,"SAC (CA SP, SACRAMENTO)",3116,0,3116,1532,203.4,2781
4532,2006,11,"LAC (CA SP, LOS ANGELES COUNTY)",4390,0,4390,2300,190.9,4418
4533,2006,11,"COR (CA SP, CORCORAN)",5432,0,5432,3116,174.3,5087
4534,2006,11,CEN (CENTINELA SP),4944,0,4944,2308,214.2,4956
4535,2006,11,CAL (CALIPATRIA SP),4191,0,4191,2308,181.6,4318
4536,2006,11,"CRC (CAL REHAB CTR, MEN)",3114,821,3935,1814,216.9,4000
4537,2006,11,CMC (CA MEN'S COLONY),6526,0,6526,3840,169.9,6574
4538,2006,11,CMF (CA MEDICAL FAC),3055,0,3055,2307,132.4,3316
4539,2006,11,CIM (CA INSTITUTION FOR MEN),6514,18,6532,3207,203.7,6464
4540,2006,11,CCI (CA CORRECTIONAL INSTITUTION),5829,1,5830,2757,211.5,5896
4541,2006,11,CCC (CA CORRECTIONAL CENTER),6165,0,6165,3883,158.8,6174
4542,2006,11,ASP (AVENAL SP),7649,0,7649,2920,262.0,7710
4543,2006,12,VSP (VALLEY SP),3840,8,3848,1980,194.3,3902
4544,2006,12,CCWF (CENTRAL CA WOMEN'S FAC),3861,3,3864,2004,192.8,3943
4545,2006,12,"CRC (CAL REHAB CTR, WOMEN)",418,323,741,500,148.2,780
4546,2006,12,CIW (CA INSTITUTION FOR WOMEN),2618,11,2629,1326,198.3,2687
4547,2006,12,WSP (WASCO SP),5767,18,5785,2834,204.1,5717
4548,2006,12,SCC (SIERRA CONSERVATION CENTER),6100,0,6100,3736,163.3,6215
4549,2006,12,SBRN (SAN BRUNO CO. JAIL),110,0,110,60,183.3,60
4550,2006,12,SVSP (SALINAS VALLEY SP),4601,0,4601,2298,200.2,4606
4551,2006,12,RJD (RJ DONOVAN CORRECTIONAL FAC),4234,0,4234,2200,192.5,4756
4552,2006,12,PVSP (PLEASANT VALLEY SP),5096,0,5096,2308,220.8,5112
4553,2006,12,PBSP (PELICAN BAY SP),3520,0,3520,2252,156.3,3316
4554,2006,12,NKSP (NORTH KERN SP),5447,7,5454,2692,202.6,5401
4555,2006,12,MCSP (MULE CREEK SP),3965,0,3965,1700,233.2,4009
4556,2006,12,KVSP (KERN VALLEY SP),4905,0,4905,2448,200.4,4946
4557,2006,12,ISP (IRONWOOD SP),4842,0,4842,2200,220.1,4809
4558,2006,12,HDSP (HIGH DESERT SP),4563,4,4567,2324,196.5,4706
4559,2006,12,FOL (FOLSOM SP) (MALE),4079,0,4079,2236,182.4,4078
4560,2006,12,DVI (DEUEL VOCATIONAL INSTITUTION),3972,11,3983,1787,222.9,3911
4561,2006,12,CTF (CORRECTIONAL TRAINING FAC),7054,1,7055,3301,213.7,7127
4562,2006,12,CVSP (CHUCKAWALLA VALLEY SP),4133,0,4133,1738,237.8,4292
4563,2006,12,SATF (CA SUBSTANCE ABUSE TREAT FAC),7439,4,7443,3424,217.4,7593
4564,2006,12,"SOL (CA SP, SOLANO)",6070,0,6070,2610,232.6,6083
4565,2006,12,SQ (SAN QUENTIN SP),5178,5,5183,3109,166.7,5220
4566,2006,12,"SAC (CA SP, SACRAMENTO)",3124,0,3124,1724,181.2,3253
4567,2006,12,"LAC (CA SP, LOS ANGELES COUNTY)",4359,0,4359,2300,189.5,4658
4568,2006,12,"COR (CA SP, CORCORAN)",5478,0,5478,3116,175.8,5450
4569,2006,12,CEN (CENTINELA SP),4986,0,4986,2308,216.0,4956
4570,2006,12,CAL (CALIPATRIA SP),4253,0,4253,2308,184.3,4318
4571,2006,12,"CRC (CAL REHAB CTR, MEN)",3202,804,4006,1814,220.8,4000
4572,2006,12,CMC (CA MEN'S COLONY),6509,0,6509,3840,169.5,6574
4573,2006,12,CMF (CA MEDICAL FAC),3022,0,3022,2307,131.0,3316
4574,2006,12,CIM (CA INSTITUTION FOR MEN),6462,18,6480,3207,202.1,6464
4575,2006,12,CCI (CA CORRECTIONAL INSTITUTION),5845,0,5845,2757,212.0,5896
4576,2006,12,CCC (CA CORRECTIONAL CENTER),6113,0,6113,3883,157.4,6174
4577,2006,12,ASP (AVENAL SP),7591,0,7591,2920,260.0,7710
4578,2007,1,VSP (VALLEY SP),3788,9,3797,1980,191.8,3902
4579,2007,1,SBRN (SAN BRUNO CO. JAIL),1,0,1,60,1.7,60
4580,2007,1,CCWF (CENTRAL CA WOMEN'S FAC),3884,2,3886,2004,193.9,3943
4581,2007,1,"CRC (CAL REHAB CTR, WOMEN)",398,305,703,500,140.6,780
4582,2007,1,CIW (CA INSTITUTION FOR WOMEN),2554,11,2565,1326,193.4,2687
4583,2007,1,WSP (WASCO SP),6023,6,6029,2834,212.7,5717
4584,2007,1,SCC (SIERRA CONSERVATION CENTER),6050,1,6051,3736,162.0,6215
4585,2007,1,SBRN (SAN BRUNO CO. JAIL),106,0,106,60,176.7,60
4586,2007,1,SVSP (SALINAS VALLEY SP),4558,0,4558,2298,198.3,4606
4587,2007,1,RJD (RJ DONOVAN CORRECTIONAL FAC),4646,0,4646,2200,211.2,4756
4588,2007,1,PVSP (PLEASANT VALLEY SP),5183,0,5183,2308,224.6,5112
4589,2007,1,PBSP (PELICAN BAY SP),3493,0,3493,2252,155.1,3316
4590,2007,1,NKSP (NORTH KERN SP),5426,4,5430,2692,201.7,5401
4591,2007,1,MCSP (MULE CREEK SP),3940,0,3940,1700,231.8,4009
4592,2007,1,KVSP (KERN VALLEY SP),4905,0,4905,2448,200.4,4946
4593,2007,1,ISP (IRONWOOD SP),4760,0,4760,2200,216.4,4809
4594,2007,1,HDSP (HIGH DESERT SP),4691,3,4694,2324,202.0,4706
4595,2007,1,FOL (FOLSOM SP) (MALE),4047,0,4047,2236,181.0,4078
4596,2007,1,DVI (DEUEL VOCATIONAL INSTITUTION),3880,21,3901,1787,218.3,3911
4597,2007,1,CTF (CORRECTIONAL TRAINING FAC),7062,0,7062,3301,213.9,7127
4598,2007,1,CVSP (CHUCKAWALLA VALLEY SP),4027,0,4027,1738,231.7,4292
4599,2007,1,SATF (CA SUBSTANCE ABUSE TREAT FAC),7461,3,7464,3424,218.0,7593
4600,2007,1,"SOL (CA SP, SOLANO)",6001,0,6001,2610,229.9,6083
4601,2007,1,SQ (SAN QUENTIN SP),5141,5,5146,3109,165.5,5220
4602,2007,1,"SAC (CA SP, SACRAMENTO)",3091,0,3091,1724,179.3,3253
4603,2007,1,"LAC (CA SP, LOS ANGELES COUNTY)",4358,0,4358,2300,189.5,4658
4604,2007,1,"COR (CA SP, CORCORAN)",5421,0,5421,3116,174.0,5450
4605,2007,1,CEN (CENTINELA SP),4963,0,4963,2308,215.0,4956
4606,2007,1,CAL (CALIPATRIA SP),4287,0,4287,2308,185.7,4318
4607,2007,1,"CRC (CAL REHAB CTR, MEN)",3067,820,3887,1814,214.3,4000
4608,2007,1,CMC (CA MEN'S COLONY),6489,0,6489,3840,169.0,6574
4609,2007,1,CMF (CA MEDICAL FAC),3040,0,3040,2307,131.8,3316
4610,2007,1,CIM (CA INSTITUTION FOR MEN),6407,12,6419,3207,200.2,6464
4611,2007,1,CCI (CA CORRECTIONAL INSTITUTION),5820,1,5821,2757,211.1,5896
4612,2007,1,CCC (CA CORRECTIONAL CENTER),5973,0,5973,3883,153.8,6174
4613,2007,1,ASP (AVENAL SP),7483,0,7483,2920,256.3,7710
4614,2007,2,VSP (VALLEY SP),3882,16,3898,1980,196.9,3902
4615,2007,2,CCWF (CENTRAL CA WOMEN'S FAC),3876,6,3882,2004,193.7,3943
4616,2007,2,"CRC (CAL REHAB CTR, WOMEN)",343,317,660,500,132.0,780
4617,2007,2,CIW (CA INSTITUTION FOR WOMEN),2595,6,2601,1326,196.2,2687
4618,2007,2,WSP (WASCO SP),6018,12,6030,2834,212.8,5717
4619,2007,2,SCC (SIERRA CONSERVATION CENTER),6301,0,6301,3736,168.7,6215
4620,2007,2,SBRN (SAN BRUNO CO. JAIL),81,0,81,60,135.0,60
4621,2007,2,SVSP (SALINAS VALLEY SP),4534,0,4534,2298,197.3,4606
4622,2007,2,RJD (RJ DONOVAN CORRECTIONAL FAC),4735,0,4735,2200,215.2,4756
4623,2007,2,PVSP (PLEASANT VALLEY SP),5235,0,5235,2308,226.8,5112
4624,2007,2,PBSP (PELICAN BAY SP),3493,0,3493,2252,155.1,3316
4625,2007,2,NKSP (NORTH KERN SP),5464,0,5464,2692,203.0,5401
4626,2007,2,MCSP (MULE CREEK SP),3913,0,3913,1700,230.2,4009
4627,2007,2,KVSP (KERN VALLEY SP),4949,0,4949,2448,202.2,4946
4628,2007,2,ISP (IRONWOOD SP),4727,0,4727,2200,214.9,4809
4629,2007,2,HDSP (HIGH DESERT SP),4584,2,4586,2324,197.3,4706
4630,2007,2,FOL (FOLSOM SP) (MALE),4040,0,4040,2236,180.7,4078
4631,2007,2,DVI (DEUEL VOCATIONAL INSTITUTION),3873,13,3886,1787,217.5,3911
4632,2007,2,CTF (CORRECTIONAL TRAINING FAC),6983,3,6986,3301,211.6,7127
4633,2007,2,CVSP (CHUCKAWALLA VALLEY SP),4149,0,4149,1738,238.7,4292
4634,2007,2,SATF (CA SUBSTANCE ABUSE TREAT FAC),7381,4,7385,3424,215.7,7593
4635,2007,2,"SOL (CA SP, SOLANO)",6057,0,6057,2610,232.1,6083
4636,2007,2,SQ (SAN QUENTIN SP),5188,7,5195,3109,167.1,5220
4637,2007,2,"SAC (CA SP, SACRAMENTO)",3147,0,3147,1724,182.5,3253
4638,2007,2,"LAC (CA SP, LOS ANGELES COUNTY)",4373,0,4373,2300,190.1,4658
4639,2007,2,"COR (CA SP, CORCORAN)",5356,1,5357,3116,171.9,5450
4640,2007,2,CEN (CENTINELA SP),4956,0,4956,2308,214.7,4956
4641,2007,2,CAL (CALIPATRIA SP),4214,0,4214,2308,182.6,4318
4642,2007,2,"CRC (CAL REHAB CTR, MEN)",3095,783,3878,1814,213.8,4000
4643,2007,2,CMC (CA MEN'S COLONY),6440,0,6440,3840,167.7,6574
4644,2007,2,CMF (CA MEDICAL FAC),3011,0,3011,2307,130.5,3316
4645,2007,2,CIM (CA INSTITUTION FOR MEN),6322,12,6334,3207,197.5,6464
4646,2007,2,CCI (CA CORRECTIONAL INSTITUTION),5793,3,5796,2757,210.2,5896
4647,2007,2,CCC (CA CORRECTIONAL CENTER),5949,0,5949,3883,153.2,6174
4648,2007,2,ASP (AVENAL SP),7512,0,7512,2920,257.3,7710
4649,2007,3,VSP (VALLEY SP),3849,22,3871,1980,195.5,3902
4650,2007,3,CCWF (CENTRAL CA WOMEN'S FAC),3943,4,3947,2004,197.0,3943
4651,2007,3,"CRC (CAL REHAB CTR, WOMEN)",240,294,534,500,106.8,780
4652,2007,3,CIW (CA INSTITUTION FOR WOMEN),2661,18,2679,1326,202.0,2687
4653,2007,3,WSP (WASCO SP),5929,12,5941,2834,209.6,5717
4654,2007,3,SCC (SIERRA CONSERVATION CENTER),6219,0,6219,3736,166.5,6215
4655,2007,3,SBRN (SAN BRUNO CO. JAIL),75,0,75,60,125.0,60
4656,2007,3,SVSP (SALINAS VALLEY SP),4740,0,4740,2298,206.3,4606
4657,2007,3,RJD (RJ DONOVAN CORRECTIONAL FAC),4731,0,4731,3302,143.3,5858
4658,2007,3,PVSP (PLEASANT VALLEY SP),5155,0,5155,2308,223.4,5112
4659,2007,3,PBSP (PELICAN BAY SP),3470,0,3470,2252,154.1,3316
4660,2007,3,NKSP (NORTH KERN SP),5444,7,5451,2692,202.5,5401
4661,2007,3,MCSP (MULE CREEK SP),3902,0,3902,1700,229.5,4009
4662,2007,3,KVSP (KERN VALLEY SP),4939,0,4939,2448,201.8,4946
4663,2007,3,ISP (IRONWOOD SP),4672,0,4672,2200,212.4,4809
4664,2007,3,HDSP (HIGH DESERT SP),4672,7,4679,2324,201.3,4706
4665,2007,3,FOL (FOLSOM SP) (MALE),4089,0,4089,2236,182.9,4078
4666,2007,3,DVI (DEUEL VOCATIONAL INSTITUTION),3865,7,3872,1787,216.7,3911
4667,2007,3,CTF (CORRECTIONAL TRAINING FAC),7074,0,7074,3301,214.3,7127
4668,2007,3,CVSP (CHUCKAWALLA VALLEY SP),3780,0,3780,1738,217.5,4292
4669,2007,3,SATF (CA SUBSTANCE ABUSE TREAT FAC),7340,2,7342,3424,214.4,7593
4670,2007,3,"SOL (CA SP, SOLANO)",6056,0,6056,2610,232.0,6083
4671,2007,3,SQ (SAN QUENTIN SP),5215,4,5219,3109,167.9,5220
4672,2007,3,"SAC (CA SP, SACRAMENTO)",3091,0,3091,1724,179.3,3253
4673,2007,3,"LAC (CA SP, LOS ANGELES COUNTY)",4683,0,4683,2300,203.6,4658
4674,2007,3,"COR (CA SP, CORCORAN)",5412,1,5413,3116,173.7,5450
4675,2007,3,CEN (CENTINELA SP),4914,0,4914,2308,212.9,4956
4676,2007,3,CAL (CALIPATRIA SP),4161,0,4161,2308,180.3,4318
4677,2007,3,"CRC (CAL REHAB CTR, MEN)",3236,776,4012,1814,221.2,4000
4678,2007,3,CMC (CA MEN'S COLONY),6511,0,6511,3840,169.6,6574
4679,2007,3,CMF (CA MEDICAL FAC),3037,0,3037,2307,131.6,3316
4680,2007,3,CIM (CA INSTITUTION FOR MEN),6492,13,6505,3207,202.8,6464
4681,2007,3,CCI (CA CORRECTIONAL INSTITUTION),5875,4,5879,2757,213.2,5896
4682,2007,3,CCC (CA CORRECTIONAL CENTER),5974,0,5974,3883,153.9,6174
4683,2007,3,ASP (AVENAL SP),7619,0,7619,2920,260.9,7710
4684,2007,4,VSP (VALLEY SP),3856,13,3869,1980,195.4,3902
4685,2007,4,CCWF (CENTRAL CA WOMEN'S FAC),4095,3,4098,2004,204.5,3943
4686,2007,4,"CRC (CAL REHAB CTR, WOMEN)",222,284,506,500,101.2,780
4687,2007,4,CIW (CA INSTITUTION FOR WOMEN),2496,17,2513,1326,189.5,2687
4688,2007,4,WSP (WASCO SP),5894,13,5907,2834,208.4,5717
4689,2007,4,SCC (SIERRA CONSERVATION CENTER),6129,0,6129,3736,164.1,6215
4690,2007,4,SBRN (SAN BRUNO CO. JAIL),55,0,55,60,91.7,60
4691,2007,4,SVSP (SALINAS VALLEY SP),4750,0,4750,2298,206.7,4606
4692,2007,4,RJD (RJ DONOVAN CORRECTIONAL FAC),4662,0,4662,3302,141.2,5858
4693,2007,4,PVSP (PLEASANT VALLEY SP),5204,0,5204,2308,225.5,5112
4694,2007,4,PBSP (PELICAN BAY SP),3436,0,3436,2252,152.6,3316
4695,2007,4,NKSP (NORTH KERN SP),5388,6,5394,2692,200.4,5401
4696,2007,4,MCSP (MULE CREEK SP),3777,0,3777,1700,222.2,4009
4697,2007,4,KVSP (KERN VALLEY SP),5000,0,5000,2448,204.2,4946
4698,2007,4,ISP (IRONWOOD SP),4676,0,4676,2200,212.5,4809
4699,2007,4,HDSP (HIGH DESERT SP),4619,4,4623,2324,198.9,4706
4700,2007,4,FOL (FOLSOM SP) (MALE),4049,1,4050,2236,181.1,4078
4701,2007,4,DVI (DEUEL VOCATIONAL INSTITUTION),3755,11,3766,1787,210.7,3911
4702,2007,4,CTF (CORRECTIONAL TRAINING FAC),7153,0,7153,3301,216.7,7127
4703,2007,4,CVSP (CHUCKAWALLA VALLEY SP),4050,0,4050,1738,233.0,4292
4704,2007,4,SATF (CA SUBSTANCE ABUSE TREAT FAC),7351,2,7353,3424,214.7,7593
4705,2007,4,"SOL (CA SP, SOLANO)",6017,0,6017,2610,230.5,6083
4706,2007,4,SQ (SAN QUENTIN SP),5303,9,5312,3109,170.9,5220
4707,2007,4,"SAC (CA SP, SACRAMENTO)",3166,0,3166,1724,183.6,3253
4708,2007,4,"LAC (CA SP, LOS ANGELES COUNTY)",4691,0,4691,2300,204.0,4658
4709,2007,4,"COR (CA SP, CORCORAN)",5423,1,5424,3116,174.1,5450
4710,2007,4,CEN (CENTINELA SP),4861,0,4861,2308,210.6,4956
4711,2007,4,CAL (CALIPATRIA SP),4205,0,4205,2308,182.2,4318
4712,2007,4,"CRC (CAL REHAB CTR, MEN)",3236,747,3983,1814,219.6,4000
4713,2007,4,CMC (CA MEN'S COLONY),6524,0,6524,3840,169.9,6574
4714,2007,4,CMF (CA MEDICAL FAC),2996,0,2996,2307,129.9,3316
4715,2007,4,CIM (CA INSTITUTION FOR MEN),6517,17,6534,3207,203.7,6464
4716,2007,4,CCI (CA CORRECTIONAL INSTITUTION),5835,2,5837,2757,211.7,5896
4717,2007,4,CCC (CA CORRECTIONAL CENTER),6073,0,6073,3883,156.4,6174
4718,2007,4,ASP (AVENAL SP),7610,0,7610,2920,260.6,7710
4719,2007,5,VSP (VALLEY SP),4167,11,4178,1980,211.0,3902
4720,2007,5,CCWF (CENTRAL CA WOMEN'S FAC),4184,4,4188,2004,209.0,3943
4721,2007,5,"CRC (CAL REHAB CTR, WOMEN)",93,269,362,500,72.4,780
4722,2007,5,CIW (CA INSTITUTION FOR WOMEN),2359,12,2371,1326,178.8,2687
4723,2007,5,WSP (WASCO SP),5923,11,5934,2834,209.4,5717
4724,2007,5,SCC (SIERRA CONSERVATION CENTER),6200,0,6200,3736,166.0,6215
4725,2007,5,SBRN (SAN BRUNO CO. JAIL),42,0,42,60,70.0,60
4726,2007,5,SVSP (SALINAS VALLEY SP),4763,1,4764,2298,207.3,4606
4727,2007,5,RJD (RJ DONOVAN CORRECTIONAL FAC),4637,0,4637,3302,140.4,5858
4728,2007,5,PVSP (PLEASANT VALLEY SP),5196,0,5196,2308,225.1,5112
4729,2007,5,PBSP (PELICAN BAY SP),3454,0,3454,2252,153.4,3316
4730,2007,5,NKSP (NORTH KERN SP),5472,4,5476,2692,203.4,5401
4731,2007,5,MCSP (MULE CREEK SP),3787,0,3787,1700,222.8,4009
4732,2007,5,KVSP (KERN VALLEY SP),4874,0,4874,2448,199.1,4946
4733,2007,5,ISP (IRONWOOD SP),4838,0,4838,2200,219.9,4809
4734,2007,5,HDSP (HIGH DESERT SP),4676,10,4686,2324,201.6,4706
4735,2007,5,FOL (FOLSOM SP) (MALE),4121,0,4121,2236,184.3,4078
4736,2007,5,DVI (DEUEL VOCATIONAL INSTITUTION),3818,5,3823,1787,213.9,3911
4737,2007,5,CTF (CORRECTIONAL TRAINING FAC),6998,0,6998,3301,212.0,7127
4738,2007,5,CVSP (CHUCKAWALLA VALLEY SP),4153,0,4153,1738,239.0,4292
4739,2007,5,SATF (CA SUBSTANCE ABUSE TREAT FAC),7328,2,7330,3424,214.1,7593
4740,2007,5,"SOL (CA SP, SOLANO)",6013,0,6013,2610,230.4,6083
4741,2007,5,SQ (SAN QUENTIN SP),5296,7,5303,3109,170.6,5220
4742,2007,5,"SAC (CA SP, SACRAMENTO)",3192,0,3192,1724,185.2,3253
4743,2007,5,"LAC (CA SP, LOS ANGELES COUNTY)",4722,0,4722,2300,205.3,4658
4744,2007,5,"COR (CA SP, CORCORAN)",5521,1,5522,3116,177.2,5450
4745,2007,5,CEN (CENTINELA SP),4728,0,4728,2308,204.9,4956
4746,2007,5,CAL (CALIPATRIA SP),4234,0,4234,2308,183.4,4318
4747,2007,5,"CRC (CAL REHAB CTR, MEN)",3247,731,3978,1814,219.3,4000
4748,2007,5,CMC (CA MEN'S COLONY),6540,0,6540,3840,170.3,6574
4749,2007,5,CMF (CA MEDICAL FAC),3030,0,3030,2307,131.3,3316
4750,2007,5,CIM (CA INSTITUTION FOR MEN),6391,17,6408,3207,199.8,6464
4751,2007,5,CCI (CA CORRECTIONAL INSTITUTION),5929,1,5930,2757,215.1,5896
4752,2007,5,CCC (CA CORRECTIONAL CENTER),6220,0,6220,3883,160.2,6174
4753,2007,5,ASP (AVENAL SP),7617,0,7617,2920,260.9,7710
4754,2007,6,VSP (VALLEY SP),4266,15,4281,1980,216.2,3902
4755,2007,6,CCWF (CENTRAL CA WOMEN'S FAC),4289,6,4295,2004,214.3,3943
4756,2007,6,"CRC (CAL REHAB CTR, WOMEN)",5,2,7,500,1.4,780
4757,2007,6,CIW (CA INSTITUTION FOR WOMEN),2279,258,2537,1326,191.3,2687
4758,2007,6,WSP (WASCO SP),5956,15,5971,2834,210.7,5717
4759,2007,6,SCC (SIERRA CONSERVATION CENTER),5972,0,5972,3736,159.9,6215
4760,2007,6,SBRN (SAN BRUNO CO. JAIL),35,0,35,60,58.3,60
4761,2007,6,SVSP (SALINAS VALLEY SP),4676,1,4677,2298,203.5,4606
4762,2007,6,RJD (RJ DONOVAN CORRECTIONAL FAC),4715,0,4715,3302,142.8,5858
4763,2007,6,PVSP (PLEASANT VALLEY SP),5330,0,5330,2308,230.9,5112
4764,2007,6,PBSP (PELICAN BAY SP),3464,0,3464,2252,153.8,3316
4765,2007,6,NKSP (NORTH KERN SP),5433,7,5440,2692,202.1,5401
4766,2007,6,MCSP (MULE CREEK SP),3783,0,3783,1700,222.5,4009
4767,2007,6,KVSP (KERN VALLEY SP),4948,0,4948,2448,202.1,4946
4768,2007,6,ISP (IRONWOOD SP),4738,0,4738,2200,215.4,4809
4769,2007,6,HDSP (HIGH DESERT SP),4695,9,4704,2324,202.4,4706
4770,2007,6,FOL (FOLSOM SP) (MALE),4128,0,4128,2236,184.6,4078
4771,2007,6,DVI (DEUEL VOCATIONAL INSTITUTION),3982,3,3985,1787,223.0,3911
4772,2007,6,CTF (CORRECTIONAL TRAINING FAC),6985,0,6985,3301,211.6,7127
4773,2007,6,CVSP (CHUCKAWALLA VALLEY SP),3991,0,3991,1738,229.6,4292
4774,2007,6,SATF (CA SUBSTANCE ABUSE TREAT FAC),7320,4,7324,3424,213.9,7593
4775,2007,6,"SOL (CA SP, SOLANO)",6083,0,6083,2610,233.1,6083
4776,2007,6,SQ (SAN QUENTIN SP),5244,7,5251,3109,168.9,5220
4777,2007,6,"SAC (CA SP, SACRAMENTO)",3219,0,3219,1724,186.7,3253
4778,2007,6,"LAC (CA SP, LOS ANGELES COUNTY)",4838,0,4838,2300,210.3,4658
4779,2007,6,"COR (CA SP, CORCORAN)",5584,2,5586,3116,179.3,5450
4780,2007,6,CEN (CENTINELA SP),4838,0,4838,2308,209.6,4956
4781,2007,6,CAL (CALIPATRIA SP),4171,0,4171,2308,180.7,4318
4782,2007,6,"CRC (CAL REHAB CTR, MEN)",3265,729,3994,1814,220.2,4000
4783,2007,6,CMC (CA MEN'S COLONY),6567,0,6567,3840,171.0,6574
4784,2007,6,CMF (CA MEDICAL FAC),3051,0,3051,2307,132.2,3316
4785,2007,6,CIM (CA INSTITUTION FOR MEN),6310,22,6332,3207,197.4,6464
4786,2007,6,CCI (CA CORRECTIONAL INSTITUTION),5885,1,5886,2757,213.5,5896
4787,2007,6,CCC (CA CORRECTIONAL CENTER),6130,0,6130,3883,157.9,6174
4788,2007,6,ASP (AVENAL SP),7661,0,7661,2920,262.4,7710
4789,2007,7,VSP (VALLEY SP),4312,10,4322,1980,218.3,3902
4790,2007,7,CCWF (CENTRAL CA WOMEN'S FAC),4287,4,4291,2006,213.9,3945
4791,2007,7,CIW (CA INSTITUTION FOR WOMEN),2213,268,2481,1356,183.0,2717
4792,2007,7,WSP (WASCO SP),6071,7,6078,2884,210.7,5888
4793,2007,7,SCC (SIERRA CONSERVATION CENTER),5912,0,5912,3736,158.2,6215
4794,2007,7,SVSP (SALINAS VALLEY SP),4461,1,4462,2298,194.2,4606
4795,2007,7,RJD (RJ DONOVAN CORRECTIONAL FAC),4657,1,4658,3302,141.1,5858
4796,2007,7,PVSP (PLEASANT VALLEY SP),5350,0,5350,2308,231.8,5112
4797,2007,7,PBSP (PELICAN BAY SP),3442,0,3442,2252,152.8,3316
4798,2007,7,NKSP (NORTH KERN SP),5443,7,5450,2692,202.5,5401
4799,2007,7,MCSP (MULE CREEK SP),3773,0,3773,1700,221.9,4009
4800,2007,7,KVSP (KERN VALLEY SP),5003,0,5003,2448,204.4,4946
4801,2007,7,ISP (IRONWOOD SP),4754,0,4754,2200,216.1,4809
4802,2007,7,HDSP (HIGH DESERT SP),4696,8,4704,2324,202.4,4706
4803,2007,7,FOL (FOLSOM SP) (MALE),4151,0,4151,2236,185.6,4078
4804,2007,7,DVI (DEUEL VOCATIONAL INSTITUTION),3837,4,3841,1787,214.9,3911
4805,2007,7,CTF (CORRECTIONAL TRAINING FAC),6962,0,6962,3301,210.9,7127
4806,2007,7,CVSP (CHUCKAWALLA VALLEY SP),3688,0,3688,1738,212.2,4292
4807,2007,7,SATF (CA SUBSTANCE ABUSE TREAT FAC),7468,3,7471,3424,218.2,7593
4808,2007,7,"SOL (CA SP, SOLANO)",6141,0,6141,2610,235.3,6083
4809,2007,7,SQ (SAN QUENTIN SP),5187,7,5194,3109,167.1,5220
4810,2007,7,"SAC (CA SP, SACRAMENTO)",3274,0,3274,1724,189.9,3253
4811,2007,7,"LAC (CA SP, LOS ANGELES COUNTY)",4976,0,4976,2300,216.3,4658
4812,2007,7,"COR (CA SP, CORCORAN)",5728,2,5730,3116,183.9,5450
4813,2007,7,CEN (CENTINELA SP),5079,0,5079,2308,220.1,4956
4814,2007,7,CAL (CALIPATRIA SP),4164,0,4164,2308,180.4,4318
4815,2007,7,"CRC (CAL REHAB CTR, MEN)",3281,690,3971,1814,218.9,4000
4816,2007,7,CMC (CA MEN'S COLONY),6559,0,6559,3840,170.8,6574
4817,2007,7,CMF (CA MEDICAL FAC),3087,0,3087,2307,133.8,3316
4818,2007,7,CIM (CA INSTITUTION FOR MEN),6218,23,6241,3207,194.6,6464
4819,2007,7,CCI (CA CORRECTIONAL INSTITUTION),5827,0,5827,2757,211.4,5896
4820,2007,7,CCC (CA CORRECTIONAL CENTER),6120,0,6120,3883,157.6,6174
4821,2007,7,ASP (AVENAL SP),7611,0,7611,2920,260.7,7710
4822,2007,8,VSP (VALLEY SP),4245,4,4249,1980,214.6,3902
4823,2007,8,CCWF (CENTRAL CA WOMEN'S FAC),4243,3,4246,2006,211.7,3945
4824,2007,8,CIW (CA INSTITUTION FOR WOMEN),2264,277,2541,1356,187.4,2717
4825,2007,8,WSP (WASCO SP),6206,11,6217,2884,215.6,5888
4826,2007,8,SCC (SIERRA CONSERVATION CENTER),6122,0,6122,3736,163.9,6215
4827,2007,8,SVSP (SALINAS VALLEY SP),4352,1,4353,2298,189.4,4606
4828,2007,8,RJD (RJ DONOVAN CORRECTIONAL FAC),4723,0,4723,3302,143.0,5858
4829,2007,8,PVSP (PLEASANT VALLEY SP),5369,0,5369,2308,232.6,5112
4830,2007,8,PBSP (PELICAN BAY SP),3497,0,3497,2252,155.3,3316
4831,2007,8,NKSP (NORTH KERN SP),5475,6,5481,2692,203.6,5401
4832,2007,8,MCSP (MULE CREEK SP),3680,0,3680,1700,216.5,4009
4833,2007,8,KVSP (KERN VALLEY SP),5023,0,5023,2448,205.2,4946
4834,2007,8,ISP (IRONWOOD SP),4759,0,4759,2200,216.3,4809
4835,2007,8,HDSP (HIGH DESERT SP),4630,11,4641,2324,199.7,4706
4836,2007,8,FOL (FOLSOM SP) (MALE),4100,0,4100,2236,183.4,4078
4837,2007,8,DVI (DEUEL VOCATIONAL INSTITUTION),3959,5,3964,1787,221.8,3911
4838,2007,8,CTF (CORRECTIONAL TRAINING FAC),6867,0,6867,3301,208.0,7127
4839,2007,8,CVSP (CHUCKAWALLA VALLEY SP),3161,0,3161,1738,181.9,4292
4840,2007,8,SATF (CA SUBSTANCE ABUSE TREAT FAC),7489,4,7493,3424,218.8,7593
4841,2007,8,"SOL (CA SP, SOLANO)",6115,0,6115,2610,234.3,6083
4842,2007,8,SQ (SAN QUENTIN SP),5334,5,5339,3109,171.7,5220
4843,2007,8,"SAC (CA SP, SACRAMENTO)",3292,0,3292,1724,191.0,3253
4844,2007,8,"LAC (CA SP, LOS ANGELES COUNTY)",5017,0,5017,2300,218.1,4658
4845,2007,8,"COR (CA SP, CORCORAN)",5734,1,5735,3116,184.1,5450
4846,2007,8,CEN (CENTINELA SP),5100,0,5100,2308,221.0,4956
4847,2007,8,CAL (CALIPATRIA SP),4222,0,4222,2308,182.9,4318
4848,2007,8,"CRC (CAL REHAB CTR, MEN)",3273,701,3974,1814,219.1,4000
4849,2007,8,CMC (CA MEN'S COLONY),6556,1,6557,3840,170.8,6574
4850,2007,8,CMF (CA MEDICAL FAC),3110,0,3110,2307,134.8,3316
4851,2007,8,CIM (CA INSTITUTION FOR MEN),6378,19,6397,3207,199.5,6464
4852,2007,8,CCI (CA CORRECTIONAL INSTITUTION),5835,1,5836,2757,211.7,5896
4853,2007,8,CCC (CA CORRECTIONAL CENTER),6103,0,6103,3883,157.2,6174
4854,2007,8,ASP (AVENAL SP),7620,0,7620,2920,261.0,7710
4855,2007,9,VSP (VALLEY SP),4244,8,4252,1980,214.7,4238
4856,2007,9,CCWF (CENTRAL CA WOMEN'S FAC),4223,7,4230,2004,211.1,4222
4857,2007,9,CIW (CA INSTITUTION FOR WOMEN),2242,269,2511,1325,189.5,2669
4858,2007,9,WSP (WASCO SP),5989,23,6012,2984,201.5,6110
4859,2007,9,SCC (SIERRA CONSERVATION CENTER),6075,0,6075,3736,162.6,6215
4860,2007,9,SVSP (SALINAS VALLEY SP),4194,1,4195,2372,176.9,4440
4861,2007,9,RJD (RJ DONOVAN CORRECTIONAL FAC),4725,0,4725,2200,214.8,4687
4862,2007,9,PVSP (PLEASANT VALLEY SP),5320,0,5320,2308,230.5,5372
4863,2007,9,PBSP (PELICAN BAY SP),3512,0,3512,2341,150.0,3632
4864,2007,9,NKSP (NORTH KERN SP),5527,7,5534,2692,205.6,5473
4865,2007,9,MCSP (MULE CREEK SP),3685,0,3685,1594,231.2,3757
4866,2007,9,KVSP (KERN VALLEY SP),5046,0,5046,2448,206.1,5026
4867,2007,9,ISP (IRONWOOD SP),4717,0,4717,2200,214.4,4709
4868,2007,9,HDSP (HIGH DESERT SP),4504,13,4517,2324,194.4,4706
4869,2007,9,FOL (FOLSOM SP) (MALE),4059,0,4059,2236,181.5,4078
4870,2007,9,DVI (DEUEL VOCATIONAL INSTITUTION),3812,10,3822,1627,234.9,3811
4871,2007,9,CTF (CORRECTIONAL TRAINING FAC),6712,0,6712,3301,203.3,6677
4872,2007,9,CVSP (CHUCKAWALLA VALLEY SP),3152,0,3152,1348,233.8,3272
4873,2007,9,SATF (CA SUBSTANCE ABUSE TREAT FAC),7454,5,7459,3424,217.8,7593
4874,2007,9,"SOL (CA SP, SOLANO)",6025,0,6025,2610,230.8,6083
4875,2007,9,SQ (SAN QUENTIN SP),5167,4,5171,3108,166.4,5274
4876,2007,9,"SAC (CA SP, SACRAMENTO)",3260,0,3260,1788,182.3,3323
4877,2007,9,"LAC (CA SP, LOS ANGELES COUNTY)",4976,0,4976,2300,216.3,4976
4878,2007,9,"COR (CA SP, CORCORAN)",5685,0,5685,3116,182.4,5630
4879,2007,9,CEN (CENTINELA SP),5110,0,5110,2308,221.4,5136
4880,2007,9,CAL (CALIPATRIA SP),4180,0,4180,2308,181.1,4218
4881,2007,9,"CRC (CAL REHAB CTR, MEN)",3617,654,4271,2314,184.6,4400
4882,2007,9,CMC (CA MEN'S COLONY),6512,0,6512,3840,169.6,6558
4883,2007,9,CMF (CA MEDICAL FAC),3047,0,3047,2179,139.8,3078
4884,2007,9,CIM (CA INSTITUTION FOR MEN),6225,32,6257,3033,206.3,6563
4885,2007,9,CCI (CA CORRECTIONAL INSTITUTION),5805,1,5806,2785,208.5,5938
4886,2007,9,CCC (CA CORRECTIONAL CENTER),6093,0,6093,3883,156.9,6024
4887,2007,9,ASP (AVENAL SP),7582,0,7582,2920,259.7,7710
4888,2007,10,VSP (VALLEY SP),4175,5,4180,1980,211.1,4238
4889,2007,10,CCWF (CENTRAL CA WOMEN'S FAC),4198,6,4204,2004,209.8,4222
4890,2007,10,CIW (CA INSTITUTION FOR WOMEN),2293,282,2575,1325,194.3,2669
4891,2007,10,WSP (WASCO SP),5924,15,5939,2984,199.0,5899
4892,2007,10,SCC (SIERRA CONSERVATION CENTER),6222,0,6222,3736,166.5,6215
4893,2007,10,SVSP (SALINAS VALLEY SP),4093,0,4093,2372,172.6,4320
4894,2007,10,RJD (RJ DONOVAN CORRECTIONAL FAC),4708,0,4708,2200,214.0,4796
4895,2007,10,PVSP (PLEASANT VALLEY SP),5364,0,5364,2308,232.4,5372
4896,2007,10,PBSP (PELICAN BAY SP),3484,0,3484,2341,148.8,3638
4897,2007,10,NKSP (NORTH KERN SP),5418,9,5427,2692,201.6,5473
4898,2007,10,MCSP (MULE CREEK SP),3664,0,3664,1594,229.9,3757
4899,2007,10,KVSP (KERN VALLEY SP),5029,0,5029,2448,205.4,5026
4900,2007,10,ISP (IRONWOOD SP),4703,0,4703,2200,213.8,4709
4901,2007,10,HDSP (HIGH DESERT SP),4459,9,4468,2324,192.3,4586
4902,2007,10,FOL (FOLSOM SP) (MALE),4096,0,4096,2236,183.2,4078
4903,2007,10,DVI (DEUEL VOCATIONAL INSTITUTION),3819,4,3823,1627,235.0,3811
4904,2007,10,CTF (CORRECTIONAL TRAINING FAC),6651,0,6651,3301,201.5,6647
4905,2007,10,CVSP (CHUCKAWALLA VALLEY SP),3158,0,3158,1348,234.3,3272
4906,2007,10,SATF (CA SUBSTANCE ABUSE TREAT FAC),7470,8,7478,3424,218.4,7593
4907,2007,10,"SOL (CA SP, SOLANO)",6078,0,6078,2610,232.9,6083
4908,2007,10,SQ (SAN QUENTIN SP),5287,6,5293,3108,170.3,5274
4909,2007,10,"SAC (CA SP, SACRAMENTO)",3251,0,3251,1788,181.8,3323
4910,2007,10,"LAC (CA SP, LOS ANGELES COUNTY)",5030,0,5030,2300,218.7,4976
4911,2007,10,"COR (CA SP, CORCORAN)",5673,0,5673,3116,182.1,5630
4912,2007,10,CEN (CENTINELA SP),4970,0,4970,2308,215.3,5136
4913,2007,10,CAL (CALIPATRIA SP),4186,0,4186,2308,181.4,4218
4914,2007,10,"CRC (CAL REHAB CTR, MEN)",4010,664,4674,2314,202.0,4800
4915,2007,10,CMC (CA MEN'S COLONY),6566,0,6566,3840,171.0,6558
4916,2007,10,CMF (CA MEDICAL FAC),3048,0,3048,2179,139.9,3078
4917,2007,10,CIM (CA INSTITUTION FOR MEN),6294,21,6315,3033,208.2,6613
4918,2007,10,CCI (CA CORRECTIONAL INSTITUTION),5849,1,5850,2785,210.1,5938
4919,2007,10,CCC (CA CORRECTIONAL CENTER),5954,0,5954,3883,153.3,6024
4920,2007,10,ASP (AVENAL SP),7449,0,7449,2920,255.1,7466
4921,2007,11,VSP (VALLEY SP),4149,3,4152,1980,209.7,4238
4922,2007,11,CCWF (CENTRAL CA WOMEN'S FAC),4101,4,4105,2004,204.8,4222
4923,2007,11,CIW (CA INSTITUTION FOR WOMEN),2395,266,2661,1325,200.8,2669
4924,2007,11,WSP (WASCO SP),5922,16,5938,2984,199.0,5899
4925,2007,11,SCC (SIERRA CONSERVATION CENTER),6336,0,6336,3736,169.6,6215
4926,2007,11,SVSP (SALINAS VALLEY SP),4024,0,4024,2372,169.6,4320
4927,2007,11,RJD (RJ DONOVAN CORRECTIONAL FAC),4691,0,4691,2200,213.2,4796
4928,2007,11,PVSP (PLEASANT VALLEY SP),5337,0,5337,2308,231.2,5372
4929,2007,11,PBSP (PELICAN BAY SP),3460,0,3460,2341,147.8,3638
4930,2007,11,NKSP (NORTH KERN SP),5257,5,5262,2692,195.5,5473
4931,2007,11,MCSP (MULE CREEK SP),3660,0,3660,1594,229.6,3757
4932,2007,11,KVSP (KERN VALLEY SP),4929,0,4929,2448,201.3,5026
4933,2007,11,ISP (IRONWOOD SP),4767,0,4767,2200,216.7,4709
4934,2007,11,HDSP (HIGH DESERT SP),4162,9,4171,2324,179.5,4586
4935,2007,11,FOL (FOLSOM SP) (MALE),4073,0,4073,2236,182.2,4078
4936,2007,11,DVI (DEUEL VOCATIONAL INSTITUTION),3795,10,3805,1627,233.9,3811
4937,2007,11,CTF (CORRECTIONAL TRAINING FAC),6488,0,6488,3301,196.5,6647
4938,2007,11,CVSP (CHUCKAWALLA VALLEY SP),3171,0,3171,1348,235.2,3272
4939,2007,11,SATF (CA SUBSTANCE ABUSE TREAT FAC),7424,4,7428,3424,216.9,7593
4940,2007,11,"SOL (CA SP, SOLANO)",6116,0,6116,2610,234.3,6083
4941,2007,11,SQ (SAN QUENTIN SP),5433,11,5444,3108,175.2,5274
4942,2007,11,"SAC (CA SP, SACRAMENTO)",3126,0,3126,1788,174.8,3323
4943,2007,11,"LAC (CA SP, LOS ANGELES COUNTY)",4939,0,4939,2300,214.7,4976
4944,2007,11,"COR (CA SP, CORCORAN)",5735,0,5735,3116,184.1,5630
4945,2007,11,CEN (CENTINELA SP),5057,0,5057,2308,219.1,5136
4946,2007,11,CAL (CALIPATRIA SP),4206,0,4206,2308,182.2,4218
4947,2007,11,"CRC (CAL REHAB CTR, MEN)",4079,668,4747,2314,205.1,4800
4948,2007,11,CMC (CA MEN'S COLONY),6550,0,6550,3840,170.6,6558
4949,2007,11,CMF (CA MEDICAL FAC),3045,0,3045,2179,139.7,3078
4950,2007,11,CIM (CA INSTITUTION FOR MEN),6265,9,6274,3033,206.9,6613
4951,2007,11,CCI (CA CORRECTIONAL INSTITUTION),5633,2,5635,2785,202.3,5938
4952,2007,11,CCC (CA CORRECTIONAL CENTER),6004,0,6004,3883,154.6,6024
4953,2007,11,ASP (AVENAL SP),7384,0,7384,2920,252.9,7466
4954,2007,12,VSP (VALLEY SP),4052,11,4063,1980,205.2,4238
4955,2007,12,CCWF (CENTRAL CA WOMEN'S FAC),4031,4,4035,2004,201.3,4142
4956,2007,12,CIW (CA INSTITUTION FOR WOMEN),2312,248,2560,1325,193.2,2669
4957,2007,12,WSP (WASCO SP),5948,12,5960,2984,199.7,5899
4958,2007,12,SCC (SIERRA CONSERVATION CENTER),6205,0,6205,3736,166.1,6215
4959,2007,12,SVSP (SALINAS VALLEY SP),4074,0,4074,2372,171.8,4100
4960,2007,12,RJD (RJ DONOVAN CORRECTIONAL FAC),4672,1,4673,2200,212.4,4796
4961,2007,12,PVSP (PLEASANT VALLEY SP),5294,0,5294,2308,229.4,5372
4962,2007,12,PBSP (PELICAN BAY SP),3434,0,3434,2341,146.7,3598
4963,2007,12,NKSP (NORTH KERN SP),5501,6,5507,2692,204.6,5473
4964,2007,12,MCSP (MULE CREEK SP),3599,0,3599,1594,225.8,3757
4965,2007,12,KVSP (KERN VALLEY SP),4929,0,4929,2448,201.3,4966
4966,2007,12,ISP (IRONWOOD SP),4743,0,4743,2200,215.6,4709
4967,2007,12,HDSP (HIGH DESERT SP),4227,6,4233,2324,182.1,4586
4968,2007,12,FOL (FOLSOM SP) (MALE),4095,0,4095,2236,183.1,4078
4969,2007,12,DVI (DEUEL VOCATIONAL INSTITUTION),3631,8,3639,1627,223.7,3811
4970,2007,12,CTF (CORRECTIONAL TRAINING FAC),6566,0,6566,3301,198.9,6513
4971,2007,12,CVSP (CHUCKAWALLA VALLEY SP),3110,0,3110,1348,230.7,3272
4972,2007,12,SATF (CA SUBSTANCE ABUSE TREAT FAC),7425,7,7432,3424,217.1,7593
4973,2007,12,"SOL (CA SP, SOLANO)",6087,0,6087,2610,233.2,6083
4974,2007,12,SQ (SAN QUENTIN SP),5163,11,5174,3108,166.5,5274
4975,2007,12,"SAC (CA SP, SACRAMENTO)",3101,0,3101,1788,173.4,3253
4976,2007,12,"LAC (CA SP, LOS ANGELES COUNTY)",5024,0,5024,2300,218.4,4946
4977,2007,12,"COR (CA SP, CORCORAN)",5685,0,5685,3116,182.4,5630
4978,2007,12,CEN (CENTINELA SP),5111,0,5111,2308,221.4,5136
4979,2007,12,CAL (CALIPATRIA SP),4200,0,4200,2308,182.0,4218
4980,2007,12,"CRC (CAL REHAB CTR, MEN)",3952,652,4604,2314,199.0,4800
4981,2007,12,CMC (CA MEN'S COLONY),6565,0,6565,3840,171.0,6558
4982,2007,12,CMF (CA MEDICAL FAC),3032,0,3032,2179,139.1,3078
4983,2007,12,CIM (CA INSTITUTION FOR MEN),6094,13,6107,3033,201.4,6413
4984,2007,12,CCI (CA CORRECTIONAL INSTITUTION),5478,8,5486,2785,197.0,5748
4985,2007,12,CCC (CA CORRECTIONAL CENTER),5954,0,5954,3883,153.3,6024
4986,2007,12,ASP (AVENAL SP),7363,0,7363,2920,252.2,7466
4987,2008,1,VSP (VALLEY SP),4032,7,4039,1980,204.0,4158
4988,2008,1,CCWF (CENTRAL CA WOMEN'S FAC),4052,3,4055,2004,202.3,4086
4989,2008,1,CIW (CA INSTITUTION FOR WOMEN),2294,244,2538,1325,191.5,2549
4990,2008,1,WSP (WASCO SP),6012,12,6024,2984,201.9,5899
4991,2008,1,SCC (SIERRA CONSERVATION CENTER),6135,0,6135,3736,164.2,6215
4992,2008,1,SVSP (SALINAS VALLEY SP),4086,0,4086,2372,172.3,4100
4993,2008,1,RJD (RJ DONOVAN CORRECTIONAL FAC),4529,0,4529,2200,205.9,4606
4994,2008,1,PVSP (PLEASANT VALLEY SP),5306,0,5306,2308,229.9,5372
4995,2008,1,PBSP (PELICAN BAY SP),3411,0,3411,2341,145.7,3598
4996,2008,1,NKSP (NORTH KERN SP),5492,4,5496,2692,204.2,5454
4997,2008,1,MCSP (MULE CREEK SP),3661,0,3661,1594,229.7,3714
4998,2008,1,KVSP (KERN VALLEY SP),4907,0,4907,2448,200.4,4966
4999,2008,1,ISP (IRONWOOD SP),4635,0,4635,2200,210.7,4709
5000,2008,1,HDSP (HIGH DESERT SP),4225,2,4227,2324,181.9,4536
5001,2008,1,FOL (FOLSOM SP) (MALE),4102,0,4102,2236,183.5,4078
5002,2008,1,DVI (DEUEL VOCATIONAL INSTITUTION),3694,18,3712,1627,228.1,3787
5003,2008,1,CTF (CORRECTIONAL TRAINING FAC),6510,0,6510,3301,197.2,6513
5004,2008,1,CVSP (CHUCKAWALLA VALLEY SP),3108,0,3108,1348,230.6,3222
5005,2008,1,SATF (CA SUBSTANCE ABUSE TREAT FAC),7314,3,7317,3424,213.7,7473
5006,2008,1,"SOL (CA SP, SOLANO)",5859,0,5859,2610,224.5,5858
5007,2008,1,SQ (SAN QUENTIN SP),5248,6,5254,3108,169.0,5274
5008,2008,1,"SAC (CA SP, SACRAMENTO)",3152,0,3152,1788,176.3,3234
5009,2008,1,"LAC (CA SP, LOS ANGELES COUNTY)",4847,0,4847,2300,210.7,4946
5010,2008,1,"COR (CA SP, CORCORAN)",5705,1,5706,3116,183.1,5744
5011,2008,1,CEN (CENTINELA SP),5010,0,5010,2308,217.1,5136
5012,2008,1,CAL (CALIPATRIA SP),4213,0,4213,2308,182.5,4218
5013,2008,1,"CRC (CAL REHAB CTR, MEN)",4069,669,4738,2314,204.8,4800
5014,2008,1,CMC (CA MEN'S COLONY),6524,0,6524,3840,169.9,6518
5015,2008,1,CMF (CA MEDICAL FAC),3024,0,3024,2179,138.8,3078
5016,2008,1,CIM (CA INSTITUTION FOR MEN),5992,20,6012,3033,198.2,6234
5017,2008,1,CCI (CA CORRECTIONAL INSTITUTION),5421,0,5421,2785,194.6,5620
5018,2008,1,CCC (CA CORRECTIONAL CENTER),5937,0,5937,3883,152.9,6024
5019,2008,1,ASP (AVENAL SP),7300,0,7300,2920,250.0,7366
5020,2008,2,VSP (VALLEY SP),3920,9,3929,1980,198.4,4158
5021,2008,2,CCWF (CENTRAL CA WOMEN'S FAC),4060,5,4065,2004,202.8,4086
5022,2008,2,CIW (CA INSTITUTION FOR WOMEN),2275,227,2502,1325,188.8,2549
5023,2008,2,WSP (WASCO SP),6051,9,6060,2984,203.1,5899
5024,2008,2,SCC (SIERRA CONSERVATION CENTER),6063,0,6063,3736,162.3,6067
5025,2008,2,SVSP (SALINAS VALLEY SP),4097,0,4097,2372,172.7,4100
5026,2008,2,RJD (RJ DONOVAN CORRECTIONAL FAC),4563,0,4563,2200,207.4,4606
5027,2008,2,PVSP (PLEASANT VALLEY SP),5249,0,5249,2308,227.4,5192
5028,2008,2,PBSP (PELICAN BAY SP),3418,0,3418,2341,146.0,3598
5029,2008,2,NKSP (NORTH KERN SP),5532,5,5537,2692,205.7,5454
5030,2008,2,MCSP (MULE CREEK SP),3673,0,3673,1594,230.4,3714
5031,2008,2,KVSP (KERN VALLEY SP),4861,0,4861,2448,198.6,4846
5032,2008,2,ISP (IRONWOOD SP),4576,0,4576,2200,208.0,4709
5033,2008,2,HDSP (HIGH DESERT SP),4244,5,4249,2324,182.8,4536
5034,2008,2,FOL (FOLSOM SP) (MALE),4083,0,4083,2236,182.6,4078
5035,2008,2,DVI (DEUEL VOCATIONAL INSTITUTION),3875,10,3885,1627,238.8,3787
5036,2008,2,CTF (CORRECTIONAL TRAINING FAC),6420,0,6420,3301,194.5,6513
5037,2008,2,CVSP (CHUCKAWALLA VALLEY SP),3160,0,3160,1348,234.4,3222
5038,2008,2,SATF (CA SUBSTANCE ABUSE TREAT FAC),7261,4,7265,3424,212.2,7473
5039,2008,2,"SOL (CA SP, SOLANO)",5710,0,5710,2610,218.8,5714
5040,2008,2,SQ (SAN QUENTIN SP),5382,18,5400,3108,173.7,5274
5041,2008,2,"SAC (CA SP, SACRAMENTO)",3165,0,3165,1788,177.0,3234
5042,2008,2,"LAC (CA SP, LOS ANGELES COUNTY)",5020,0,5020,2300,218.3,4946
5043,2008,2,"COR (CA SP, CORCORAN)",5572,1,5573,3116,178.9,5623
5044,2008,2,CEN (CENTINELA SP),5124,0,5124,2308,222.0,5136
5045,2008,2,CAL (CALIPATRIA SP),4104,0,4104,2308,177.8,4218
5046,2008,2,"CRC (CAL REHAB CTR, MEN)",3949,648,4597,2314,198.7,4604
5047,2008,2,CMC (CA MEN'S COLONY),6458,0,6458,3840,168.2,6518
5048,2008,2,CMF (CA MEDICAL FAC),3032,0,3032,2179,139.1,3078
5049,2008,2,CIM (CA INSTITUTION FOR MEN),5825,24,5849,3033,192.8,6130
5050,2008,2,CCI (CA CORRECTIONAL INSTITUTION),4882,0,4882,2785,175.3,5620
5051,2008,2,CCC (CA CORRECTIONAL CENTER),5957,0,5957,3883,153.4,6024
5052,2008,2,ASP (AVENAL SP),7302,0,7302,2920,250.1,7222
5053,2008,3,VSP (VALLEY SP),3918,15,3933,1980,198.6,4158
5054,2008,3,CCWF (CENTRAL CA WOMEN'S FAC),4058,3,4061,2004,202.6,4086
5055,2008,3,CIW (CA INSTITUTION FOR WOMEN),2342,230,2572,1325,194.1,2549
5056,2008,3,WSP (WASCO SP),5964,14,5978,2984,200.3,5878
5057,2008,3,SCC (SIERRA CONSERVATION CENTER),6023,0,6023,3736,161.2,6046
5058,2008,3,SVSP (SALINAS VALLEY SP),4122,0,4122,2372,173.8,4100
5059,2008,3,RJD (RJ DONOVAN CORRECTIONAL FAC),4610,0,4610,2200,209.5,4588
5060,2008,3,PVSP (PLEASANT VALLEY SP),5183,0,5183,2308,224.6,5192
5061,2008,3,PBSP (PELICAN BAY SP),3382,0,3382,2341,144.5,3598
5062,2008,3,NKSP (NORTH KERN SP),5436,5,5441,2692,202.1,5454
5063,2008,3,MCSP (MULE CREEK SP),3671,0,3671,1594,230.3,3714
5064,2008,3,KVSP (KERN VALLEY SP),4734,0,4734,2448,193.4,4846
5065,2008,3,ISP (IRONWOOD SP),4595,0,4595,2200,208.9,4565
5066,2008,3,HDSP (HIGH DESERT SP),4370,11,4381,2324,188.5,4536
5067,2008,3,FOL (FOLSOM SP) (MALE),4101,0,4101,2236,183.4,4078
5068,2008,3,DVI (DEUEL VOCATIONAL INSTITUTION),3813,6,3819,1627,234.7,3787
5069,2008,3,CTF (CORRECTIONAL TRAINING FAC),6397,0,6397,3301,193.8,6499
5070,2008,3,CVSP (CHUCKAWALLA VALLEY SP),3058,0,3058,1348,226.9,3222
5071,2008,3,SATF (CA SUBSTANCE ABUSE TREAT FAC),7179,6,7185,3424,209.8,7473
5072,2008,3,"SOL (CA SP, SOLANO)",5604,0,5604,2610,214.7,5570
5073,2008,3,SQ (SAN QUENTIN SP),5219,4,5223,3108,168.1,5274
5074,2008,3,"SAC (CA SP, SACRAMENTO)",3183,0,3183,1788,178.0,3234
5075,2008,3,"LAC (CA SP, LOS ANGELES COUNTY)",5010,0,5010,2300,217.8,4946
5076,2008,3,"COR (CA SP, CORCORAN)",5592,0,5592,3116,179.5,5623
5077,2008,3,CEN (CENTINELA SP),5085,0,5085,2308,220.3,5136
5078,2008,3,CAL (CALIPATRIA SP),4245,0,4245,2308,183.9,4218
5079,2008,3,"CRC (CAL REHAB CTR, MEN)",3872,655,4527,2314,195.6,4604
5080,2008,3,CMC (CA MEN'S COLONY),6505,0,6505,3840,169.4,6518
5081,2008,3,CMF (CA MEDICAL FAC),3049,0,3049,2179,139.9,3078
5082,2008,3,CIM (CA INSTITUTION FOR MEN),5898,27,5925,3033,195.4,6130
5083,2008,3,CCI (CA CORRECTIONAL INSTITUTION),4615,1,4616,2785,165.7,5620
5084,2008,3,CCC (CA CORRECTIONAL CENTER),5849,0,5849,3883,150.6,6024
5085,2008,3,ASP (AVENAL SP),7192,0,7192,2920,246.3,7222
5086,2008,4,VSP (VALLEY SP),3891,0,3891,1980,196.5,4158
5087,2008,4,CCWF (CENTRAL CA WOMEN'S FAC),4013,7,4020,2004,200.6,4086
5088,2008,4,CIW (CA INSTITUTION FOR WOMEN),2465,226,2691,1325,203.1,2549
5089,2008,4,WSP (WASCO SP),5956,7,5963,2984,199.8,5878
5090,2008,4,SCC (SIERRA CONSERVATION CENTER),6061,0,6061,3736,162.2,6046
5091,2008,4,SVSP (SALINAS VALLEY SP),4093,0,4093,2372,172.6,4100
5092,2008,4,RJD (RJ DONOVAN CORRECTIONAL FAC),4542,0,4542,2200,206.5,4588
5093,2008,4,PVSP (PLEASANT VALLEY SP),5171,0,5171,2308,224.0,5192
5094,2008,4,PBSP (PELICAN BAY SP),3360,0,3360,2341,143.5,3598
5095,2008,4,NKSP (NORTH KERN SP),5430,4,5434,2692,201.9,5454
5096,2008,4,MCSP (MULE CREEK SP),3731,0,3731,1594,234.1,3714
5097,2008,4,KVSP (KERN VALLEY SP),4639,0,4639,2448,189.5,4846
5098,2008,4,ISP (IRONWOOD SP),4524,0,4524,2200,205.6,4565
5099,2008,4,HDSP (HIGH DESERT SP),4343,3,4346,2324,187.0,4536
5100,2008,4,FOL (FOLSOM SP) (MALE),4151,0,4151,2236,185.6,4078
5101,2008,4,DVI (DEUEL VOCATIONAL INSTITUTION),3822,6,3828,1627,235.3,3787
5102,2008,4,CTF (CORRECTIONAL TRAINING FAC),6456,0,6456,3301,195.6,6499
5103,2008,4,CVSP (CHUCKAWALLA VALLEY SP),3113,0,3113,1348,230.9,3222
5104,2008,4,SATF (CA SUBSTANCE ABUSE TREAT FAC),7170,6,7176,3424,209.6,7473
5105,2008,4,"SOL (CA SP, SOLANO)",5651,0,5651,2610,216.5,5570
5106,2008,4,SQ (SAN QUENTIN SP),5215,6,5221,3108,168.0,5274
5107,2008,4,"SAC (CA SP, SACRAMENTO)",3056,0,3056,1788,170.9,3234
5108,2008,4,"LAC (CA SP, LOS ANGELES COUNTY)",4950,0,4950,2300,215.2,4946
5109,2008,4,"COR (CA SP, CORCORAN)",5650,1,5651,3116,181.4,5623
5110,2008,4,CEN (CENTINELA SP),5041,0,5041,2308,218.4,5136
5111,2008,4,CAL (CALIPATRIA SP),4233,0,4233,2308,183.4,4218
5112,2008,4,"CRC (CAL REHAB CTR, MEN)",3762,637,4399,2314,190.1,4604
5113,2008,4,CMC (CA MEN'S COLONY),6535,0,6535,3840,170.2,6518
5114,2008,4,CMF (CA MEDICAL FAC),3094,0,3094,2179,142.0,3078
5115,2008,4,CIM (CA INSTITUTION FOR MEN),5959,30,5989,3033,197.5,6130
5116,2008,4,CCI (CA CORRECTIONAL INSTITUTION),4936,1,4937,2785,177.3,5620
5117,2008,4,CCC (CA CORRECTIONAL CENTER),5945,0,5945,3883,153.1,6024
5118,2008,4,ASP (AVENAL SP),7039,0,7039,2920,241.1,7222
5119,2008,5,VSP (VALLEY SP),3897,8,3905,1980,197.2,4158
5120,2008,5,CCWF (CENTRAL CA WOMEN'S FAC),4051,12,4063,2004,202.7,4086
5121,2008,5,CIW (CA INSTITUTION FOR WOMEN),2462,208,2670,1356,196.9,2549
5122,2008,5,WSP (WASCO SP),6039,6,6045,2984,202.6,5878
5123,2008,5,SCC (SIERRA CONSERVATION CENTER),6067,1,6068,3736,162.4,6046
5124,2008,5,SVSP (SALINAS VALLEY SP),4084,0,4084,2388,171.0,4100
5125,2008,5,RJD (RJ DONOVAN CORRECTIONAL FAC),4626,0,4626,2200,210.3,4588
5126,2008,5,PVSP (PLEASANT VALLEY SP),5128,0,5128,2308,222.2,5192
5127,2008,5,PBSP (PELICAN BAY SP),3376,0,3376,2380,141.8,3598
5128,2008,5,NKSP (NORTH KERN SP),5529,6,5535,2694,205.5,5454
5129,2008,5,MCSP (MULE CREEK SP),3731,0,3731,1700,219.5,3714
5130,2008,5,KVSP (KERN VALLEY SP),4707,0,4707,2448,192.3,4846
5131,2008,5,ISP (IRONWOOD SP),4412,0,4412,2200,200.5,4565
5132,2008,5,HDSP (HIGH DESERT SP),4375,9,4384,2324,188.6,4536
5133,2008,5,FOL (FOLSOM SP) (MALE),4094,0,4094,2372,172.6,4078
5134,2008,5,DVI (DEUEL VOCATIONAL INSTITUTION),3853,5,3858,1681,229.5,3787
5135,2008,5,CTF (CORRECTIONAL TRAINING FAC),6486,0,6486,3312,195.8,6499
5136,2008,5,CVSP (CHUCKAWALLA VALLEY SP),3077,0,3077,1738,177.0,3222
5137,2008,5,SATF (CA SUBSTANCE ABUSE TREAT FAC),7196,6,7202,3424,210.3,7473
5138,2008,5,"SOL (CA SP, SOLANO)",5672,0,5672,2610,217.3,5570
5139,2008,5,SQ (SAN QUENTIN SP),5292,2,5294,3082,171.8,5274
5140,2008,5,"SAC (CA SP, SACRAMENTO)",3010,0,3010,1828,164.7,3234
5141,2008,5,"LAC (CA SP, LOS ANGELES COUNTY)",5009,0,5009,2300,217.8,4946
5142,2008,5,"COR (CA SP, CORCORAN)",5675,0,5675,2988,189.9,5402
5143,2008,5,CEN (CENTINELA SP),5115,0,5115,2308,221.6,5136
5144,2008,5,CAL (CALIPATRIA SP),4147,0,4147,2308,179.7,4218
5145,2008,5,"CRC (CAL REHAB CTR, MEN)",3749,597,4346,2491,174.5,4604
5146,2008,5,CMC (CA MEN'S COLONY),6506,0,6506,3838,169.5,6518
5147,2008,5,CMF (CA MEDICAL FAC),3030,0,3030,2297,131.9,3078
5148,2008,5,CIM (CA INSTITUTION FOR MEN),6036,29,6065,2976,203.8,6130
5149,2008,5,CCI (CA CORRECTIONAL INSTITUTION),5355,1,5356,2783,192.5,5620
5150,2008,5,CCC (CA CORRECTIONAL CENTER),5836,0,5836,3883,150.3,6024
5151,2008,5,ASP (AVENAL SP),6839,0,6839,2920,234.2,7222
5152,2008,6,VSP (VALLEY SP),3911,12,3923,1980,198.1,4158
5153,2008,6,CCWF (CENTRAL CA WOMEN'S FAC),4065,2,4067,2004,202.9,4086
5154,2008,6,CIW (CA INSTITUTION FOR WOMEN),2418,200,2618,1356,193.1,2549
5155,2008,6,WSP (WASCO SP),5924,10,5934,2984,198.9,5878
5156,2008,6,SCC (SIERRA CONSERVATION CENTER),6162,2,6164,3736,165.0,6046
5157,2008,6,SVSP (SALINAS VALLEY SP),4095,0,4095,2388,171.5,4100
5158,2008,6,RJD (RJ DONOVAN CORRECTIONAL FAC),4556,0,4556,2200,207.1,4588
5159,2008,6,PVSP (PLEASANT VALLEY SP),5180,0,5180,2308,224.4,5192
5160,2008,6,PBSP (PELICAN BAY SP),3388,0,3388,2380,142.4,3598
5161,2008,6,NKSP (NORTH KERN SP),5500,8,5508,2694,204.5,5454
5162,2008,6,MCSP (MULE CREEK SP),3666,0,3666,1700,215.6,3714
5163,2008,6,KVSP (KERN VALLEY SP),4683,0,4683,2448,191.3,4846
5164,2008,6,ISP (IRONWOOD SP),4430,0,4430,2200,201.4,4565
5165,2008,6,HDSP (HIGH DESERT SP),4495,7,4502,2324,193.7,4536
5166,2008,6,FOL (FOLSOM SP) (MALE),4067,0,4067,2469,164.7,4078
5167,2008,6,DVI (DEUEL VOCATIONAL INSTITUTION),3861,10,3871,1681,230.3,3787
5168,2008,6,CTF (CORRECTIONAL TRAINING FAC),6604,0,6604,3312,199.4,6499
5169,2008,6,CVSP (CHUCKAWALLA VALLEY SP),3109,0,3109,1738,178.9,3222
5170,2008,6,SATF (CA SUBSTANCE ABUSE TREAT FAC),7156,6,7162,3424,209.2,7473
5171,2008,6,"SOL (CA SP, SOLANO)",5652,0,5652,2610,216.6,5570
5172,2008,6,SQ (SAN QUENTIN SP),5314,4,5318,3082,172.6,5274
5173,2008,6,"SAC (CA SP, SACRAMENTO)",2979,0,2979,1828,163.0,3234
5174,2008,6,"LAC (CA SP, LOS ANGELES COUNTY)",4946,0,4946,2300,215.0,4946
5175,2008,6,"COR (CA SP, CORCORAN)",5725,0,5725,3116,183.7,5402
5176,2008,6,CEN (CENTINELA SP),4817,0,4817,2308,208.7,5136
5177,2008,6,CAL (CALIPATRIA SP),4189,0,4189,2308,181.5,4218
5178,2008,6,"CRC (CAL REHAB CTR, MEN)",3802,580,4382,2491,175.9,4604
5179,2008,6,CMC (CA MEN'S COLONY),6505,0,6505,3838,169.5,6518
5180,2008,6,CMF (CA MEDICAL FAC),3056,0,3056,2297,133.0,3078
5181,2008,6,CIM (CA INSTITUTION FOR MEN),6023,29,6052,2976,203.4,6130
5182,2008,6,CCI (CA CORRECTIONAL INSTITUTION),5418,0,5418,2783,194.7,5620
5183,2008,6,CCC (CA CORRECTIONAL CENTER),5595,0,5595,3883,144.1,6024
5184,2008,6,ASP (AVENAL SP),6869,0,6869,2920,235.2,7222
5185,2008,7,VSP (VALLEY SP),4027,10,4037,1980,203.9,4158
5186,2008,7,CCWF (CENTRAL CA WOMEN'S FAC),4093,3,4096,2004,204.4,4086
5187,2008,7,CIW (CA INSTITUTION FOR WOMEN),2476,205,2681,1356,197.7,2549
5188,2008,7,WSP (WASCO SP),6000,9,6009,2984,201.4,5878
5189,2008,7,SCC (SIERRA CONSERVATION CENTER),6070,0,6070,3736,162.5,6046
5190,2008,7,SVSP (SALINAS VALLEY SP),4095,0,4095,2388,171.5,4100
5191,2008,7,RJD (RJ DONOVAN CORRECTIONAL FAC),4609,0,4609,2200,209.5,4588
5192,2008,7,PVSP (PLEASANT VALLEY SP),5186,0,5186,2308,224.7,5192
5193,2008,7,PBSP (PELICAN BAY SP),3372,0,3372,2380,141.7,3598
5194,2008,7,NKSP (NORTH KERN SP),5289,5,5294,2694,196.5,5454
5195,2008,7,MCSP (MULE CREEK SP),3692,0,3692,1700,217.2,3714
5196,2008,7,KVSP (KERN VALLEY SP),4678,0,4678,2448,191.1,4846
5197,2008,7,ISP (IRONWOOD SP),4497,0,4497,2200,204.4,4565
5198,2008,7,HDSP (HIGH DESERT SP),4472,13,4485,2324,193.0,4536
5199,2008,7,FOL (FOLSOM SP) (MALE),4037,0,4037,2469,163.5,4078
5200,2008,7,DVI (DEUEL VOCATIONAL INSTITUTION),3816,9,3825,1681,227.5,3787
5201,2008,7,CTF (CORRECTIONAL TRAINING FAC),6470,0,6470,3312,195.4,6499
5202,2008,7,CVSP (CHUCKAWALLA VALLEY SP),3080,0,3080,1738,177.2,3222
5203,2008,7,SATF (CA SUBSTANCE ABUSE TREAT FAC),7120,4,7124,3424,208.1,7473
5204,2008,7,"SOL (CA SP, SOLANO)",5671,0,5671,2610,217.3,5570
5205,2008,7,SQ (SAN QUENTIN SP),5135,5,5140,3082,166.8,5274
5206,2008,7,"SAC (CA SP, SACRAMENTO)",3032,0,3032,1828,165.9,3234
5207,2008,7,"LAC (CA SP, LOS ANGELES COUNTY)",4987,0,4987,2300,216.8,4946
5208,2008,7,"COR (CA SP, CORCORAN)",5744,0,5744,3116,184.3,5402
5209,2008,7,CEN (CENTINELA SP),4819,0,4819,2308,208.8,5136
5210,2008,7,CAL (CALIPATRIA SP),4279,0,4279,2308,185.4,4218
5211,2008,7,"CRC (CAL REHAB CTR, MEN)",3784,565,4349,2491,174.6,4604
5212,2008,7,CMC (CA MEN'S COLONY),6482,0,6482,3838,168.9,6518
5213,2008,7,CMF (CA MEDICAL FAC),3067,0,3067,2297,133.5,3078
5214,2008,7,CIM (CA INSTITUTION FOR MEN),6062,26,6088,2976,204.6,6130
5215,2008,7,CCI (CA CORRECTIONAL INSTITUTION),5751,0,5751,2783,206.6,5620
5216,2008,7,CCC (CA CORRECTIONAL CENTER),5566,0,5566,3883,143.3,6024
5217,2008,7,ASP (AVENAL SP),6882,0,6882,2920,235.7,7222
5218,2008,8,VSP (VALLEY SP),4060,15,4075,1980,205.8,4158
5219,2008,8,CCWF (CENTRAL CA WOMEN'S FAC),4116,3,4119,2004,205.5,4086
5220,2008,8,CIW (CA INSTITUTION FOR WOMEN),2439,203,2642,1356,194.8,2549
5221,2008,8,WSP (WASCO SP),5855,13,5868,2984,196.6,5878
5222,2008,8,SCC (SIERRA CONSERVATION CENTER),6118,0,6118,3736,163.8,6046
5223,2008,8,SVSP (SALINAS VALLEY SP),4062,0,4062,2388,170.1,4100
5224,2008,8,RJD (RJ DONOVAN CORRECTIONAL FAC),4678,1,4679,2200,212.7,4588
5225,2008,8,PVSP (PLEASANT VALLEY SP),5161,0,5161,2308,223.6,5192
5226,2008,8,PBSP (PELICAN BAY SP),3370,0,3370,2380,141.6,3598
5227,2008,8,NKSP (NORTH KERN SP),5513,10,5523,2694,205.0,5454
5228,2008,8,MCSP (MULE CREEK SP),3680,0,3680,1700,216.5,3714
5229,2008,8,KVSP (KERN VALLEY SP),4700,0,4700,2448,192.0,4846
5230,2008,8,ISP (IRONWOOD SP),4386,0,4386,2200,199.4,4565
5231,2008,8,HDSP (HIGH DESERT SP),4441,4,4445,2324,191.3,4536
5232,2008,8,FOL (FOLSOM SP) (MALE),4028,0,4028,2469,163.1,4078
5233,2008,8,DVI (DEUEL VOCATIONAL INSTITUTION),3832,12,3844,1681,228.7,3787
5234,2008,8,CTF (CORRECTIONAL TRAINING FAC),6435,0,6435,3312,194.3,6499
5235,2008,8,CVSP (CHUCKAWALLA VALLEY SP),2991,0,2991,1738,172.1,3222
5236,2008,8,SATF (CA SUBSTANCE ABUSE TREAT FAC),7171,6,7177,3424,209.6,7473
5237,2008,8,"SOL (CA SP, SOLANO)",5504,0,5504,2610,210.9,5570
5238,2008,8,SQ (SAN QUENTIN SP),5256,3,5259,3082,170.6,5274
5239,2008,8,"SAC (CA SP, SACRAMENTO)",3057,0,3057,1828,167.2,3234
5240,2008,8,"LAC (CA SP, LOS ANGELES COUNTY)",5055,0,5055,2300,219.8,4946
5241,2008,8,"COR (CA SP, CORCORAN)",5735,0,5735,3116,184.1,5402
5242,2008,8,CEN (CENTINELA SP),5022,0,5022,2308,217.6,5136
5243,2008,8,CAL (CALIPATRIA SP),4372,0,4372,2308,189.4,4218
5244,2008,8,"CRC (CAL REHAB CTR, MEN)",3814,551,4365,2491,175.2,4604
5245,2008,8,CMC (CA MEN'S COLONY),6497,0,6497,3838,169.3,6518
5246,2008,8,CMF (CA MEDICAL FAC),3110,0,3110,2297,135.4,3078
5247,2008,8,CIM (CA INSTITUTION FOR MEN),5825,22,5847,2976,196.5,6130
5248,2008,8,CCI (CA CORRECTIONAL INSTITUTION),5752,0,5752,2783,206.7,5620
5249,2008,8,CCC (CA CORRECTIONAL CENTER),5602,0,5602,3883,144.3,6024
5250,2008,8,ASP (AVENAL SP),6878,0,6878,2920,235.5,7222
5251,2008,9,VSP (VALLEY SP),4061,10,4071,1980,205.6,4158
5252,2008,9,CCWF (CENTRAL CA WOMEN'S FAC),4072,4,4076,2004,203.4,4086
5253,2008,9,CIW (CA INSTITUTION FOR WOMEN),2409,202,2611,1356,192.6,2549
5254,2008,9,WSP (WASCO SP),5817,7,5824,2984,195.2,5878
5255,2008,9,SCC (SIERRA CONSERVATION CENTER),6064,0,6064,3736,162.3,6046
5256,2008,9,SVSP (SALINAS VALLEY SP),4083,0,4083,2388,171.0,4100
5257,2008,9,RJD (RJ DONOVAN CORRECTIONAL FAC),4813,1,4814,2200,218.8,4588
5258,2008,9,PVSP (PLEASANT VALLEY SP),5194,0,5194,2308,225.0,5192
5259,2008,9,PBSP (PELICAN BAY SP),3361,0,3361,2380,141.2,3598
5260,2008,9,NKSP (NORTH KERN SP),5482,13,5495,2694,204.0,5454
5261,2008,9,MCSP (MULE CREEK SP),3800,0,3800,1700,223.5,3714
5262,2008,9,KVSP (KERN VALLEY SP),4712,0,4712,2448,192.5,4846
5263,2008,9,ISP (IRONWOOD SP),4331,0,4331,2200,196.9,4565
5264,2008,9,HDSP (HIGH DESERT SP),4531,5,4536,2324,195.2,4536
5265,2008,9,FOL (FOLSOM SP) (MALE),4056,0,4056,2469,164.3,4078
5266,2008,9,DVI (DEUEL VOCATIONAL INSTITUTION),3701,10,3711,1681,220.8,3787
5267,2008,9,CTF (CORRECTIONAL TRAINING FAC),6396,0,6396,3312,193.1,6499
5268,2008,9,CVSP (CHUCKAWALLA VALLEY SP),3141,0,3141,1738,180.7,3222
5269,2008,9,SATF (CA SUBSTANCE ABUSE TREAT FAC),7156,5,7161,3424,209.1,7473
5270,2008,9,"SOL (CA SP, SOLANO)",5423,0,5423,2610,207.8,5570
5271,2008,9,SQ (SAN QUENTIN SP),5268,3,5271,3082,171.0,5274
5272,2008,9,"SAC (CA SP, SACRAMENTO)",3028,0,3028,1828,165.6,3234
5273,2008,9,"LAC (CA SP, LOS ANGELES COUNTY)",4991,0,4991,2300,217.0,4946
5274,2008,9,"COR (CA SP, CORCORAN)",5789,0,5789,3116,185.8,5402
5275,2008,9,CEN (CENTINELA SP),5103,0,5103,2308,221.1,5136
5276,2008,9,CAL (CALIPATRIA SP),4317,0,4317,2308,187.0,4218
5277,2008,9,"CRC (CAL REHAB CTR, MEN)",3811,541,4352,2491,174.7,4604
5278,2008,9,CMC (CA MEN'S COLONY),6531,0,6531,3838,170.2,6518
5279,2008,9,CMF (CA MEDICAL FAC),3104,0,3104,2297,135.1,3078
5280,2008,9,CIM (CA INSTITUTION FOR MEN),5807,22,5829,2976,195.9,6130
5281,2008,9,CCI (CA CORRECTIONAL INSTITUTION),5674,0,5674,2783,203.9,5620
5282,2008,9,CCC (CA CORRECTIONAL CENTER),5696,0,5696,3883,146.7,6024
5283,2008,9,ASP (AVENAL SP),6870,0,6870,2920,235.3,7222
5284,2008,10,VSP (VALLEY SP),4097,10,4107,1980,207.4,4118
5285,2008,10,CCWF (CENTRAL CA WOMEN'S FAC),4161,5,4166,2004,207.9,4166
5286,2008,10,CIW (CA INSTITUTION FOR WOMEN),2445,211,2656,1356,195.9,2669
5287,2008,10,WSP (WASCO SP),5972,7,5979,2984,200.4,5848
5288,2008,10,SCC (SIERRA CONSERVATION CENTER),6012,0,6012,3736,160.9,6067
5289,2008,10,SVSP (SALINAS VALLEY SP),4066,0,4066,2388,170.3,4099
5290,2008,10,RJD (RJ DONOVAN CORRECTIONAL FAC),4769,2,4771,2200,216.9,4814
5291,2008,10,PVSP (PLEASANT VALLEY SP),5136,0,5136,2308,222.5,5162
5292,2008,10,PBSP (PELICAN BAY SP),3368,0,3368,2380,141.5,3502
5293,2008,10,NKSP (NORTH KERN SP),5444,15,5459,2694,202.6,5454
5294,2008,10,MCSP (MULE CREEK SP),3874,0,3874,1700,227.9,3748
5295,2008,10,KVSP (KERN VALLEY SP),4714,0,4714,2448,192.6,4820
5296,2008,10,ISP (IRONWOOD SP),4263,0,4263,2200,193.8,4445
5297,2008,10,HDSP (HIGH DESERT SP),4529,3,4532,2324,195.0,4536
5298,2008,10,FOL (FOLSOM SP) (MALE),4035,0,4035,2469,163.4,4078
5299,2008,10,DVI (DEUEL VOCATIONAL INSTITUTION),3857,9,3866,1681,230.0,3811
5300,2008,10,CTF (CORRECTIONAL TRAINING FAC),6534,0,6534,3312,197.3,6527
5301,2008,10,CVSP (CHUCKAWALLA VALLEY SP),3234,0,3234,1738,186.1,3328
5302,2008,10,SATF (CA SUBSTANCE ABUSE TREAT FAC),7153,6,7159,3424,209.1,7264
5303,2008,10,"SOL (CA SP, SOLANO)",5280,0,5280,2610,202.3,5427
5304,2008,10,SQ (SAN QUENTIN SP),5365,4,5369,3082,174.2,5259
5305,2008,10,"SAC (CA SP, SACRAMENTO)",3025,0,3025,1828,165.5,3059
5306,2008,10,"LAC (CA SP, LOS ANGELES COUNTY)",4955,1,4956,2300,215.5,5027
5307,2008,10,"COR (CA SP, CORCORAN)",5791,0,5791,3116,185.8,5653
5308,2008,10,CEN (CENTINELA SP),5028,0,5028,2308,217.9,5136
5309,2008,10,CAL (CALIPATRIA SP),4343,0,4343,2308,188.2,4218
5310,2008,10,"CRC (CAL REHAB CTR, MEN)",3814,534,4348,2491,174.5,4408
5311,2008,10,CMC (CA MEN'S COLONY),6557,0,6557,3838,170.8,6518
5312,2008,10,CMF (CA MEDICAL FAC),3047,0,3047,2297,132.7,3060
5313,2008,10,CIM (CA INSTITUTION FOR MEN),5847,26,5873,2976,197.3,6032
5314,2008,10,CCI (CA CORRECTIONAL INSTITUTION),5858,0,5858,2783,210.5,5835
5315,2008,10,CCC (CA CORRECTIONAL CENTER),5724,0,5724,3883,147.4,5724
5316,2008,10,ASP (AVENAL SP),6731,0,6731,2920,230.5,6878
5317,2008,11,VSP (VALLEY SP),4103,4,4107,1980,207.4,4118
5318,2008,11,CCWF (CENTRAL CA WOMEN'S FAC),4114,1,4115,2004,205.3,4166
5319,2008,11,CIW (CA INSTITUTION FOR WOMEN),2451,201,2652,1356,195.6,2669
5320,2008,11,WSP (WASCO SP),5669,9,5678,2984,190.3,5848
5321,2008,11,SCC (SIERRA CONSERVATION CENTER),6074,0,6074,3736,162.6,6067
5322,2008,11,SVSP (SALINAS VALLEY SP),4054,0,4054,2388,169.8,4099
5323,2008,11,RJD (RJ DONOVAN CORRECTIONAL FAC),4760,1,4761,2200,216.4,4814
5324,2008,11,PVSP (PLEASANT VALLEY SP),5079,0,5079,2308,220.1,5162
5325,2008,11,PBSP (PELICAN BAY SP),3408,0,3408,2380,143.2,3502
5326,2008,11,NKSP (NORTH KERN SP),5468,8,5476,2694,203.3,5454
5327,2008,11,MCSP (MULE CREEK SP),3873,0,3873,1700,227.8,3748
5328,2008,11,KVSP (KERN VALLEY SP),4768,0,4768,2448,194.8,4820
5329,2008,11,ISP (IRONWOOD SP),4181,0,4181,2200,190.0,4445
5330,2008,11,HDSP (HIGH DESERT SP),4410,11,4421,2324,190.2,4536
5331,2008,11,FOL (FOLSOM SP) (MALE),4061,0,4061,2469,164.5,4078
5332,2008,11,DVI (DEUEL VOCATIONAL INSTITUTION),3780,16,3796,1681,225.8,3811
5333,2008,11,CTF (CORRECTIONAL TRAINING FAC),6539,0,6539,3312,197.4,6527
5334,2008,11,CVSP (CHUCKAWALLA VALLEY SP),3123,0,3123,1738,179.7,3328
5335,2008,11,SATF (CA SUBSTANCE ABUSE TREAT FAC),7033,4,7037,3424,205.5,7264
5336,2008,11,"SOL (CA SP, SOLANO)",5240,0,5240,2610,200.8,5427
5337,2008,11,SQ (SAN QUENTIN SP),5229,8,5237,3082,169.9,5259
5338,2008,11,"SAC (CA SP, SACRAMENTO)",2973,0,2973,1828,162.6,3059
5339,2008,11,"LAC (CA SP, LOS ANGELES COUNTY)",4834,0,4834,2300,210.2,5027
5340,2008,11,"COR (CA SP, CORCORAN)",5776,0,5776,3116,185.4,5653
5341,2008,11,CEN (CENTINELA SP),5004,0,5004,2308,216.8,5136
5342,2008,11,CAL (CALIPATRIA SP),4335,0,4335,2308,187.8,4218
5343,2008,11,"CRC (CAL REHAB CTR, MEN)",3810,529,4339,2491,174.2,4408
5344,2008,11,CMC (CA MEN'S COLONY),6502,0,6502,3838,169.4,6518
5345,2008,11,CMF (CA MEDICAL FAC),2994,0,2994,2297,130.3,3060
5346,2008,11,CIM (CA INSTITUTION FOR MEN),5715,26,5741,2976,192.9,6032
5347,2008,11,CCI (CA CORRECTIONAL INSTITUTION),5797,0,5797,2783,208.3,5835
5348,2008,11,CCC (CA CORRECTIONAL CENTER),5621,0,5621,3883,144.8,5724
5349,2008,11,ASP (AVENAL SP),6707,0,6707,2920,229.7,6878
5350,2008,12,VSP (VALLEY SP),4050,8,4058,1980,204.9,4158
5351,2008,12,CCWF (CENTRAL CA WOMEN'S FAC),4082,0,4082,2004,203.7,4166
5352,2008,12,CIW (CA INSTITUTION FOR WOMEN),2397,199,2596,1356,191.4,2669
5353,2008,12,WSP (WASCO SP),5968,3,5971,2984,200.1,5848
5354,2008,12,SCC (SIERRA CONSERVATION CENTER),6068,0,6068,3736,162.4,6067
5355,2008,12,SVSP (SALINAS VALLEY SP),4014,0,4014,2388,168.1,4099
5356,2008,12,RJD (RJ DONOVAN CORRECTIONAL FAC),4772,1,4773,2200,217.0,4814
5357,2008,12,PVSP (PLEASANT VALLEY SP),5084,0,5084,2308,220.3,5162
5358,2008,12,PBSP (PELICAN BAY SP),3429,0,3429,2380,144.1,3502
5359,2008,12,NKSP (NORTH KERN SP),5382,12,5394,2694,200.2,5454
5360,2008,12,MCSP (MULE CREEK SP),3859,0,3859,1700,227.0,3748
5361,2008,12,KVSP (KERN VALLEY SP),4797,0,4797,2448,196.0,4820
5362,2008,12,ISP (IRONWOOD SP),4161,0,4161,2200,189.1,4445
5363,2008,12,HDSP (HIGH DESERT SP),4380,7,4387,2324,188.8,4536
5364,2008,12,FOL (FOLSOM SP) (MALE),4024,0,4024,2469,163.0,4078
5365,2008,12,DVI (DEUEL VOCATIONAL INSTITUTION),3838,9,3847,1681,228.9,3811
5366,2008,12,CTF (CORRECTIONAL TRAINING FAC),6409,0,6409,3312,193.5,6527
5367,2008,12,CVSP (CHUCKAWALLA VALLEY SP),3197,0,3197,1738,183.9,3328
5368,2008,12,SATF (CA SUBSTANCE ABUSE TREAT FAC),7068,5,7073,3424,206.6,7264
5369,2008,12,"SOL (CA SP, SOLANO)",5213,0,5213,2610,199.7,5427
5370,2008,12,SQ (SAN QUENTIN SP),5239,17,5256,3082,170.5,5259
5371,2008,12,"SAC (CA SP, SACRAMENTO)",2951,0,2951,1828,161.4,3059
5372,2008,12,"LAC (CA SP, LOS ANGELES COUNTY)",4938,0,4938,2300,214.7,5027
5373,2008,12,"COR (CA SP, CORCORAN)",5737,0,5737,3116,184.1,5653
5374,2008,12,CEN (CENTINELA SP),4976,0,4976,2308,215.6,5136
5375,2008,12,CAL (CALIPATRIA SP),4258,0,4258,2308,184.5,4218
5376,2008,12,"CRC (CAL REHAB CTR, MEN)",3853,516,4369,2491,175.4,4408
5377,2008,12,CMC (CA MEN'S COLONY),6445,0,6445,3838,167.9,6488
5378,2008,12,CMF (CA MEDICAL FAC),2873,0,2873,2297,125.1,3060
5379,2008,12,CIM (CA INSTITUTION FOR MEN),5625,21,5646,2976,189.7,5832
5380,2008,12,CCI (CA CORRECTIONAL INSTITUTION),5759,0,5759,2783,206.9,5835
5381,2008,12,CCC (CA CORRECTIONAL CENTER),5594,0,5594,3883,144.1,5724
5382,2008,12,ASP (AVENAL SP),6556,0,6556,2920,224.5,6878
5383,2009,1,VSP (VALLEY SP),4052,9,4061,1980,205.1,4158
5384,2009,1,CCWF (CENTRAL CA WOMEN'S FAC),3988,2,3990,2004,199.1,4166
5385,2009,1,CIW (CA INSTITUTION FOR WOMEN),2326,207,2533,1356,186.8,2669
5386,2009,1,WSP (WASCO SP),5941,16,5957,2984,199.6,5848
5387,2009,1,SCC (SIERRA CONSERVATION CENTER),5973,0,5973,3736,159.9,6067
5388,2009,1,SVSP (SALINAS VALLEY SP),3966,0,3966,2388,166.1,4099
5389,2009,1,RJD (RJ DONOVAN CORRECTIONAL FAC),4760,1,4761,2200,216.4,4814
5390,2009,1,PVSP (PLEASANT VALLEY SP),5144,0,5144,2308,222.9,5162
5391,2009,1,PBSP (PELICAN BAY SP),3394,0,3394,2380,142.6,3502
5392,2009,1,NKSP (NORTH KERN SP),5522,13,5535,2694,205.5,5454
5393,2009,1,MCSP (MULE CREEK SP),3881,0,3881,1700,228.3,3748
5394,2009,1,KVSP (KERN VALLEY SP),4779,0,4779,2448,195.2,4628
5395,2009,1,ISP (IRONWOOD SP),4045,0,4045,2200,183.9,4325
5396,2009,1,HDSP (HIGH DESERT SP),4395,9,4404,2324,189.5,4536
5397,2009,1,FOL (FOLSOM SP) (MALE),4085,0,4085,2469,165.5,4078
5398,2009,1,DVI (DEUEL VOCATIONAL INSTITUTION),3806,7,3813,1681,226.8,3811
5399,2009,1,CTF (CORRECTIONAL TRAINING FAC),6274,0,6274,3312,189.4,6527
5400,2009,1,CVSP (CHUCKAWALLA VALLEY SP),3340,0,3340,1738,192.2,3328
5401,2009,1,SATF (CA SUBSTANCE ABUSE TREAT FAC),6987,5,6992,3424,204.2,7264
5402,2009,1,"SOL (CA SP, SOLANO)",5028,0,5028,2610,192.6,5235
5403,2009,1,SQ (SAN QUENTIN SP),5231,8,5239,3082,170.0,5259
5404,2009,1,"SAC (CA SP, SACRAMENTO)",2959,0,2959,1828,161.9,3059
5405,2009,1,"LAC (CA SP, LOS ANGELES COUNTY)",4857,0,4857,2300,211.2,5027
5406,2009,1,"COR (CA SP, CORCORAN)",5631,0,5631,3116,180.7,5653
5407,2009,1,CEN (CENTINELA SP),4826,0,4826,2308,209.1,5016
5408,2009,1,CAL (CALIPATRIA SP),4292,0,4292,2308,186.0,4218
5409,2009,1,"CRC (CAL REHAB CTR, MEN)",3818,526,4344,2491,174.4,4408
5410,2009,1,CMC (CA MEN'S COLONY),6484,0,6484,3838,168.9,6488
5411,2009,1,CMF (CA MEDICAL FAC),2822,0,2822,2297,122.9,3000
5412,2009,1,CIM (CA INSTITUTION FOR MEN),5682,14,5696,2976,191.4,6011
5413,2009,1,CCI (CA CORRECTIONAL INSTITUTION),5667,0,5667,2783,203.6,5835
5414,2009,1,CCC (CA CORRECTIONAL CENTER),5575,0,5575,3883,143.6,5724
5415,2009,1,ASP (AVENAL SP),6451,0,6451,2920,220.9,6878
5416,2009,2,VSP (VALLEY SP),3931,11,3942,1860,211.9,4158
5417,2009,2,CCWF (CENTRAL CA WOMEN'S FAC),3911,1,3912,2004,195.2,4166
5418,2009,2,CIW (CA INSTITUTION FOR WOMEN),2454,211,2665,1356,196.5,2669
5419,2009,2,WSP (WASCO SP),5972,13,5985,2984,200.6,5848
5420,2009,2,SCC (SIERRA CONSERVATION CENTER),5862,0,5862,3454,169.7,6067
5421,2009,2,SVSP (SALINAS VALLEY SP),3962,0,3962,2472,160.3,4099
5422,2009,2,RJD (RJ DONOVAN CORRECTIONAL FAC),4727,2,4729,2200,215.0,4814
5423,2009,2,PVSP (PLEASANT VALLEY SP),5140,0,5140,2308,222.7,5162
5424,2009,2,PBSP (PELICAN BAY SP),3370,0,3370,2380,141.6,3502
5425,2009,2,NKSP (NORTH KERN SP),5408,12,5420,2694,201.2,5454
5426,2009,2,MCSP (MULE CREEK SP),3864,0,3864,1700,227.3,3748
5427,2009,2,KVSP (KERN VALLEY SP),4771,0,4771,2448,194.9,4628
5428,2009,2,ISP (IRONWOOD SP),4032,0,4032,1960,205.7,4325
5429,2009,2,HDSP (HIGH DESERT SP),4399,9,4408,2324,189.7,4536
5430,2009,2,FOL (FOLSOM SP) (MALE),4115,0,4115,2469,166.7,4078
5431,2009,2,DVI (DEUEL VOCATIONAL INSTITUTION),3821,7,3828,1681,227.7,3811
5432,2009,2,CTF (CORRECTIONAL TRAINING FAC),6252,0,6252,3312,188.8,6527
5433,2009,2,CVSP (CHUCKAWALLA VALLEY SP),3481,0,3481,1738,200.3,3328
5434,2009,2,SATF (CA SUBSTANCE ABUSE TREAT FAC),6939,3,6942,3424,202.7,7264
5435,2009,2,"SOL (CA SP, SOLANO)",4920,0,4920,2480,198.4,5235
5436,2009,2,SQ (SAN QUENTIN SP),5242,8,5250,3082,170.3,5259
5437,2009,2,"SAC (CA SP, SACRAMENTO)",2962,0,2962,1828,162.0,3059
5438,2009,2,"LAC (CA SP, LOS ANGELES COUNTY)",4897,0,4897,2300,212.9,5027
5439,2009,2,"COR (CA SP, CORCORAN)",5545,0,5545,2995,185.1,5653
5440,2009,2,CEN (CENTINELA SP),4665,0,4665,2308,202.1,5016
5441,2009,2,CAL (CALIPATRIA SP),4254,0,4254,2308,184.3,4218
5442,2009,2,"CRC (CAL REHAB CTR, MEN)",3786,530,4316,2491,173.3,4408
5443,2009,2,CMC (CA MEN'S COLONY),6471,0,6471,3838,168.6,6488
5444,2009,2,CMF (CA MEDICAL FAC),2775,0,2775,2297,120.8,3000
5445,2009,2,CIM (CA INSTITUTION FOR MEN),5680,14,5694,2976,191.3,6011
5446,2009,2,CCI (CA CORRECTIONAL INSTITUTION),5556,0,5556,2608,213.0,5835
5447,2009,2,CCC (CA CORRECTIONAL CENTER),5514,0,5514,3883,142.0,5724
5448,2009,2,ASP (AVENAL SP),6337,0,6337,2820,224.7,6878
5449,2009,3,VSP (VALLEY SP),3915,10,3925,1860,211.0,4158
5450,2009,3,CCWF (CENTRAL CA WOMEN'S FAC),3875,4,3879,2004,193.6,4046
5451,2009,3,CIW (CA INSTITUTION FOR WOMEN),2473,212,2685,1356,198.0,2669
5452,2009,3,WSP (WASCO SP),5883,6,5889,2984,197.4,5848
5453,2009,3,SCC (SIERRA CONSERVATION CENTER),5865,0,5865,3454,169.8,6067
5454,2009,3,SVSP (SALINAS VALLEY SP),4030,0,4030,2472,163.0,4099
5455,2009,3,RJD (RJ DONOVAN CORRECTIONAL FAC),4809,1,4810,2300,209.1,4714
5456,2009,3,PVSP (PLEASANT VALLEY SP),5074,0,5074,2308,219.8,5162
5457,2009,3,PBSP (PELICAN BAY SP),3330,0,3330,2380,139.9,3502
5458,2009,3,NKSP (NORTH KERN SP),5284,11,5295,2694,196.5,5354
5459,2009,3,MCSP (MULE CREEK SP),3805,0,3805,1700,223.8,3748
5460,2009,3,KVSP (KERN VALLEY SP),4797,0,4797,2448,196.0,4728
5461,2009,3,ISP (IRONWOOD SP),4048,0,4048,1960,206.5,4325
5462,2009,3,HDSP (HIGH DESERT SP),4434,17,4451,2324,191.5,4486
5463,2009,3,FOL (FOLSOM SP) (MALE),4152,0,4152,2469,168.2,4078
5464,2009,3,DVI (DEUEL VOCATIONAL INSTITUTION),3843,15,3858,1681,229.5,3811
5465,2009,3,CTF (CORRECTIONAL TRAINING FAC),6172,0,6172,3412,180.9,6327
5466,2009,3,CVSP (CHUCKAWALLA VALLEY SP),3557,0,3557,1738,204.7,3278
5467,2009,3,SATF (CA SUBSTANCE ABUSE TREAT FAC),6982,2,6984,3424,204.0,7064
5468,2009,3,"SOL (CA SP, SOLANO)",4821,0,4821,2480,194.4,5235
5469,2009,3,SQ (SAN QUENTIN SP),5280,6,5286,3082,171.5,5259
5470,2009,3,"SAC (CA SP, SACRAMENTO)",2904,0,2904,1828,158.9,2979
5471,2009,3,"LAC (CA SP, LOS ANGELES COUNTY)",4829,0,4829,2400,201.2,5027
5472,2009,3,"COR (CA SP, CORCORAN)",5496,0,5496,2995,183.5,5511
5473,2009,3,CEN (CENTINELA SP),4762,0,4762,2308,206.3,4916
5474,2009,3,CAL (CALIPATRIA SP),4220,0,4220,2308,182.8,4218
5475,2009,3,"CRC (CAL REHAB CTR, MEN)",3705,546,4251,2491,170.7,4332
5476,2009,3,CMC (CA MEN'S COLONY),6417,0,6417,3838,167.2,6488
5477,2009,3,CMF (CA MEDICAL FAC),2792,1,2793,2297,121.6,3000
5478,2009,3,CIM (CA INSTITUTION FOR MEN),5886,12,5898,2976,198.2,6011
5479,2009,3,CCI (CA CORRECTIONAL INSTITUTION),5223,0,5223,2608,200.3,5835
5480,2009,3,CCC (CA CORRECTIONAL CENTER),5444,0,5444,3883,140.2,5724
5481,2009,3,ASP (AVENAL SP),6378,0,6378,2820,226.2,6878
5482,2009,4,VSP (VALLEY SP),3864,13,3877,1980,195.8,3958
5483,2009,4,CCWF (CENTRAL CA WOMEN'S FAC),3937,6,3943,2004,196.8,4046
5484,2009,4,CIW (CA INSTITUTION FOR WOMEN),2464,217,2681,1356,197.7,2669
5485,2009,4,WSP (WASCO SP),5891,6,5897,2984,197.6,5920
5486,2009,4,SCC (SIERRA CONSERVATION CENTER),5853,0,5853,3736,156.7,5921
5487,2009,4,SVSP (SALINAS VALLEY SP),4210,0,4210,2388,176.3,4163
5488,2009,4,RJD (RJ DONOVAN CORRECTIONAL FAC),4824,0,4824,2300,209.7,4814
5489,2009,4,PVSP (PLEASANT VALLEY SP),4883,0,4883,2308,211.6,4922
5490,2009,4,PBSP (PELICAN BAY SP),3345,0,3345,2380,140.5,3502
5491,2009,4,NKSP (NORTH KERN SP),5427,3,5430,2694,201.6,5354
5492,2009,4,MCSP (MULE CREEK SP),3808,0,3808,1700,224.0,3812
5493,2009,4,KVSP (KERN VALLEY SP),4816,0,4816,2448,196.7,4900
5494,2009,4,ISP (IRONWOOD SP),3997,0,3997,2200,181.7,4085
5495,2009,4,HDSP (HIGH DESERT SP),4456,7,4463,2324,192.0,4486
5496,2009,4,FOL (FOLSOM SP) (MALE),4100,0,4100,2469,166.1,4078
5497,2009,4,DVI (DEUEL VOCATIONAL INSTITUTION),3815,9,3824,1681,227.5,3811
5498,2009,4,CTF (CORRECTIONAL TRAINING FAC),6125,0,6125,3312,184.9,6527
5499,2009,4,CVSP (CHUCKAWALLA VALLEY SP),3506,0,3506,1738,201.7,3737
5500,2009,4,SATF (CA SUBSTANCE ABUSE TREAT FAC),7004,4,7008,3424,204.7,7009
5501,2009,4,"SOL (CA SP, SOLANO)",4808,0,4808,2610,184.2,4850
5502,2009,4,SQ (SAN QUENTIN SP),5120,6,5126,3082,166.3,5274
5503,2009,4,"SAC (CA SP, SACRAMENTO)",2901,0,2901,1828,158.7,2979
5504,2009,4,"LAC (CA SP, LOS ANGELES COUNTY)",4476,0,4476,3200,139.9,8000
5505,2009,4,"COR (CA SP, CORCORAN)",5497,0,5497,3116,176.4,5390
5506,2009,4,CEN (CENTINELA SP),4637,0,4637,2308,200.9,4808
5507,2009,4,CAL (CALIPATRIA SP),4211,0,4211,2308,182.5,4218
5508,2009,4,"CRC (CAL REHAB CTR, MEN)",3734,559,4293,2491,172.3,4408
5509,2009,4,CMC (CA MEN'S COLONY),6386,0,6386,3838,166.4,6458
5510,2009,4,CMF (CA MEDICAL FAC),2811,0,2811,2297,122.4,3000
5511,2009,4,CIM (CA INSTITUTION FOR MEN),5868,16,5884,2976,197.7,5811
5512,2009,4,CCI (CA CORRECTIONAL INSTITUTION),5266,0,5266,2783,189.2,5732
5513,2009,4,CCC (CA CORRECTIONAL CENTER),5417,0,5417,3883,139.5,5724
5514,2009,4,ASP (AVENAL SP),6401,0,6401,2920,219.2,6506
5515,2009,5,VSP (VALLEY SP),3836,8,3844,1980,194.1,3958
5516,2009,5,FRCC (FRCCC BAKERSFIELD),19,0,19,75,25.3,75
5517,2009,5,CCWF (CENTRAL CA WOMEN'S FAC),3882,6,3888,2004,194.0,3966
5518,2009,5,CIW (CA INSTITUTION FOR WOMEN),2376,231,2607,1356,192.3,2669
5519,2009,5,WSP (WASCO SP),5886,17,5903,2984,197.8,5920
5520,2009,5,SCC (SIERRA CONSERVATION CENTER),5703,0,5703,3736,152.6,5621
5521,2009,5,SVSP (SALINAS VALLEY SP),4193,0,4193,2388,175.6,4187
5522,2009,5,RJD (RJ DONOVAN CORRECTIONAL FAC),4751,0,4751,2200,216.0,4814
5523,2009,5,PVSP (PLEASANT VALLEY SP),4930,0,4930,2308,213.6,4922
5524,2009,5,PBSP (PELICAN BAY SP),3326,0,3326,2380,139.7,3407
5525,2009,5,NKSP (NORTH KERN SP),5310,7,5317,2694,197.4,5354
5526,2009,5,MCSP (MULE CREEK SP),3847,0,3847,1700,226.3,3812
5527,2009,5,KVSP (KERN VALLEY SP),4795,0,4795,2448,195.9,4880
5528,2009,5,ISP (IRONWOOD SP),3878,0,3878,2200,176.3,4085
5529,2009,5,HDSP (HIGH DESERT SP),4469,8,4477,2324,192.6,4486
5530,2009,5,FOL (FOLSOM SP) (MALE),4036,0,4036,2469,163.5,4078
5531,2009,5,DVI (DEUEL VOCATIONAL INSTITUTION),3824,2,3826,1681,227.6,3811
5532,2009,5,CTF (CORRECTIONAL TRAINING FAC),6071,0,6071,3312,183.3,6527
5533,2009,5,CVSP (CHUCKAWALLA VALLEY SP),3636,0,3636,1738,209.2,3737
5534,2009,5,SATF (CA SUBSTANCE ABUSE TREAT FAC),6884,5,6889,3424,201.2,7009
5535,2009,5,"SOL (CA SP, SOLANO)",4721,0,4721,2610,180.9,4850
5536,2009,5,SQ (SAN QUENTIN SP),5162,10,5172,3082,167.8,5274
5537,2009,5,"SAC (CA SP, SACRAMENTO)",2895,0,2895,1828,158.4,2979
5538,2009,5,"LAC (CA SP, LOS ANGELES COUNTY)",4546,0,4546,2400,189.4,4970
5539,2009,5,"COR (CA SP, CORCORAN)",5414,0,5414,3116,173.7,5390
5540,2009,5,CEN (CENTINELA SP),4675,0,4675,2308,202.6,4808
5541,2009,5,CAL (CALIPATRIA SP),4189,0,4189,2308,181.5,4218
5542,2009,5,"CRC (CAL REHAB CTR, MEN)",3687,545,4232,2491,169.9,4408
5543,2009,5,CMC (CA MEN'S COLONY),6403,0,6403,3838,166.8,6458
5544,2009,5,CMF (CA MEDICAL FAC),2835,0,2835,2297,123.4,3000
5545,2009,5,CIM (CA INSTITUTION FOR MEN),5936,19,5955,2976,200.1,5811
5546,2009,5,CCI (CA CORRECTIONAL INSTITUTION),5202,0,5202,2783,186.9,5732
5547,2009,5,CCC (CA CORRECTIONAL CENTER),5285,0,5285,3883,136.1,5724
5548,2009,5,ASP (AVENAL SP),6378,0,6378,2920,218.4,6506
5549,2009,6,VSP (VALLEY SP),3837,15,3852,1980,194.5,3958
5550,2009,6,FRCC (FRCCC BAKERSFIELD),74,0,74,75,98.7,75
5551,2009,6,CCWF (CENTRAL CA WOMEN'S FAC),3882,6,3888,2004,194.0,3966
5552,2009,6,CIW (CA INSTITUTION FOR WOMEN),2386,211,2597,1356,191.5,2669
5553,2009,6,WSP (WASCO SP),5846,13,5859,2984,196.3,5848
5554,2009,6,SCC (SIERRA CONSERVATION CENTER),5491,0,5491,3736,147.0,5621
5555,2009,6,SVSP (SALINAS VALLEY SP),4175,0,4175,2388,174.8,3971
5556,2009,6,RJD (RJ DONOVAN CORRECTIONAL FAC),4760,0,4760,2200,216.4,4814
5557,2009,6,PVSP (PLEASANT VALLEY SP),4925,0,4925,2308,213.4,4922
5558,2009,6,PBSP (PELICAN BAY SP),3260,0,3260,2380,137.0,3407
5559,2009,6,NKSP (NORTH KERN SP),5345,5,5350,2694,198.6,5354
5560,2009,6,MCSP (MULE CREEK SP),3784,0,3784,1700,222.6,3812
5561,2009,6,KVSP (KERN VALLEY SP),4720,0,4720,2448,192.8,4880
5562,2009,6,ISP (IRONWOOD SP),4005,0,4005,2200,182.0,4085
5563,2009,6,HDSP (HIGH DESERT SP),4380,11,4391,2324,188.9,4486
5564,2009,6,FOL (FOLSOM SP) (MALE),4035,0,4035,2469,163.4,4078
5565,2009,6,DVI (DEUEL VOCATIONAL INSTITUTION),3825,3,3828,1681,227.7,3811
5566,2009,6,CTF (CORRECTIONAL TRAINING FAC),5919,0,5919,3312,178.7,6127
5567,2009,6,CVSP (CHUCKAWALLA VALLEY SP),3468,0,3468,1738,199.5,3593
5568,2009,6,SATF (CA SUBSTANCE ABUSE TREAT FAC),6958,3,6961,3424,203.3,7009
5569,2009,6,"SOL (CA SP, SOLANO)",4777,0,4777,2610,183.0,4850
5570,2009,6,SQ (SAN QUENTIN SP),5189,8,5197,3082,168.6,5274
5571,2009,6,"SAC (CA SP, SACRAMENTO)",2867,0,2867,1828,156.8,2979
5572,2009,6,"LAC (CA SP, LOS ANGELES COUNTY)",4531,0,4531,2400,188.8,4790
5573,2009,6,"COR (CA SP, CORCORAN)",5365,0,5365,3116,172.2,5352
5574,2009,6,CEN (CENTINELA SP),4497,0,4497,2308,194.8,4628
5575,2009,6,CAL (CALIPATRIA SP),4280,0,4280,2308,185.4,4218
5576,2009,6,"CRC (CAL REHAB CTR, MEN)",3703,550,4253,2491,170.7,4408
5577,2009,6,CMC (CA MEN'S COLONY),6362,0,6362,3838,165.8,6458
5578,2009,6,CMF (CA MEDICAL FAC),2785,0,2785,2297,121.2,3000
5579,2009,6,CIM (CA INSTITUTION FOR MEN),5998,21,6019,2976,202.3,5811
5580,2009,6,CCI (CA CORRECTIONAL INSTITUTION),5358,0,5358,2783,192.5,5732
5581,2009,6,CCC (CA CORRECTIONAL CENTER),5490,0,5490,3883,141.4,5724
5582,2009,6,ASP (AVENAL SP),6347,0,6347,2920,217.4,6506
5583,2009,7,VSP (VALLEY SP),3854,13,3867,1980,195.3,3958
5584,2009,7,FRCC (FRCCC BAKERSFIELD),76,0,76,75,101.3,75
5585,2009,7,CCWF (CENTRAL CA WOMEN'S FAC),3851,5,3856,2004,192.4,3966
5586,2009,7,CIW (CA INSTITUTION FOR WOMEN),2422,205,2627,1386,189.5,2715
5587,2009,7,WSP (WASCO SP),6043,10,6053,2984,202.8,5848
5588,2009,7,SCC (SIERRA CONSERVATION CENTER),5419,0,5419,3736,145.0,5621
5589,2009,7,SVSP (SALINAS VALLEY SP),4033,0,4033,2388,168.9,3981
5590,2009,7,RJD (RJ DONOVAN CORRECTIONAL FAC),4759,0,4759,2200,216.3,4814
5591,2009,7,PVSP (PLEASANT VALLEY SP),4912,0,4912,2308,212.8,4922
5592,2009,7,PBSP (PELICAN BAY SP),3225,0,3225,2380,135.5,3407
5593,2009,7,NKSP (NORTH KERN SP),5410,6,5416,2694,201.0,5354
5594,2009,7,MCSP (MULE CREEK SP),3739,0,3739,1700,219.9,3812
5595,2009,7,KVSP (KERN VALLEY SP),4680,0,4680,2448,191.2,4825
5596,2009,7,ISP (IRONWOOD SP),4186,0,4186,2200,190.3,4325
5597,2009,7,HDSP (HIGH DESERT SP),4423,11,4434,2324,190.8,4486
5598,2009,7,FOL (FOLSOM SP) (MALE),4075,0,4075,2469,165.0,4078
5599,2009,7,DVI (DEUEL VOCATIONAL INSTITUTION),3940,6,3946,1681,234.7,3811
5600,2009,7,CTF (CORRECTIONAL TRAINING FAC),5728,0,5728,3312,172.9,6127
5601,2009,7,CVSP (CHUCKAWALLA VALLEY SP),3422,0,3422,1738,196.9,3593
5602,2009,7,SATF (CA SUBSTANCE ABUSE TREAT FAC),6861,3,6864,3424,200.5,7009
5603,2009,7,"SOL (CA SP, SOLANO)",4772,0,4772,2610,182.8,5040
5604,2009,7,SQ (SAN QUENTIN SP),5174,13,5187,3082,168.3,5274
5605,2009,7,"SAC (CA SP, SACRAMENTO)",2873,0,2873,1828,157.2,2979
5606,2009,7,"LAC (CA SP, LOS ANGELES COUNTY)",4663,0,4663,2400,194.3,4790
5607,2009,7,"COR (CA SP, CORCORAN)",5402,0,5402,3116,173.4,5352
5608,2009,7,CEN (CENTINELA SP),4523,0,4523,2308,196.0,4508
5609,2009,7,CAL (CALIPATRIA SP),4276,0,4276,2308,185.3,4218
5610,2009,7,"CRC (CAL REHAB CTR, MEN)",3697,545,4242,2491,170.3,4408
5611,2009,7,CMC (CA MEN'S COLONY),6298,0,6298,3838,164.1,6458
5612,2009,7,CMF (CA MEDICAL FAC),2695,0,2695,2297,117.3,2875
5613,2009,7,CIM (CA INSTITUTION FOR MEN),5889,24,5913,2976,198.7,6011
5614,2009,7,CCI (CA CORRECTIONAL INSTITUTION),5600,0,5600,2783,201.2,5732
5615,2009,7,CCC (CA CORRECTIONAL CENTER),5465,0,5465,3883,140.7,5724
5616,2009,7,ASP (AVENAL SP),6320,0,6320,2920,216.4,6506
5617,2009,8,VSP (VALLEY SP),3811,18,3829,1980,193.4,3902
5618,2009,8,FRCC (FRCCC BAKERSFIELD),77,0,77,75,102.7,75
5619,2009,8,CCWF (CENTRAL CA WOMEN'S FAC),3911,4,3915,2004,195.4,3966
5620,2009,8,CIW (CA INSTITUTION FOR WOMEN),2393,205,2598,1386,187.4,2715
5621,2009,8,WSP (WASCO SP),5988,11,5999,2984,201.0,5848
5622,2009,8,SCC (SIERRA CONSERVATION CENTER),5637,1,5638,3736,150.9,5621
5623,2009,8,SVSP (SALINAS VALLEY SP),3736,0,3736,2388,156.4,3981
5624,2009,8,RJD (RJ DONOVAN CORRECTIONAL FAC),4755,0,4755,2200,216.1,4814
5625,2009,8,PVSP (PLEASANT VALLEY SP),4945,0,4945,2308,214.3,4922
5626,2009,8,PBSP (PELICAN BAY SP),3211,0,3211,2380,134.9,3407
5627,2009,8,NKSP (NORTH KERN SP),5449,3,5452,2694,202.4,5354
5628,2009,8,MCSP (MULE CREEK SP),3733,0,3733,1700,219.6,3812
5629,2009,8,KVSP (KERN VALLEY SP),4691,0,4691,2448,191.6,4825
5630,2009,8,ISP (IRONWOOD SP),4044,0,4044,2200,183.8,4205
5631,2009,8,HDSP (HIGH DESERT SP),4453,13,4466,2324,192.2,4486
5632,2009,8,FOL (FOLSOM SP) (MALE),4144,0,4144,2469,167.8,4078
5633,2009,8,DVI (DEUEL VOCATIONAL INSTITUTION),3895,6,3901,1681,232.1,3811
5634,2009,8,CTF (CORRECTIONAL TRAINING FAC),5515,0,5515,3312,166.5,6127
5635,2009,8,CVSP (CHUCKAWALLA VALLEY SP),3378,0,3378,1738,194.4,3593
5636,2009,8,SATF (CA SUBSTANCE ABUSE TREAT FAC),6868,3,6871,3424,200.7,7009
5637,2009,8,"SOL (CA SP, SOLANO)",4941,0,4941,2610,189.3,5040
5638,2009,8,SQ (SAN QUENTIN SP),5233,8,5241,3082,170.1,5274
5639,2009,8,"SAC (CA SP, SACRAMENTO)",2847,1,2848,1828,155.8,2979
5640,2009,8,"LAC (CA SP, LOS ANGELES COUNTY)",4662,0,4662,2400,194.3,4790
5641,2009,8,"COR (CA SP, CORCORAN)",5340,1,5341,3116,171.4,5352
5642,2009,8,CEN (CENTINELA SP),4500,0,4500,2308,195.0,4508
5643,2009,8,CAL (CALIPATRIA SP),4264,0,4264,2308,184.7,4218
5644,2009,8,"CRC (CAL REHAB CTR, MEN)",3666,552,4218,2491,169.3,4408
5645,2009,8,CMC (CA MEN'S COLONY),6341,0,6341,3838,165.2,6458
5646,2009,8,CMF (CA MEDICAL FAC),2711,0,2711,2297,118.0,2875
5647,2009,8,CIM (CA INSTITUTION FOR MEN),4533,24,4557,2976,153.1,6011
5648,2009,8,CCI (CA CORRECTIONAL INSTITUTION),5759,0,5759,2783,206.9,5732
5649,2009,8,CCC (CA CORRECTIONAL CENTER),5528,0,5528,3883,142.4,5724
5650,2009,8,ASP (AVENAL SP),6340,0,6340,2920,217.1,6506
5651,2009,9,VSP (VALLEY SP),3839,25,3864,1980,195.2,3902
5652,2009,9,FRCC (FRCCC BAKERSFIELD),73,0,73,75,97.3,75
5653,2009,9,CCWF (CENTRAL CA WOMEN'S FAC),3887,4,3891,2004,194.2,3966
5654,2009,9,CIW (CA INSTITUTION FOR WOMEN),2450,198,2648,1386,191.1,2715
5655,2009,9,WSP (WASCO SP),5876,14,5890,2984,197.4,5848
5656,2009,9,SCC (SIERRA CONSERVATION CENTER),5559,0,5559,3736,148.8,5621
5657,2009,9,SVSP (SALINAS VALLEY SP),3696,0,3696,2388,154.8,3981
5658,2009,9,RJD (RJ DONOVAN CORRECTIONAL FAC),4689,1,4690,2200,213.2,4814
5659,2009,9,PVSP (PLEASANT VALLEY SP),4934,0,4934,2308,213.8,4922
5660,2009,9,PBSP (PELICAN BAY SP),3205,1,3206,2380,134.7,3407
5661,2009,9,NKSP (NORTH KERN SP),5444,10,5454,2694,202.4,5354
5662,2009,9,MCSP (MULE CREEK SP),3759,0,3759,1700,221.1,3812
5663,2009,9,KVSP (KERN VALLEY SP),4704,0,4704,2448,192.2,4825
5664,2009,9,ISP (IRONWOOD SP),4139,0,4139,2200,188.1,4205
5665,2009,9,HDSP (HIGH DESERT SP),4497,7,4504,2324,193.8,4486
5666,2009,9,FOL (FOLSOM SP) (MALE),3998,0,3998,2469,161.9,4078
5667,2009,9,DVI (DEUEL VOCATIONAL INSTITUTION),3868,9,3877,1681,230.6,3811
5668,2009,9,CTF (CORRECTIONAL TRAINING FAC),5635,2,5637,3312,170.2,6127
5669,2009,9,CVSP (CHUCKAWALLA VALLEY SP),3464,0,3464,1738,199.3,3593
5670,2009,9,SATF (CA SUBSTANCE ABUSE TREAT FAC),6884,2,6886,3424,201.1,7009
5671,2009,9,"SOL (CA SP, SOLANO)",5010,0,5010,2610,192.0,5040
5672,2009,9,SQ (SAN QUENTIN SP),5185,9,5194,3082,168.5,5274
5673,2009,9,"SAC (CA SP, SACRAMENTO)",2904,1,2905,1828,158.9,2979
5674,2009,9,"LAC (CA SP, LOS ANGELES COUNTY)",4732,0,4732,2400,197.2,4790
5675,2009,9,"COR (CA SP, CORCORAN)",5280,0,5280,3116,169.4,5352
5676,2009,9,CEN (CENTINELA SP),4584,0,4584,2308,198.6,4508
5677,2009,9,CAL (CALIPATRIA SP),4296,0,4296,2308,186.1,4218
5678,2009,9,"CRC (CAL REHAB CTR, MEN)",3736,545,4281,2491,171.9,4408
5679,2009,9,CMC (CA MEN'S COLONY),6446,0,6446,3838,168.0,6458
5680,2009,9,CMF (CA MEDICAL FAC),2852,0,2852,2297,124.2,2875
5681,2009,9,CIM (CA INSTITUTION FOR MEN),4773,25,4798,2976,161.2,6011
5682,2009,9,CCI (CA CORRECTIONAL INSTITUTION),5731,1,5732,2783,206.0,5732
5683,2009,9,CCC (CA CORRECTIONAL CENTER),5648,0,5648,3883,145.5,5724
5684,2009,9,ASP (AVENAL SP),6316,0,6316,2920,216.3,6506
5685,2009,10,VSP (VALLEY SP),3786,16,3802,1980,192.0,3902
5686,2009,10,FRCC (FRCCC BAKERSFIELD),71,0,71,75,94.7,75
5687,2009,10,CCWF (CENTRAL CA WOMEN'S FAC),3867,3,3870,2004,193.1,3966
5688,2009,10,CIW (CA INSTITUTION FOR WOMEN),2461,198,2659,1386,191.8,2715
5689,2009,10,WSP (WASCO SP),6005,12,6017,2984,201.6,5848
5690,2009,10,SCC (SIERRA CONSERVATION CENTER),5507,0,5507,3736,147.4,5513
5691,2009,10,SVSP (SALINAS VALLEY SP),3756,0,3756,2388,157.3,3843
5692,2009,10,RJD (RJ DONOVAN CORRECTIONAL FAC),4695,1,4696,2200,213.5,4814
5693,2009,10,PVSP (PLEASANT VALLEY SP),4926,0,4926,2308,213.4,4922
5694,2009,10,PBSP (PELICAN BAY SP),3201,0,3201,2380,134.5,3407
5695,2009,10,NKSP (NORTH KERN SP),5442,14,5456,2694,202.5,5354
5696,2009,10,MCSP (MULE CREEK SP),3749,0,3749,1700,220.5,3812
5697,2009,10,KVSP (KERN VALLEY SP),4721,1,4722,2448,192.9,4880
5698,2009,10,ISP (IRONWOOD SP),4250,0,4250,2200,193.2,4205
5699,2009,10,HDSP (HIGH DESERT SP),4484,14,4498,2324,193.5,4486
5700,2009,10,FOL (FOLSOM SP) (MALE),3909,0,3909,2469,158.3,4078
5701,2009,10,DVI (DEUEL VOCATIONAL INSTITUTION),3811,10,3821,1681,227.3,3811
5702,2009,10,CTF (CORRECTIONAL TRAINING FAC),5937,0,5937,3312,179.3,6127
5703,2009,10,CVSP (CHUCKAWALLA VALLEY SP),3519,2,3521,1738,202.6,3593
5704,2009,10,SATF (CA SUBSTANCE ABUSE TREAT FAC),6913,4,6917,3424,202.0,7009
5705,2009,10,"SOL (CA SP, SOLANO)",5095,0,5095,2610,195.2,5137
5706,2009,10,SQ (SAN QUENTIN SP),5139,5,5144,2967,173.4,5059
5707,2009,10,"SAC (CA SP, SACRAMENTO)",2903,0,2903,1828,158.8,2979
5708,2009,10,"LAC (CA SP, LOS ANGELES COUNTY)",4698,0,4698,2400,195.8,4790
5709,2009,10,"COR (CA SP, CORCORAN)",5233,0,5233,3116,167.9,5172
5710,2009,10,CEN (CENTINELA SP),4636,0,4636,2308,200.9,4628
5711,2009,10,CAL (CALIPATRIA SP),4302,1,4303,2308,186.4,4218
5712,2009,10,"CRC (CAL REHAB CTR, MEN)",3754,572,4326,2491,173.7,4408
5713,2009,10,CMC (CA MEN'S COLONY),6495,0,6495,3838,169.2,6458
5714,2009,10,CMF (CA MEDICAL FAC),2939,0,2939,2297,127.9,2875
5715,2009,10,CIM (CA INSTITUTION FOR MEN),4898,23,4921,2976,165.4,6087
5716,2009,10,CCI (CA CORRECTIONAL INSTITUTION),5920,0,5920,2783,212.7,5907
5717,2009,10,CCC (CA CORRECTIONAL CENTER),5650,0,5650,3883,145.5,5724
5718,2009,10,ASP (AVENAL SP),6429,0,6429,2920,220.2,6506
5719,2009,11,VSP (VALLEY SP),3781,17,3798,1980,191.8,3902
5720,2009,11,FRCC (FRCCC BAKERSFIELD),77,0,77,75,102.7,75
5721,2009,11,CCWF (CENTRAL CA WOMEN'S FAC),3793,3,3796,2004,189.4,3966
5722,2009,11,CIW (CA INSTITUTION FOR WOMEN),2417,193,2610,1386,188.3,2715
5723,2009,11,WSP (WASCO SP),5893,12,5905,2984,197.9,5848
5724,2009,11,SCC (SIERRA CONSERVATION CENTER),5615,0,5615,3736,150.3,5659
5725,2009,11,SVSP (SALINAS VALLEY SP),3678,0,3678,2388,154.0,3843
5726,2009,11,RJD (RJ DONOVAN CORRECTIONAL FAC),4760,1,4761,2200,216.4,4814
5727,2009,11,PVSP (PLEASANT VALLEY SP),4865,0,4865,2308,210.8,4922
5728,2009,11,PBSP (PELICAN BAY SP),3338,0,3338,2380,140.3,3502
5729,2009,11,NKSP (NORTH KERN SP),5396,8,5404,2694,200.6,5354
5730,2009,11,MCSP (MULE CREEK SP),3748,0,3748,1700,220.5,3812
5731,2009,11,KVSP (KERN VALLEY SP),4724,0,4724,2448,193.0,4880
5732,2009,11,ISP (IRONWOOD SP),4216,0,4216,2200,191.6,4205
5733,2009,11,HDSP (HIGH DESERT SP),4470,6,4476,2324,192.6,4486
5734,2009,11,FOL (FOLSOM SP) (MALE),3887,0,3887,2469,157.4,4078
5735,2009,11,DVI (DEUEL VOCATIONAL INSTITUTION),3570,7,3577,1681,212.8,3811
5736,2009,11,CTF (CORRECTIONAL TRAINING FAC),6005,0,6005,3312,181.3,6127
5737,2009,11,CVSP (CHUCKAWALLA VALLEY SP),3484,0,3484,1738,200.5,3593
5738,2009,11,SATF (CA SUBSTANCE ABUSE TREAT FAC),6876,2,6878,3424,200.9,7009
5739,2009,11,"SOL (CA SP, SOLANO)",5120,0,5120,2610,196.2,5137
5740,2009,11,SQ (SAN QUENTIN SP),4974,4,4978,2967,167.8,5059
5741,2009,11,"SAC (CA SP, SACRAMENTO)",3069,0,3069,1828,167.9,3119
5742,2009,11,"LAC (CA SP, LOS ANGELES COUNTY)",4551,0,4551,2400,189.6,4790
5743,2009,11,"COR (CA SP, CORCORAN)",5331,0,5331,3116,171.1,5311
5744,2009,11,CEN (CENTINELA SP),4589,0,4589,2308,198.8,4628
5745,2009,11,CAL (CALIPATRIA SP),4272,0,4272,2308,185.1,4218
5746,2009,11,"CRC (CAL REHAB CTR, MEN)",3762,586,4348,2491,174.5,4408
5747,2009,11,CMC (CA MEN'S COLONY),6496,0,6496,3838,169.3,6458
5748,2009,11,CMF (CA MEDICAL FAC),2889,0,2889,2297,125.8,2875
5749,2009,11,CIM (CA INSTITUTION FOR MEN),4702,28,4730,2976,158.9,6087
5750,2009,11,CCI (CA CORRECTIONAL INSTITUTION),5859,1,5860,2783,210.6,5907
5751,2009,11,CCC (CA CORRECTIONAL CENTER),5606,0,5606,3883,144.4,5724
5752,2009,11,ASP (AVENAL SP),6578,0,6578,2920,225.3,6700
5753,2009,12,VSP (VALLEY SP),3809,12,3821,1980,193.0,3902
5754,2009,12,FRCC (FRCCC BAKERSFIELD),76,0,76,75,101.3,75
5755,2009,12,CCWF (CENTRAL CA WOMEN'S FAC),3828,5,3833,2004,191.3,3886
5756,2009,12,CIW (CA INSTITUTION FOR WOMEN),2386,207,2593,1386,187.1,2715
5757,2009,12,WSP (WASCO SP),5859,12,5871,2984,196.7,5848
5758,2009,12,SCC (SIERRA CONSERVATION CENTER),5614,0,5614,3736,150.3,5659
5759,2009,12,SVSP (SALINAS VALLEY SP),3622,0,3622,2388,151.7,3843
5760,2009,12,RJD (RJ DONOVAN CORRECTIONAL FAC),4709,1,4710,2200,214.1,4814
5761,2009,12,PVSP (PLEASANT VALLEY SP),4868,0,4868,2308,210.9,4922
5762,2009,12,PBSP (PELICAN BAY SP),3370,0,3370,2380,141.6,3449
5763,2009,12,NKSP (NORTH KERN SP),5321,12,5333,2694,198.0,5354
5764,2009,12,MCSP (MULE CREEK SP),3797,0,3797,1700,223.4,3812
5765,2009,12,KVSP (KERN VALLEY SP),4804,0,4804,2448,196.2,4880
5766,2009,12,ISP (IRONWOOD SP),4237,0,4237,2200,192.6,4205
5767,2009,12,HDSP (HIGH DESERT SP),4476,8,4484,2324,192.9,4486
5768,2009,12,FOL (FOLSOM SP) (MALE),3818,1,3819,2469,154.7,3778
5769,2009,12,DVI (DEUEL VOCATIONAL INSTITUTION),3621,6,3627,1681,215.8,3811
5770,2009,12,CTF (CORRECTIONAL TRAINING FAC),6064,0,6064,3312,183.1,6247
5771,2009,12,CVSP (CHUCKAWALLA VALLEY SP),3483,0,3483,1738,200.4,3593
5772,2009,12,SATF (CA SUBSTANCE ABUSE TREAT FAC),6889,4,6893,3424,201.3,7009
5773,2009,12,"SOL (CA SP, SOLANO)",5082,0,5082,2610,194.7,5137
5774,2009,12,SQ (SAN QUENTIN SP),4941,5,4946,2967,166.7,4727
5775,2009,12,"SAC (CA SP, SACRAMENTO)",3058,0,3058,1828,167.3,3119
5776,2009,12,"LAC (CA SP, LOS ANGELES COUNTY)",4571,0,4571,2300,198.7,4690
5777,2009,12,"COR (CA SP, CORCORAN)",5479,1,5480,3116,175.9,5311
5778,2009,12,CEN (CENTINELA SP),4676,0,4676,2308,202.6,4628
5779,2009,12,CAL (CALIPATRIA SP),4311,0,4311,2308,186.8,4218
5780,2009,12,"CRC (CAL REHAB CTR, MEN)",3789,604,4393,2491,176.4,4408
5781,2009,12,CMC (CA MEN'S COLONY),6497,0,6497,3838,169.3,6458
5782,2009,12,CMF (CA MEDICAL FAC),2873,0,2873,2297,125.1,2875
5783,2009,12,CIM (CA INSTITUTION FOR MEN),5266,29,5295,2976,177.9,6087
5784,2009,12,CCI (CA CORRECTIONAL INSTITUTION),5937,1,5938,2783,213.4,5907
5785,2009,12,CCC (CA CORRECTIONAL CENTER),5596,0,5596,3883,144.1,5724
5786,2009,12,ASP (AVENAL SP),6786,0,6786,2920,232.4,6700
5787,2010,1,VSP (VALLEY SP),3681,12,3693,1980,186.5,3866
5788,2010,1,FRCC (FRCCC BAKERSFIELD),73,0,73,75,97.3,75
5789,2010,1,CCWF (CENTRAL CA WOMEN'S FAC),3809,5,3814,2004,190.3,3886
5790,2010,1,CIW (CA INSTITUTION FOR WOMEN),2357,211,2568,1386,185.3,2715
5791,2010,1,WSP (WASCO SP),5925,11,5936,2984,198.9,5800
5792,2010,1,SCC (SIERRA CONSERVATION CENTER),5474,0,5474,3736,146.5,5659
5793,2010,1,SVSP (SALINAS VALLEY SP),3777,0,3777,2388,158.2,3843
5794,2010,1,RJD (RJ DONOVAN CORRECTIONAL FAC),4610,2,4612,2200,209.6,4814
5795,2010,1,PVSP (PLEASANT VALLEY SP),4848,0,4848,2308,210.1,4922
5796,2010,1,PBSP (PELICAN BAY SP),3365,0,3365,2380,141.4,3449
5797,2010,1,NKSP (NORTH KERN SP),5376,10,5386,2694,199.9,5354
5798,2010,1,MCSP (MULE CREEK SP),3791,0,3791,1700,223.0,3812
5799,2010,1,KVSP (KERN VALLEY SP),4773,0,4773,2448,195.0,4880
5800,2010,1,ISP (IRONWOOD SP),4120,0,4120,2200,187.3,4205
5801,2010,1,HDSP (HIGH DESERT SP),4474,9,4483,2324,192.9,4486
5802,2010,1,FOL (FOLSOM SP) (MALE),3732,1,3733,2469,151.2,3675
5803,2010,1,DVI (DEUEL VOCATIONAL INSTITUTION),3727,14,3741,1681,222.5,3811
5804,2010,1,CTF (CORRECTIONAL TRAINING FAC),6198,0,6198,3312,187.1,6247
5805,2010,1,CVSP (CHUCKAWALLA VALLEY SP),3471,0,3471,1738,199.7,3593
5806,2010,1,SATF (CA SUBSTANCE ABUSE TREAT FAC),6713,6,6719,3424,196.2,6944
5807,2010,1,"SOL (CA SP, SOLANO)",5065,1,5066,2610,194.1,5137
5808,2010,1,SQ (SAN QUENTIN SP),4778,2,4780,2967,161.1,4727
5809,2010,1,"SAC (CA SP, SACRAMENTO)",3033,0,3033,1828,165.9,3119
5810,2010,1,"LAC (CA SP, LOS ANGELES COUNTY)",4582,0,4582,2400,190.9,4790
5811,2010,1,"COR (CA SP, CORCORAN)",5471,0,5471,3116,175.6,5453
5812,2010,1,CEN (CENTINELA SP),4634,0,4634,2308,200.8,4628
5813,2010,1,CAL (CALIPATRIA SP),4283,0,4283,2308,185.6,4218
5814,2010,1,"CRC (CAL REHAB CTR, MEN)",3732,575,4307,2491,172.9,4408
5815,2010,1,CMC (CA MEN'S COLONY),6492,0,6492,3838,169.2,6458
5816,2010,1,CMF (CA MEDICAL FAC),2800,0,2800,2297,121.9,2801
5817,2010,1,CIM (CA INSTITUTION FOR MEN),5089,30,5119,2976,172.0,6087
5818,2010,1,CCI (CA CORRECTIONAL INSTITUTION),5912,1,5913,2783,212.5,5907
5819,2010,1,CCC (CA CORRECTIONAL CENTER),5476,0,5476,3883,141.0,5724
5820,2010,1,ASP (AVENAL SP),6687,0,6687,2920,229.0,6700
5821,2010,2,VSP (VALLEY SP),3577,9,3586,1980,181.1,3764
5822,2010,2,FRCC (FRCCC BAKERSFIELD),78,0,78,75,104.0,75
5823,2010,2,CCWF (CENTRAL CA WOMEN'S FAC),3733,3,3736,2004,186.4,3937
5824,2010,2,CIW (CA INSTITUTION FOR WOMEN),2357,212,2569,1386,185.4,2715
5825,2010,2,WSP (WASCO SP),5933,9,5942,2984,199.1,5800
5826,2010,2,SCC (SIERRA CONSERVATION CENTER),5440,0,5440,3736,145.6,5659
5827,2010,2,SVSP (SALINAS VALLEY SP),3763,0,3763,2388,157.6,3793
5828,2010,2,RJD (RJ DONOVAN CORRECTIONAL FAC),4631,2,4633,2200,210.6,4754
5829,2010,2,PVSP (PLEASANT VALLEY SP),4840,0,4840,2308,209.7,4872
5830,2010,2,PBSP (PELICAN BAY SP),3347,0,3347,2380,140.6,3449
5831,2010,2,NKSP (NORTH KERN SP),5444,6,5450,2694,202.3,5354
5832,2010,2,MCSP (MULE CREEK SP),3733,0,3733,1700,219.6,3812
5833,2010,2,KVSP (KERN VALLEY SP),4780,0,4780,2448,195.3,4880
5834,2010,2,ISP (IRONWOOD SP),4090,0,4090,2200,185.9,4085
5835,2010,2,HDSP (HIGH DESERT SP),4547,6,4553,2324,195.9,4486
5836,2010,2,FOL (FOLSOM SP) (MALE),3722,1,3723,2469,150.8,3675
5837,2010,2,DVI (DEUEL VOCATIONAL INSTITUTION),3805,12,3817,1681,227.1,3811
5838,2010,2,CTF (CORRECTIONAL TRAINING FAC),6147,0,6147,3312,185.6,6247
5839,2010,2,CVSP (CHUCKAWALLA VALLEY SP),3400,0,3400,1738,195.6,3593
5840,2010,2,SATF (CA SUBSTANCE ABUSE TREAT FAC),6714,5,6719,3424,196.2,6944
5841,2010,2,"SOL (CA SP, SOLANO)",5047,0,5047,2610,193.4,5137
5842,2010,2,SQ (SAN QUENTIN SP),4919,2,4921,2967,165.9,4727
5843,2010,2,"SAC (CA SP, SACRAMENTO)",3013,0,3013,1828,164.8,3119
5844,2010,2,"LAC (CA SP, LOS ANGELES COUNTY)",4598,0,4598,2400,191.6,4790
5845,2010,2,"COR (CA SP, CORCORAN)",5497,0,5497,3116,176.4,5453
5846,2010,2,CEN (CENTINELA SP),4556,0,4556,2308,197.4,4628
5847,2010,2,CAL (CALIPATRIA SP),4201,0,4201,2308,182.0,4218
5848,2010,2,"CRC (CAL REHAB CTR, MEN)",3811,581,4392,2491,176.3,4408
5849,2010,2,CMC (CA MEN'S COLONY),6459,0,6459,3838,168.3,6458
5850,2010,2,CMF (CA MEDICAL FAC),2702,0,2702,2297,117.6,2801
5851,2010,2,CIM (CA INSTITUTION FOR MEN),5021,31,5052,2976,169.8,6087
5852,2010,2,CCI (CA CORRECTIONAL INSTITUTION),5915,1,5916,2783,212.6,5907
5853,2010,2,CCC (CA CORRECTIONAL CENTER),5476,0,5476,3883,141.0,5724
5854,2010,2,ASP (AVENAL SP),6403,0,6403,2920,219.3,6576
5855,2010,3,VSP (VALLEY SP),3544,17,3561,1980,179.8,3687
5856,2010,3,FRCC (FRCCC BAKERSFIELD),74,0,74,75,98.7,75
5857,2010,3,CCWF (CENTRAL CA WOMEN'S FAC),3726,2,3728,2004,186.0,3886
5858,2010,3,CIW (CA INSTITUTION FOR WOMEN),2313,208,2521,1386,181.9,2715
5859,2010,3,WSP (WASCO SP),5904,3,5907,2984,198.0,5800
5860,2010,3,SCC (SIERRA CONSERVATION CENTER),5480,0,5480,3736,146.7,5659
5861,2010,3,SVSP (SALINAS VALLEY SP),3741,0,3741,2388,156.7,3793
5862,2010,3,RJD (RJ DONOVAN CORRECTIONAL FAC),4638,2,4640,2200,210.9,4754
5863,2010,3,PVSP (PLEASANT VALLEY SP),4716,0,4716,2308,204.3,4752
5864,2010,3,PBSP (PELICAN BAY SP),3364,0,3364,2380,141.3,3449
5865,2010,3,NKSP (NORTH KERN SP),5350,10,5360,2694,199.0,5354
5866,2010,3,MCSP (MULE CREEK SP),3804,0,3804,1700,223.8,3812
5867,2010,3,KVSP (KERN VALLEY SP),4799,0,4799,2448,196.0,4880
5868,2010,3,ISP (IRONWOOD SP),4165,0,4165,2200,189.3,4085
5869,2010,3,HDSP (HIGH DESERT SP),4493,1,4494,2324,193.4,4486
5870,2010,3,FOL (FOLSOM SP) (MALE),3744,1,3745,2469,151.7,3675
5871,2010,3,DVI (DEUEL VOCATIONAL INSTITUTION),3811,12,3823,1681,227.4,3811
5872,2010,3,CTF (CORRECTIONAL TRAINING FAC),6164,0,6164,3312,186.1,6247
5873,2010,3,CVSP (CHUCKAWALLA VALLEY SP),3462,0,3462,1738,199.2,3593
5874,2010,3,SATF (CA SUBSTANCE ABUSE TREAT FAC),6723,4,6727,3424,196.5,6892
5875,2010,3,"SOL (CA SP, SOLANO)",5084,0,5084,2610,194.8,5137
5876,2010,3,SQ (SAN QUENTIN SP),4842,5,4847,2967,163.4,4727
5877,2010,3,"SAC (CA SP, SACRAMENTO)",2921,0,2921,1828,159.8,2979
5878,2010,3,"LAC (CA SP, LOS ANGELES COUNTY)",4567,0,4567,2400,190.3,4730
5879,2010,3,"COR (CA SP, CORCORAN)",5480,1,5481,3116,175.9,5453
5880,2010,3,CEN (CENTINELA SP),4501,0,4501,2308,195.0,4508
5881,2010,3,CAL (CALIPATRIA SP),4173,0,4173,2308,180.8,4218
5882,2010,3,"CRC (CAL REHAB CTR, MEN)",3743,573,4316,2491,173.3,4408
5883,2010,3,CMC (CA MEN'S COLONY),6443,0,6443,3838,167.9,6458
5884,2010,3,CMF (CA MEDICAL FAC),2694,0,2694,2297,117.3,2801
5885,2010,3,CIM (CA INSTITUTION FOR MEN),4937,28,4965,2976,166.8,5887
5886,2010,3,CCI (CA CORRECTIONAL INSTITUTION),5874,1,5875,2783,211.1,5907
5887,2010,3,CCC (CA CORRECTIONAL CENTER),5472,0,5472,3883,140.9,5724
5888,2010,3,ASP (AVENAL SP),6432,0,6432,2920,220.3,6576
5889,2010,4,VSP (VALLEY SP),3492,9,3501,1980,176.8,3687
5890,2010,4,FRCC (FRCCC BAKERSFIELD),74,0,74,75,98.7,75
5891,2010,4,CCWF (CENTRAL CA WOMEN'S FAC),3740,2,3742,2004,186.7,3886
5892,2010,4,CIW (CA INSTITUTION FOR WOMEN),2284,220,2504,1386,180.7,2715
5893,2010,4,WSP (WASCO SP),6069,4,6073,2984,203.5,5800
5894,2010,4,SCC (SIERRA CONSERVATION CENTER),5520,0,5520,3736,147.8,5659
5895,2010,4,SVSP (SALINAS VALLEY SP),3778,0,3778,2388,158.2,3793
5896,2010,4,RJD (RJ DONOVAN CORRECTIONAL FAC),4605,1,4606,2200,209.4,4754
5897,2010,4,PVSP (PLEASANT VALLEY SP),4694,0,4694,2308,203.4,4752
5898,2010,4,PBSP (PELICAN BAY SP),3324,0,3324,2380,139.7,3449
5899,2010,4,NKSP (NORTH KERN SP),5463,7,5470,2694,203.0,5354
5900,2010,4,MCSP (MULE CREEK SP),3722,0,3722,1700,218.9,3812
5901,2010,4,KVSP (KERN VALLEY SP),4783,0,4783,2448,195.4,4880
5902,2010,4,ISP (IRONWOOD SP),4065,0,4065,2200,184.8,4085
5903,2010,4,HDSP (HIGH DESERT SP),4499,1,4500,2324,193.6,4486
5904,2010,4,FOL (FOLSOM SP) (MALE),3714,0,3714,2469,150.4,3675
5905,2010,4,DVI (DEUEL VOCATIONAL INSTITUTION),3866,6,3872,1681,230.3,3811
5906,2010,4,CTF (CORRECTIONAL TRAINING FAC),6295,0,6295,3312,190.1,6247
5907,2010,4,CVSP (CHUCKAWALLA VALLEY SP),3491,0,3491,1738,200.9,3593
5908,2010,4,SATF (CA SUBSTANCE ABUSE TREAT FAC),6546,4,6550,3424,191.3,6892
5909,2010,4,"SOL (CA SP, SOLANO)",5102,0,5102,2610,195.5,5137
5910,2010,4,SQ (SAN QUENTIN SP),4916,5,4921,2967,165.9,4727
5911,2010,4,"SAC (CA SP, SACRAMENTO)",2943,0,2943,1828,161.0,2979
5912,2010,4,"LAC (CA SP, LOS ANGELES COUNTY)",4588,0,4588,2400,191.2,4730
5913,2010,4,"COR (CA SP, CORCORAN)",5318,0,5318,3116,170.7,5453
5914,2010,4,CEN (CENTINELA SP),4461,0,4461,2308,193.3,4508
5915,2010,4,CAL (CALIPATRIA SP),4175,0,4175,2308,180.9,4218
5916,2010,4,"CRC (CAL REHAB CTR, MEN)",3815,542,4357,2491,174.9,4408
5917,2010,4,CMC (CA MEN'S COLONY),6434,0,6434,3838,167.6,6458
5918,2010,4,CMF (CA MEDICAL FAC),2604,1,2605,2297,113.4,2801
5919,2010,4,CIM (CA INSTITUTION FOR MEN),5034,26,5060,2976,170.0,5887
5920,2010,4,CCI (CA CORRECTIONAL INSTITUTION),5956,1,5957,2783,214.0,5907
5921,2010,4,CCC (CA CORRECTIONAL CENTER),5506,0,5506,3883,141.8,5724
5922,2010,4,ASP (AVENAL SP),6357,0,6357,2920,217.7,6576
5923,2010,5,VSP (VALLEY SP),3450,9,3459,1980,174.7,3559
5924,2010,5,FRCC (FRCCC BAKERSFIELD),76,0,76,75,101.3,75
5925,2010,5,CCWF (CENTRAL CA WOMEN'S FAC),3673,3,3676,2004,183.4,3859
5926,2010,5,CIW (CA INSTITUTION FOR WOMEN),2295,207,2502,1386,180.5,2545
5927,2010,5,WSP (WASCO SP),5814,15,5829,2984,195.3,5800
5928,2010,5,SCC (SIERRA CONSERVATION CENTER),5466,0,5466,3736,146.3,5391
5929,2010,5,SVSP (SALINAS VALLEY SP),3794,0,3794,2388,158.9,3793
5930,2010,5,RJD (RJ DONOVAN CORRECTIONAL FAC),4571,1,4572,2200,207.8,4662
5931,2010,5,PVSP (PLEASANT VALLEY SP),4631,0,4631,2308,200.6,4722
5932,2010,5,PBSP (PELICAN BAY SP),3318,0,3318,2380,139.4,3449
5933,2010,5,NKSP (NORTH KERN SP),5474,5,5479,2694,203.4,5354
5934,2010,5,MCSP (MULE CREEK SP),3762,0,3762,1700,221.3,3732
5935,2010,5,KVSP (KERN VALLEY SP),4819,0,4819,2448,196.9,4880
5936,2010,5,ISP (IRONWOOD SP),4064,0,4064,2200,184.7,4085
5937,2010,5,HDSP (HIGH DESERT SP),4483,5,4488,2324,193.1,4486
5938,2010,5,FOL (FOLSOM SP) (MALE),3663,0,3663,2469,148.4,3675
5939,2010,5,DVI (DEUEL VOCATIONAL INSTITUTION),3848,9,3857,1681,229.4,3811
5940,2010,5,CTF (CORRECTIONAL TRAINING FAC),6315,0,6315,3312,190.7,6327
5941,2010,5,CVSP (CHUCKAWALLA VALLEY SP),3530,0,3530,1738,203.1,3593
5942,2010,5,SATF (CA SUBSTANCE ABUSE TREAT FAC),6611,3,6614,3424,193.2,6636
5943,2010,5,"SOL (CA SP, SOLANO)",5100,0,5100,2610,195.4,5137
5944,2010,5,SQ (SAN QUENTIN SP),4879,6,4885,2967,164.6,4727
5945,2010,5,"SAC (CA SP, SACRAMENTO)",2923,0,2923,1828,159.9,2979
5946,2010,5,"LAC (CA SP, LOS ANGELES COUNTY)",4521,0,4521,2400,188.4,4730
5947,2010,5,"COR (CA SP, CORCORAN)",5220,0,5220,3116,167.5,5423
5948,2010,5,CEN (CENTINELA SP),4424,0,4424,2308,191.7,4508
5949,2010,5,CAL (CALIPATRIA SP),4221,0,4221,2308,182.9,4218
5950,2010,5,"CRC (CAL REHAB CTR, MEN)",3829,524,4353,2491,174.7,4408
5951,2010,5,CMC (CA MEN'S COLONY),6459,0,6459,3838,168.3,6458
5952,2010,5,CMF (CA MEDICAL FAC),2589,0,2589,2297,112.7,2561
5953,2010,5,CIM (CA INSTITUTION FOR MEN),5030,16,5046,2976,169.6,5887
5954,2010,5,CCI (CA CORRECTIONAL INSTITUTION),5845,1,5846,2783,210.1,5907
5955,2010,5,CCC (CA CORRECTIONAL CENTER),5471,0,5471,3883,140.9,5583
5956,2010,5,ASP (AVENAL SP),6249,0,6249,2920,214.0,6576
5957,2010,6,VSP (VALLEY SP),3398,7,3405,1980,172.0,3486
5958,2010,6,FRCC (FRCCC BAKERSFIELD),75,0,75,75,100.0,75
5959,2010,6,CCWF (CENTRAL CA WOMEN'S FAC),3737,3,3740,2004,186.6,3859
5960,2010,6,CIW (CA INSTITUTION FOR WOMEN),2224,188,2412,1386,174.0,2545
5961,2010,6,WSP (WASCO SP),5972,6,5978,2984,200.3,5800
5962,2010,6,SCC (SIERRA CONSERVATION CENTER),5410,0,5410,3736,144.8,5391
5963,2010,6,SVSP (SALINAS VALLEY SP),3715,0,3715,2388,155.6,3793
5964,2010,6,RJD (RJ DONOVAN CORRECTIONAL FAC),4658,1,4659,2200,211.8,4814
5965,2010,6,PVSP (PLEASANT VALLEY SP),4605,0,4605,2308,199.5,4722
5966,2010,6,PBSP (PELICAN BAY SP),3302,0,3302,2380,138.7,3449
5967,2010,6,NKSP (NORTH KERN SP),5416,8,5424,2694,201.3,5354
5968,2010,6,MCSP (MULE CREEK SP),3781,0,3781,1700,222.4,3732
5969,2010,6,KVSP (KERN VALLEY SP),4766,0,4766,2448,194.7,4880
5970,2010,6,ISP (IRONWOOD SP),3932,0,3932,2200,178.7,4085
5971,2010,6,HDSP (HIGH DESERT SP),4451,3,4454,2324,191.7,4486
5972,2010,6,FOL (FOLSOM SP) (MALE),3590,0,3590,2469,145.4,3675
5973,2010,6,DVI (DEUEL VOCATIONAL INSTITUTION),3830,5,3835,1681,228.1,3811
5974,2010,6,CTF (CORRECTIONAL TRAINING FAC),6358,1,6359,3312,192.0,6327
5975,2010,6,CVSP (CHUCKAWALLA VALLEY SP),3559,0,3559,1738,204.8,3687
5976,2010,6,SATF (CA SUBSTANCE ABUSE TREAT FAC),6756,3,6759,3424,197.4,6756
5977,2010,6,"SOL (CA SP, SOLANO)",5079,0,5079,2610,194.6,5137
5978,2010,6,SQ (SAN QUENTIN SP),4840,5,4845,2967,163.3,4727
5979,2010,6,"SAC (CA SP, SACRAMENTO)",2918,0,2918,1828,159.6,2979
5980,2010,6,"LAC (CA SP, LOS ANGELES COUNTY)",4466,0,4466,2400,186.1,4730
5981,2010,6,"COR (CA SP, CORCORAN)",5192,0,5192,3116,166.6,5423
5982,2010,6,CEN (CENTINELA SP),4428,0,4428,2308,191.9,4508
5983,2010,6,CAL (CALIPATRIA SP),4081,0,4081,2308,176.8,4218
5984,2010,6,"CRC (CAL REHAB CTR, MEN)",3760,507,4267,2491,171.3,4408
5985,2010,6,CMC (CA MEN'S COLONY),6438,0,6438,3838,167.7,6458
5986,2010,6,CMF (CA MEDICAL FAC),2597,0,2597,2297,113.1,2561
5987,2010,6,CIM (CA INSTITUTION FOR MEN),4814,14,4828,2976,162.2,5887
5988,2010,6,CCI (CA CORRECTIONAL INSTITUTION),5924,1,5925,2783,212.9,5907
5989,2010,6,CCC (CA CORRECTIONAL CENTER),5524,0,5524,3883,142.3,5583
5990,2010,6,ASP (AVENAL SP),6692,0,6692,2920,229.2,6726
5991,2010,7,VSP (VALLEY SP),3376,11,3387,1980,171.1,3486
5992,2010,7,FRCC (FRCCC BAKERSFIELD),79,0,79,75,105.3,75
5993,2010,7,CCWF (CENTRAL CA WOMEN'S FAC),3640,4,3644,2004,181.8,3859
5994,2010,7,CIW (CA INSTITUTION FOR WOMEN),2222,182,2404,1386,173.4,2521
5995,2010,7,WSP (WASCO SP),5789,10,5799,2984,194.3,5800
5996,2010,7,SCC (SIERRA CONSERVATION CENTER),5335,0,5335,3736,142.8,5391
5997,2010,7,SVSP (SALINAS VALLEY SP),3657,0,3657,2388,153.1,3793
5998,2010,7,RJD (RJ DONOVAN CORRECTIONAL FAC),4648,1,4649,2200,211.3,4814
5999,2010,7,PVSP (PLEASANT VALLEY SP),4626,0,4626,2308,200.4,4722
6000,2010,7,PBSP (PELICAN BAY SP),3278,0,3278,2380,137.7,3449
6001,2010,7,NKSP (NORTH KERN SP),5241,10,5251,2694,194.9,5354
6002,2010,7,MCSP (MULE CREEK SP),3772,0,3772,1700,221.9,3732
6003,2010,7,KVSP (KERN VALLEY SP),4571,0,4571,2448,186.7,4884
6004,2010,7,ISP (IRONWOOD SP),3923,0,3923,2200,178.3,4085
6005,2010,7,HDSP (HIGH DESERT SP),4454,7,4461,2324,192.0,4486
6006,2010,7,FOL (FOLSOM SP) (MALE),3572,0,3572,2469,144.7,3675
6007,2010,7,DVI (DEUEL VOCATIONAL INSTITUTION),3853,22,3875,1681,230.5,3811
6008,2010,7,CTF (CORRECTIONAL TRAINING FAC),6472,0,6472,3312,195.4,6127
6009,2010,7,CVSP (CHUCKAWALLA VALLEY SP),3512,0,3512,1738,202.1,3687
6010,2010,7,SATF (CA SUBSTANCE ABUSE TREAT FAC),6598,4,6602,3424,192.8,6678
6011,2010,7,"SOL (CA SP, SOLANO)",5121,0,5121,2610,196.2,5137
6012,2010,7,SQ (SAN QUENTIN SP),5098,5,5103,2967,172.0,5014
6013,2010,7,"SAC (CA SP, SACRAMENTO)",2919,0,2919,1828,159.7,2979
6014,2010,7,"LAC (CA SP, LOS ANGELES COUNTY)",4594,0,4594,2400,191.4,4790
6015,2010,7,"COR (CA SP, CORCORAN)",5191,0,5191,3116,166.6,5281
6016,2010,7,CEN (CENTINELA SP),4338,0,4338,2308,188.0,4508
6017,2010,7,CAL (CALIPATRIA SP),4114,0,4114,2308,178.2,4218
6018,2010,7,"CRC (CAL REHAB CTR, MEN)",3909,488,4397,2491,176.5,4408
6019,2010,7,CMC (CA MEN'S COLONY),6451,0,6451,3838,168.1,6458
6020,2010,7,CMF (CA MEDICAL FAC),2604,0,2604,2297,113.4,2593
6021,2010,7,CIM (CA INSTITUTION FOR MEN),4469,14,4483,2976,150.6,5887
6022,2010,7,CCI (CA CORRECTIONAL INSTITUTION),5962,2,5964,2783,214.3,5732
6023,2010,7,CCC (CA CORRECTIONAL CENTER),5561,0,5561,3883,143.2,5585
6024,2010,7,ASP (AVENAL SP),6626,0,6626,2920,226.9,6726
6025,2010,8,VSP (VALLEY SP),3381,10,3391,1980,171.3,3486
6026,2010,8,FRCC (FRCCC BAKERSFIELD),75,0,75,75,100.0,75
6027,2010,8,CCWF (CENTRAL CA WOMEN'S FAC),3723,5,3728,2004,186.0,3782
6028,2010,8,CIW (CA INSTITUTION FOR WOMEN),2163,172,2335,1386,168.5,2425
6029,2010,8,WSP (WASCO SP),5884,5,5889,2984,197.4,5800
6030,2010,8,SCC (SIERRA CONSERVATION CENTER),5286,0,5286,3736,141.5,5391
6031,2010,8,SVSP (SALINAS VALLEY SP),3750,0,3750,2388,157.0,3793
6032,2010,8,RJD (RJ DONOVAN CORRECTIONAL FAC),4499,1,4500,2200,204.5,4706
6033,2010,8,PVSP (PLEASANT VALLEY SP),4666,0,4666,2308,202.2,4722
6034,2010,8,PBSP (PELICAN BAY SP),3272,0,3272,2380,137.5,3351
6035,2010,8,NKSP (NORTH KERN SP),5372,10,5382,2694,199.8,5304
6036,2010,8,MCSP (MULE CREEK SP),3749,0,3749,1700,220.5,3732
6037,2010,8,KVSP (KERN VALLEY SP),4336,0,4336,2448,177.1,4884
6038,2010,8,ISP (IRONWOOD SP),3907,0,3907,2200,177.6,4035
6039,2010,8,HDSP (HIGH DESERT SP),4313,5,4318,2324,185.8,4316
6040,2010,8,FOL (FOLSOM SP) (MALE),3561,0,3561,2469,144.2,3675
6041,2010,8,DVI (DEUEL VOCATIONAL INSTITUTION),3828,31,3859,1681,229.6,3811
6042,2010,8,CTF (CORRECTIONAL TRAINING FAC),6520,1,6521,3312,196.9,6127
6043,2010,8,CVSP (CHUCKAWALLA VALLEY SP),3583,0,3583,1738,206.2,3687
6044,2010,8,SATF (CA SUBSTANCE ABUSE TREAT FAC),6551,5,6556,3424,191.5,6540
6045,2010,8,"SOL (CA SP, SOLANO)",5102,0,5102,2610,195.5,5137
6046,2010,8,SQ (SAN QUENTIN SP),5104,0,5104,2967,172.0,5014
6047,2010,8,"SAC (CA SP, SACRAMENTO)",2908,0,2908,1828,159.1,2979
6048,2010,8,"LAC (CA SP, LOS ANGELES COUNTY)",4515,0,4515,2300,196.3,4640
6049,2010,8,"COR (CA SP, CORCORAN)",5136,1,5137,3116,164.9,5158
6050,2010,8,CEN (CENTINELA SP),4271,0,4271,2308,185.1,4338
6051,2010,8,CAL (CALIPATRIA SP),4169,0,4169,2308,180.6,4168
6052,2010,8,"CRC (CAL REHAB CTR, MEN)",3822,491,4313,2491,173.1,4408
6053,2010,8,CMC (CA MEN'S COLONY),6425,0,6425,3838,167.4,6458
6054,2010,8,CMF (CA MEDICAL FAC),2603,0,2603,2297,113.3,2593
6055,2010,8,CIM (CA INSTITUTION FOR MEN),4246,15,4261,2976,143.2,5813
6056,2010,8,CCI (CA CORRECTIONAL INSTITUTION),5937,0,5937,2783,213.3,5852
6057,2010,8,CCC (CA CORRECTIONAL CENTER),5591,0,5591,3883,144.0,5585
6058,2010,8,ASP (AVENAL SP),6444,0,6444,2920,220.7,6576
6059,2010,9,VSP (VALLEY SP),3393,6,3399,1980,171.7,3486
6060,2010,9,FRCC (FRCCC BAKERSFIELD),65,0,65,75,86.7,75
6061,2010,9,CCWF (CENTRAL CA WOMEN'S FAC),3788,5,3793,2004,189.3,3782
6062,2010,9,CIW (CA INSTITUTION FOR WOMEN),2147,170,2317,1386,167.2,2353
6063,2010,9,WSP (WASCO SP),5892,5,5897,2984,197.6,5752
6064,2010,9,SCC (SIERRA CONSERVATION CENTER),5371,0,5371,3736,143.8,5391
6065,2010,9,SVSP (SALINAS VALLEY SP),3763,0,3763,2388,157.6,3801
6066,2010,9,RJD (RJ DONOVAN CORRECTIONAL FAC),4336,1,4337,2200,197.1,4666
6067,2010,9,PVSP (PLEASANT VALLEY SP),4650,0,4650,2308,201.5,4722
6068,2010,9,PBSP (PELICAN BAY SP),3229,0,3229,2380,135.7,3351
6069,2010,9,NKSP (NORTH KERN SP),5336,8,5344,2694,198.4,5304
6070,2010,9,MCSP (MULE CREEK SP),3726,0,3726,1700,219.2,3732
6071,2010,9,KVSP (KERN VALLEY SP),4557,0,4557,2448,186.2,4884
6072,2010,9,ISP (IRONWOOD SP),3959,0,3959,2200,180.0,4035
6073,2010,9,HDSP (HIGH DESERT SP),4316,1,4317,2324,185.8,4316
6074,2010,9,FOL (FOLSOM SP) (MALE),3508,0,3508,2469,142.1,3675
6075,2010,9,DVI (DEUEL VOCATIONAL INSTITUTION),3848,8,3856,1681,229.4,3811
6076,2010,9,CTF (CORRECTIONAL TRAINING FAC),6414,0,6414,3312,193.7,6127
6077,2010,9,CVSP (CHUCKAWALLA VALLEY SP),3479,0,3479,1738,200.2,3447
6078,2010,9,SATF (CA SUBSTANCE ABUSE TREAT FAC),6463,5,6468,3424,188.9,6540
6079,2010,9,"SOL (CA SP, SOLANO)",5033,0,5033,2610,192.8,5040
6080,2010,9,SQ (SAN QUENTIN SP),5109,2,5111,2967,172.3,5014
6081,2010,9,"SAC (CA SP, SACRAMENTO)",2933,0,2933,1828,160.4,2979
6082,2010,9,"LAC (CA SP, LOS ANGELES COUNTY)",4481,0,4481,2300,194.8,4640
6083,2010,9,"COR (CA SP, CORCORAN)",5094,1,5095,3116,163.5,5158
6084,2010,9,CEN (CENTINELA SP),4124,0,4124,2308,178.7,4218
6085,2010,9,CAL (CALIPATRIA SP),4182,0,4182,2308,181.2,4168
6086,2010,9,"CRC (CAL REHAB CTR, MEN)",3790,516,4306,2491,172.9,4408
6087,2010,9,CMC (CA MEN'S COLONY),6323,0,6323,3838,164.7,6458
6088,2010,9,CMF (CA MEDICAL FAC),2605,0,2605,2297,113.4,2665
6089,2010,9,CIM (CA INSTITUTION FOR MEN),4812,12,4824,2976,162.1,6125
6090,2010,9,CCI (CA CORRECTIONAL INSTITUTION),5885,0,5885,2783,211.5,5852
6091,2010,9,CCC (CA CORRECTIONAL CENTER),5520,0,5520,3883,142.2,5585
6092,2010,9,ASP (AVENAL SP),6284,0,6284,2920,215.2,6426
6093,2010,10,VSP (VALLEY SP),3463,6,3469,1980,175.2,3486
6094,2010,10,CCWF (CENTRAL CA WOMEN'S FAC),3749,6,3755,2004,187.4,3886
6095,2010,10,CIW (CA INSTITUTION FOR WOMEN),2129,161,2290,1386,165.2,2353
6096,2010,10,WSP (WASCO SP),5833,5,5838,2984,195.6,5752
6097,2010,10,SCC (SIERRA CONSERVATION CENTER),5416,0,5416,3736,145.0,5366
6098,2010,10,SVSP (SALINAS VALLEY SP),3735,0,3735,2388,156.4,3801
6099,2010,10,RJD (RJ DONOVAN CORRECTIONAL FAC),4416,2,4418,2200,200.8,4594
6100,2010,10,PVSP (PLEASANT VALLEY SP),4593,0,4593,2308,199.0,4722
6101,2010,10,PBSP (PELICAN BAY SP),3220,0,3220,2380,135.3,3351
6102,2010,10,NKSP (NORTH KERN SP),5308,9,5317,2694,197.4,5304
6103,2010,10,MCSP (MULE CREEK SP),3668,0,3668,1700,215.8,3624
6104,2010,10,KVSP (KERN VALLEY SP),4662,0,4662,2448,190.4,4884
6105,2010,10,ISP (IRONWOOD SP),3976,0,3976,2200,180.7,4035
6106,2010,10,HDSP (HIGH DESERT SP),4249,4,4253,2324,183.0,4316
6107,2010,10,FOL (FOLSOM SP) (MALE),3522,0,3522,2469,142.6,3675
6108,2010,10,DVI (DEUEL VOCATIONAL INSTITUTION),3795,7,3802,1681,226.2,3811
6109,2010,10,CTF (CORRECTIONAL TRAINING FAC),6419,0,6419,3312,193.8,6127
6110,2010,10,CVSP (CHUCKAWALLA VALLEY SP),3183,0,3183,1738,183.1,3268
6111,2010,10,SATF (CA SUBSTANCE ABUSE TREAT FAC),6396,6,6402,3424,187.0,6258
6112,2010,10,"SOL (CA SP, SOLANO)",5026,0,5026,2610,192.6,5015
6113,2010,10,SQ (SAN QUENTIN SP),5212,8,5220,2967,175.9,5014
6114,2010,10,"SAC (CA SP, SACRAMENTO)",2955,0,2955,1828,161.7,2979
6115,2010,10,"LAC (CA SP, LOS ANGELES COUNTY)",4474,0,4474,2300,194.5,4640
6116,2010,10,"COR (CA SP, CORCORAN)",5063,0,5063,3116,162.5,5158
6117,2010,10,CEN (CENTINELA SP),3975,0,3975,2308,172.2,4218
6118,2010,10,CAL (CALIPATRIA SP),4116,0,4116,2308,178.3,4168
6119,2010,10,"CRC (CAL REHAB CTR, MEN)",3753,489,4242,2491,170.3,4408
6120,2010,10,CMC (CA MEN'S COLONY),6208,0,6208,3838,161.8,6458
6121,2010,10,CMF (CA MEDICAL FAC),2573,0,2573,2297,112.0,2665
6122,2010,10,CIM (CA INSTITUTION FOR MEN),5369,11,5380,2976,180.8,6537
6123,2010,10,CCI (CA CORRECTIONAL INSTITUTION),5800,0,5800,2783,208.4,5852
6124,2010,10,CCC (CA CORRECTIONAL CENTER),5445,0,5445,3883,140.2,5585
6125,2010,10,ASP (AVENAL SP),6145,0,6145,2920,210.4,6276
6126,2010,11,VSP (VALLEY SP),3473,10,3483,1980,175.9,3486
6127,2010,11,CCWF (CENTRAL CA WOMEN'S FAC),3729,6,3735,2004,186.4,3901
6128,2010,11,CIW (CA INSTITUTION FOR WOMEN),2091,149,2240,1386,161.6,2353
6129,2010,11,WSP (WASCO SP),5736,2,5738,2984,192.3,5752
6130,2010,11,SCC (SIERRA CONSERVATION CENTER),5341,0,5341,3736,143.0,5366
6131,2010,11,SVSP (SALINAS VALLEY SP),3732,0,3732,2388,156.3,3801
6132,2010,11,RJD (RJ DONOVAN CORRECTIONAL FAC),4451,1,4452,2200,202.4,4594
6133,2010,11,PVSP (PLEASANT VALLEY SP),4590,0,4590,2308,198.9,4722
6134,2010,11,PBSP (PELICAN BAY SP),3243,0,3243,2380,136.3,3351
6135,2010,11,NKSP (NORTH KERN SP),5337,5,5342,2694,198.3,5304
6136,2010,11,MCSP (MULE CREEK SP),3536,0,3536,1700,208.0,3516
6137,2010,11,KVSP (KERN VALLEY SP),4680,0,4680,2448,191.2,4884
6138,2010,11,ISP (IRONWOOD SP),3919,0,3919,2200,178.1,4035
6139,2010,11,HDSP (HIGH DESERT SP),4255,5,4260,2324,183.3,4316
6140,2010,11,FOL (FOLSOM SP) (MALE),3461,0,3461,2469,140.2,3675
6141,2010,11,DVI (DEUEL VOCATIONAL INSTITUTION),3810,20,3830,1681,227.8,3811
6142,2010,11,CTF (CORRECTIONAL TRAINING FAC),6463,0,6463,3312,195.1,6127
6143,2010,11,CVSP (CHUCKAWALLA VALLEY SP),3065,0,3065,1738,176.4,3268
6144,2010,11,SATF (CA SUBSTANCE ABUSE TREAT FAC),6315,6,6321,3424,184.6,6258
6145,2010,11,"SOL (CA SP, SOLANO)",4995,0,4995,2610,191.4,5015
6146,2010,11,SQ (SAN QUENTIN SP),5030,4,5034,2967,169.7,5014
6147,2010,11,"SAC (CA SP, SACRAMENTO)",2928,1,2929,1828,160.2,2979
6148,2010,11,"LAC (CA SP, LOS ANGELES COUNTY)",4489,1,4490,2300,195.2,4640
6149,2010,11,"COR (CA SP, CORCORAN)",4993,0,4993,3116,160.2,5158
6150,2010,11,CEN (CENTINELA SP),3963,0,3963,2308,171.7,4218
6151,2010,11,CAL (CALIPATRIA SP),4074,0,4074,2308,176.5,4168
6152,2010,11,"CRC (CAL REHAB CTR, MEN)",3755,461,4216,2491,169.2,4306
6153,2010,11,CMC (CA MEN'S COLONY),6030,0,6030,3838,157.1,6098
6154,2010,11,CMF (CA MEDICAL FAC),2549,0,2549,2297,111.0,2697
6155,2010,11,CIM (CA INSTITUTION FOR MEN),5517,8,5525,2976,185.7,6761
6156,2010,11,CCI (CA CORRECTIONAL INSTITUTION),5767,0,5767,2783,207.2,5732
6157,2010,11,CCC (CA CORRECTIONAL CENTER),5410,0,5410,3883,139.3,5585
6158,2010,11,ASP (AVENAL SP),5949,0,5949,2920,203.7,6054
6159,2010,12,VSP (VALLEY SP),3396,12,3408,1980,172.1,3486
6160,2010,12,CCWF (CENTRAL CA WOMEN'S FAC),3692,3,3695,2004,184.4,3901
6161,2010,12,CIW (CA INSTITUTION FOR WOMEN),2021,140,2161,1386,155.9,2363
6162,2010,12,WSP (WASCO SP),5877,7,5884,2984,197.2,5752
6163,2010,12,SCC (SIERRA CONSERVATION CENTER),5302,0,5302,3736,141.9,5366
6164,2010,12,SVSP (SALINAS VALLEY SP),3758,0,3758,2388,157.4,3801
6165,2010,12,RJD (RJ DONOVAN CORRECTIONAL FAC),4335,2,4337,2200,197.1,4494
6166,2010,12,PVSP (PLEASANT VALLEY SP),4574,0,4574,2308,198.2,4672
6167,2010,12,PBSP (PELICAN BAY SP),3222,0,3222,2380,135.4,3303
6168,2010,12,NKSP (NORTH KERN SP),5264,6,5270,2694,195.6,5254
6169,2010,12,MCSP (MULE CREEK SP),3540,0,3540,1700,208.2,3516
6170,2010,12,KVSP (KERN VALLEY SP),4657,0,4657,2448,190.2,4784
6171,2010,12,ISP (IRONWOOD SP),3710,0,3710,2200,168.6,3985
6172,2010,12,HDSP (HIGH DESERT SP),4257,3,4260,2324,183.3,4266
6173,2010,12,FOL (FOLSOM SP) (MALE),3401,0,3401,2469,137.7,3675
6174,2010,12,DVI (DEUEL VOCATIONAL INSTITUTION),3851,20,3871,1681,230.3,3811
6175,2010,12,CTF (CORRECTIONAL TRAINING FAC),6633,0,6633,3312,200.3,6127
6176,2010,12,CVSP (CHUCKAWALLA VALLEY SP),3152,0,3152,1738,181.4,3218
6177,2010,12,SATF (CA SUBSTANCE ABUSE TREAT FAC),6274,4,6278,3424,183.4,6258
6178,2010,12,"SOL (CA SP, SOLANO)",4946,0,4946,2610,189.5,5015
6179,2010,12,SQ (SAN QUENTIN SP),5139,3,5142,2967,173.3,5014
6180,2010,12,"SAC (CA SP, SACRAMENTO)",2866,0,2866,1828,156.8,2979
6181,2010,12,"LAC (CA SP, LOS ANGELES COUNTY)",4480,0,4480,2300,194.8,4590
6182,2010,12,"COR (CA SP, CORCORAN)",4977,0,4977,3116,159.7,5039
6183,2010,12,CEN (CENTINELA SP),4044,0,4044,2308,175.2,4168
6184,2010,12,CAL (CALIPATRIA SP),4086,0,4086,2308,177.0,4118
6185,2010,12,"CRC (CAL REHAB CTR, MEN)",3716,415,4131,2491,165.8,4216
6186,2010,12,CMC (CA MEN'S COLONY),5789,0,5789,3838,150.8,5848
6187,2010,12,CMF (CA MEDICAL FAC),2579,0,2579,2297,112.3,2697
6188,2010,12,CIM (CA INSTITUTION FOR MEN),5548,5,5553,2976,186.6,6761
6189,2010,12,CCI (CA CORRECTIONAL INSTITUTION),5706,0,5706,2783,205.0,5732
6190,2010,12,CCC (CA CORRECTIONAL CENTER),5395,0,5395,3883,138.9,5433
6191,2010,12,ASP (AVENAL SP),5894,0,5894,2920,201.8,5982
6192,2011,1,VSP (VALLEY SP),3370,11,3381,1980,170.8,3306
6193,2011,1,CCWF (CENTRAL CA WOMEN'S FAC),3666,3,3669,2004,183.1,3901
6194,2011,1,CIW (CA INSTITUTION FOR WOMEN),1992,153,2145,1386,154.8,2327
6195,2011,1,WSP (WASCO SP),5842,4,5846,2984,195.9,5656
6196,2011,1,SCC (SIERRA CONSERVATION CENTER),5295,0,5295,3736,141.7,5366
6197,2011,1,SVSP (SALINAS VALLEY SP),3761,0,3761,2388,157.5,3809
6198,2011,1,RJD (RJ DONOVAN CORRECTIONAL FAC),4332,0,4332,2200,196.9,4494
6199,2011,1,PVSP (PLEASANT VALLEY SP),4627,0,4627,2308,200.5,4672
6200,2011,1,PBSP (PELICAN BAY SP),3223,0,3223,2380,135.4,3303
6201,2011,1,NKSP (NORTH KERN SP),5279,6,5285,2694,196.2,5218
6202,2011,1,MCSP (MULE CREEK SP),3548,0,3548,1700,208.7,3516
6203,2011,1,KVSP (KERN VALLEY SP),4657,0,4657,2448,190.2,4784
6204,2011,1,ISP (IRONWOOD SP),3537,0,3537,2200,160.8,3985
6205,2011,1,HDSP (HIGH DESERT SP),4170,4,4174,2324,179.6,4211
6206,2011,1,FOL (FOLSOM SP) (MALE),3443,0,3443,2469,139.4,3601
6207,2011,1,DVI (DEUEL VOCATIONAL INSTITUTION),3798,9,3807,1681,226.5,3811
6208,2011,1,CTF (CORRECTIONAL TRAINING FAC),6569,0,6569,3312,198.3,6127
6209,2011,1,CVSP (CHUCKAWALLA VALLEY SP),3187,0,3187,1738,183.4,3218
6210,2011,1,SATF (CA SUBSTANCE ABUSE TREAT FAC),6321,7,6328,3424,184.8,6258
6211,2011,1,"SOL (CA SP, SOLANO)",4938,0,4938,2610,189.2,4990
6212,2011,1,SQ (SAN QUENTIN SP),5111,6,5117,2967,172.5,4914
6213,2011,1,"SAC (CA SP, SACRAMENTO)",2806,0,2806,1828,153.5,2979
6214,2011,1,"LAC (CA SP, LOS ANGELES COUNTY)",4465,0,4465,2300,194.1,4590
6215,2011,1,"COR (CA SP, CORCORAN)",4710,0,4710,3116,151.2,4918
6216,2011,1,CEN (CENTINELA SP),4120,0,4120,2308,178.5,4168
6217,2011,1,CAL (CALIPATRIA SP),4062,0,4062,2308,176.0,3995
6218,2011,1,"CRC (CAL REHAB CTR, MEN)",3665,396,4061,2491,163.0,4216
6219,2011,1,CMC (CA MEN'S COLONY),5700,0,5700,3838,148.5,5848
6220,2011,1,CMF (CA MEDICAL FAC),2617,0,2617,2297,113.9,2780
6221,2011,1,CIM (CA INSTITUTION FOR MEN),5572,6,5578,2976,187.4,6761
6222,2011,1,CCI (CA CORRECTIONAL INSTITUTION),5632,0,5632,2783,202.4,5732
6223,2011,1,CCC (CA CORRECTIONAL CENTER),5342,0,5342,3883,137.6,5433
6224,2011,1,ASP (AVENAL SP),5757,0,5757,2920,197.2,5785
6225,2011,2,VSP (VALLEY SP),3322,3,3325,1980,167.9,3306
6226,2011,2,CCWF (CENTRAL CA WOMEN'S FAC),3687,4,3691,2004,184.2,3795
6227,2011,2,CIW (CA INSTITUTION FOR WOMEN),1936,147,2083,1386,150.3,2147
6228,2011,2,WSP (WASCO SP),5729,5,5734,2984,192.2,5656
6229,2011,2,SCC (SIERRA CONSERVATION CENTER),5261,0,5261,3736,140.8,5366
6230,2011,2,SVSP (SALINAS VALLEY SP),3741,0,3741,2388,156.7,3809
6231,2011,2,RJD (RJ DONOVAN CORRECTIONAL FAC),4282,0,4282,2200,194.6,4494
6232,2011,2,PVSP (PLEASANT VALLEY SP),4689,0,4689,2308,203.2,4672
6233,2011,2,PBSP (PELICAN BAY SP),3161,0,3161,2380,132.8,3208
6234,2011,2,NKSP (NORTH KERN SP),5059,8,5067,2694,188.1,5218
6235,2011,2,MCSP (MULE CREEK SP),3534,0,3534,1700,207.9,3516
6236,2011,2,KVSP (KERN VALLEY SP),4651,0,4651,2448,190.0,4729
6237,2011,2,ISP (IRONWOOD SP),3650,0,3650,2200,165.9,3795
6238,2011,2,HDSP (HIGH DESERT SP),4136,6,4142,2324,178.2,4211
6239,2011,2,FOL (FOLSOM SP) (MALE),3651,1,3652,2469,147.9,3601
6240,2011,2,DVI (DEUEL VOCATIONAL INSTITUTION),3751,19,3770,1681,224.3,3811
6241,2011,2,CTF (CORRECTIONAL TRAINING FAC),6602,0,6602,3312,199.3,6127
6242,2011,2,CVSP (CHUCKAWALLA VALLEY SP),3205,0,3205,1738,184.4,3218
6243,2011,2,SATF (CA SUBSTANCE ABUSE TREAT FAC),6223,5,6228,3424,181.9,6006
6244,2011,2,"SOL (CA SP, SOLANO)",5035,0,5035,2610,192.9,4990
6245,2011,2,SQ (SAN QUENTIN SP),4985,14,4999,3082,162.2,5079
6246,2011,2,"SAC (CA SP, SACRAMENTO)",2796,0,2796,1828,153.0,2793
6247,2011,2,"LAC (CA SP, LOS ANGELES COUNTY)",4412,0,4412,2300,191.8,4590
6248,2011,2,"COR (CA SP, CORCORAN)",4660,0,4660,3116,149.6,4008
6249,2011,2,CEN (CENTINELA SP),4190,0,4190,2308,181.5,4168
6250,2011,2,CAL (CALIPATRIA SP),4091,0,4091,2308,177.3,3995
6251,2011,2,"CRC (CAL REHAB CTR, MEN)",3736,388,4124,2491,165.6,4216
6252,2011,2,CMC (CA MEN'S COLONY),5858,0,5858,3838,152.6,5848
6253,2011,2,CMF (CA MEDICAL FAC),2693,0,2693,2297,117.2,2780
6254,2011,2,CIM (CA INSTITUTION FOR MEN),5827,6,5833,2976,196.0,6961
6255,2011,2,CCI (CA CORRECTIONAL INSTITUTION),5446,0,5446,2783,195.7,5732
6256,2011,2,CCC (CA CORRECTIONAL CENTER),5406,0,5406,3883,139.2,5433
6257,2011,2,ASP (AVENAL SP),5693,0,5693,2920,195.0,5785
6258,2011,3,VSP (VALLEY SP),3237,2,3239,1980,163.6,3306
6259,2011,3,CCWF (CENTRAL CA WOMEN'S FAC),3714,7,3721,2004,185.7,3795
6260,2011,3,CIW (CA INSTITUTION FOR WOMEN),1936,132,2068,1386,149.2,2147
6261,2011,3,WSP (WASCO SP),5666,8,5674,2984,190.1,5656
6262,2011,3,SCC (SIERRA CONSERVATION CENTER),5358,0,5358,3736,143.4,5366
6263,2011,3,SVSP (SALINAS VALLEY SP),3741,0,3741,2388,156.7,3809
6264,2011,3,RJD (RJ DONOVAN CORRECTIONAL FAC),4357,0,4357,2200,198.0,4494
6265,2011,3,PVSP (PLEASANT VALLEY SP),4627,0,4627,2308,200.5,4672
6266,2011,3,PBSP (PELICAN BAY SP),3183,0,3183,2380,133.7,3208
6267,2011,3,NKSP (NORTH KERN SP),5149,2,5151,2694,191.2,5218
6268,2011,3,MCSP (MULE CREEK SP),3502,0,3502,1700,206.0,3516
6269,2011,3,KVSP (KERN VALLEY SP),4641,0,4641,2448,189.6,4729
6270,2011,3,ISP (IRONWOOD SP),3884,0,3884,2200,176.5,3795
6271,2011,3,HDSP (HIGH DESERT SP),4106,4,4110,2324,176.9,4211
6272,2011,3,FOL (FOLSOM SP) (MALE),3728,1,3729,2469,151.0,3601
6273,2011,3,DVI (DEUEL VOCATIONAL INSTITUTION),3777,17,3794,1681,225.7,3811
6274,2011,3,CTF (CORRECTIONAL TRAINING FAC),6472,0,6472,3312,195.4,6127
6275,2011,3,CVSP (CHUCKAWALLA VALLEY SP),3153,0,3153,1738,181.4,3218
6276,2011,3,SATF (CA SUBSTANCE ABUSE TREAT FAC),6046,5,6051,3424,176.7,6006
6277,2011,3,"SOL (CA SP, SOLANO)",4979,0,4979,2610,190.8,4990
6278,2011,3,SQ (SAN QUENTIN SP),4929,6,4935,3082,160.1,5079
6279,2011,3,"SAC (CA SP, SACRAMENTO)",2798,0,2798,1828,153.1,2793
6280,2011,3,"LAC (CA SP, LOS ANGELES COUNTY)",4357,0,4357,2300,189.4,4590
6281,2011,3,"COR (CA SP, CORCORAN)",4976,0,4976,3116,159.7,4008
6282,2011,3,CEN (CENTINELA SP),4231,0,4231,2308,183.3,4168
6283,2011,3,CAL (CALIPATRIA SP),4195,0,4195,2308,181.8,3995
6284,2011,3,"CRC (CAL REHAB CTR, MEN)",3690,413,4103,2491,164.7,4216
6285,2011,3,CMC (CA MEN'S COLONY),6189,0,6189,3838,161.3,5848
6286,2011,3,CMF (CA MEDICAL FAC),2765,0,2765,2297,120.4,2780
6287,2011,3,CIM (CA INSTITUTION FOR MEN),5868,5,5873,2976,197.3,6961
6288,2011,3,CCI (CA CORRECTIONAL INSTITUTION),5564,0,5564,2783,199.9,5732
6289,2011,3,CCC (CA CORRECTIONAL CENTER),5488,0,5488,3883,141.3,5433
6290,2011,3,ASP (AVENAL SP),5747,0,5747,2920,196.8,5785
6291,2011,4,VSP (VALLEY SP),3210,6,3216,1980,162.4,3306
6292,2011,4,CCWF (CENTRAL CA WOMEN'S FAC),3672,3,3675,2004,183.4,3795
6293,2011,4,CIW (CA INSTITUTION FOR WOMEN),2021,125,2146,1386,154.8,2147
6294,2011,4,WSP (WASCO SP),5813,5,5818,2984,195.0,5656
6295,2011,4,SCC (SIERRA CONSERVATION CENTER),5362,1,5363,3736,143.5,5366
6296,2011,4,SVSP (SALINAS VALLEY SP),3810,0,3810,2388,159.5,3809
6297,2011,4,RJD (RJ DONOVAN CORRECTIONAL FAC),4334,0,4334,2200,197.0,4494
6298,2011,4,PVSP (PLEASANT VALLEY SP),4607,0,4607,2308,199.6,4672
6299,2011,4,PBSP (PELICAN BAY SP),3149,0,3149,2380,132.3,3208
6300,2011,4,NKSP (NORTH KERN SP),5008,4,5012,2694,186.0,5218
6301,2011,4,MCSP (MULE CREEK SP),3551,0,3551,1700,208.9,3516
6302,2011,4,KVSP (KERN VALLEY SP),4597,0,4597,2448,187.8,4729
6303,2011,4,ISP (IRONWOOD SP),4065,0,4065,2200,184.8,3795
6304,2011,4,HDSP (HIGH DESERT SP),4191,4,4195,2324,180.5,4211
6305,2011,4,FOL (FOLSOM SP) (MALE),3723,1,3724,2469,150.8,3601
6306,2011,4,DVI (DEUEL VOCATIONAL INSTITUTION),3774,8,3782,1681,225.0,3811
6307,2011,4,CTF (CORRECTIONAL TRAINING FAC),6568,0,6568,3312,198.3,6127
6308,2011,4,CVSP (CHUCKAWALLA VALLEY SP),3157,0,3157,1738,181.6,3218
6309,2011,4,SATF (CA SUBSTANCE ABUSE TREAT FAC),6142,5,6147,3424,179.5,6006
6310,2011,4,"SOL (CA SP, SOLANO)",5052,0,5052,2610,193.6,4990
6311,2011,4,SQ (SAN QUENTIN SP),4856,0,4856,3082,157.6,5079
6312,2011,4,"SAC (CA SP, SACRAMENTO)",2848,0,2848,1828,155.8,2793
6313,2011,4,"LAC (CA SP, LOS ANGELES COUNTY)",4323,0,4323,2300,188.0,4590
6314,2011,4,"COR (CA SP, CORCORAN)",4900,0,4900,3116,157.3,4008
6315,2011,4,CEN (CENTINELA SP),4140,1,4141,2308,179.4,4168
6316,2011,4,CAL (CALIPATRIA SP),4216,0,4216,2308,182.7,3995
6317,2011,4,"CRC (CAL REHAB CTR, MEN)",3750,443,4193,2491,168.3,4216
6318,2011,4,CMC (CA MEN'S COLONY),6400,0,6400,3838,166.8,5848
6319,2011,4,CMF (CA MEDICAL FAC),2865,0,2865,2297,124.7,2780
6320,2011,4,CIM (CA INSTITUTION FOR MEN),5860,3,5863,2976,197.0,6961
6321,2011,4,CCI (CA CORRECTIONAL INSTITUTION),5583,0,5583,2783,200.6,5732
6322,2011,4,CCC (CA CORRECTIONAL CENTER),5481,0,5481,3883,141.2,5433
6323,2011,4,ASP (AVENAL SP),5732,0,5732,2920,196.3,5785
6324,2011,5,VSP (VALLEY SP),3263,8,3271,1980,165.2,3306
6325,2011,5,CCWF (CENTRAL CA WOMEN'S FAC),3678,8,3686,2004,183.9,3859
6326,2011,5,CIW (CA INSTITUTION FOR WOMEN),1967,119,2086,1386,150.5,2147
6327,2011,5,WSP (WASCO SP),5772,4,5776,2984,193.6,5656
6328,2011,5,SCC (SIERRA CONSERVATION CENTER),5280,0,5280,3736,141.3,5548
6329,2011,5,SVSP (SALINAS VALLEY SP),3823,0,3823,2388,160.1,3809
6330,2011,5,RJD (RJ DONOVAN CORRECTIONAL FAC),4295,0,4295,2200,195.2,4544
6331,2011,5,PVSP (PLEASANT VALLEY SP),4620,0,4620,2308,200.2,4647
6332,2011,5,PBSP (PELICAN BAY SP),3076,0,3076,2380,129.2,3208
6333,2011,5,NKSP (NORTH KERN SP),5026,5,5031,2694,186.7,5218
6334,2011,5,MCSP (MULE CREEK SP),3549,0,3549,1700,208.8,3516
6335,2011,5,KVSP (KERN VALLEY SP),4614,0,4614,2448,188.5,4729
6336,2011,5,ISP (IRONWOOD SP),4083,0,4083,2200,185.6,3960
6337,2011,5,HDSP (HIGH DESERT SP),4230,4,4234,2324,182.2,4211
6338,2011,5,FOL (FOLSOM SP) (MALE),3687,1,3688,2469,149.4,3601
6339,2011,5,DVI (DEUEL VOCATIONAL INSTITUTION),3803,10,3813,1681,226.8,3811
6340,2011,5,CTF (CORRECTIONAL TRAINING FAC),6658,0,6658,3312,201.0,6127
6341,2011,5,CVSP (CHUCKAWALLA VALLEY SP),3139,0,3139,1738,180.6,3218
6342,2011,5,SATF (CA SUBSTANCE ABUSE TREAT FAC),6342,13,6355,3424,185.6,6138
6343,2011,5,"SOL (CA SP, SOLANO)",5035,0,5035,2610,192.9,4990
6344,2011,5,SQ (SAN QUENTIN SP),4696,2,4698,3082,152.4,4792
6345,2011,5,"SAC (CA SP, SACRAMENTO)",2836,1,2837,1828,155.2,2843
6346,2011,5,"LAC (CA SP, LOS ANGELES COUNTY)",4301,0,4301,2300,187.0,4488
6347,2011,5,"COR (CA SP, CORCORAN)",4957,0,4957,3116,159.1,4918
6348,2011,5,CEN (CENTINELA SP),4222,0,4222,2308,182.9,4143
6349,2011,5,CAL (CALIPATRIA SP),4136,0,4136,2308,179.2,4045
6350,2011,5,"CRC (CAL REHAB CTR, MEN)",3708,435,4143,2491,166.3,4176
6351,2011,5,CMC (CA MEN'S COLONY),6417,0,6417,3838,167.2,6208
6352,2011,5,CMF (CA MEDICAL FAC),2874,0,2874,2297,125.1,2780
6353,2011,5,CIM (CA INSTITUTION FOR MEN),5857,4,5861,2976,196.9,7258
6354,2011,5,CCI (CA CORRECTIONAL INSTITUTION),5687,0,5687,2783,204.3,5812
6355,2011,5,CCC (CA CORRECTIONAL CENTER),5375,0,5375,3883,138.4,5533
6356,2011,5,ASP (AVENAL SP),5688,0,5688,2920,194.8,5760
6357,2011,6,VSP (VALLEY SP),3305,10,3315,1980,167.4,3306
6358,2011,6,CCWF (CENTRAL CA WOMEN'S FAC),3752,6,3758,2004,187.5,3859
6359,2011,6,CIW (CA INSTITUTION FOR WOMEN),1975,115,2090,1356,154.1,2101
6360,2011,6,WSP (WASCO SP),5908,4,5912,2984,198.1,5584
6361,2011,6,SCC (SIERRA CONSERVATION CENTER),5236,0,5236,3736,140.1,5548
6362,2011,6,SVSP (SALINAS VALLEY SP),3879,0,3879,2388,162.4,3859
6363,2011,6,RJD (RJ DONOVAN CORRECTIONAL FAC),4401,0,4401,2200,200.0,4436
6364,2011,6,PVSP (PLEASANT VALLEY SP),4572,0,4572,2308,198.1,4647
6365,2011,6,PBSP (PELICAN BAY SP),3137,0,3137,2380,131.8,3208
6366,2011,6,NKSP (NORTH KERN SP),5051,6,5057,2694,187.7,5110
6367,2011,6,MCSP (MULE CREEK SP),3570,0,3570,1700,210.0,3516
6368,2011,6,KVSP (KERN VALLEY SP),4682,0,4682,2448,191.3,4729
6369,2011,6,ISP (IRONWOOD SP),4141,0,4141,2200,188.2,4010
6370,2011,6,HDSP (HIGH DESERT SP),4267,1,4268,2324,183.6,4211
6371,2011,6,FOL (FOLSOM SP) (MALE),3771,1,3772,2469,152.8,3601
6372,2011,6,DVI (DEUEL VOCATIONAL INSTITUTION),3788,5,3793,1681,225.6,3811
6373,2011,6,CTF (CORRECTIONAL TRAINING FAC),6593,0,6593,3312,199.1,6127
6374,2011,6,CVSP (CHUCKAWALLA VALLEY SP),3188,0,3188,1738,183.4,3218
6375,2011,6,SATF (CA SUBSTANCE ABUSE TREAT FAC),6389,19,6408,3424,187.1,6138
6376,2011,6,"SOL (CA SP, SOLANO)",5020,1,5021,2610,192.4,4990
6377,2011,6,SQ (SAN QUENTIN SP),4790,4,4794,3082,155.5,4792
6378,2011,6,"SAC (CA SP, SACRAMENTO)",2846,0,2846,1828,155.7,2843
6379,2011,6,"LAC (CA SP, LOS ANGELES COUNTY)",4359,0,4359,2300,189.5,4380
6380,2011,6,"COR (CA SP, CORCORAN)",4938,0,4938,3116,158.5,4918
6381,2011,6,CEN (CENTINELA SP),4161,0,4161,2308,180.3,4143
6382,2011,6,CAL (CALIPATRIA SP),4194,0,4194,2308,181.7,4045
6383,2011,6,"CRC (CAL REHAB CTR, MEN)",3764,376,4140,2491,166.2,4176
6384,2011,6,CMC (CA MEN'S COLONY),6280,0,6280,3838,163.6,6111
6385,2011,6,CMF (CA MEDICAL FAC),2889,0,2889,2297,125.8,2780
6386,2011,6,CIM (CA INSTITUTION FOR MEN),6070,2,6072,2976,204.0,7207
6387,2011,6,CCI (CA CORRECTIONAL INSTITUTION),5647,0,5647,2783,202.9,5812
6388,2011,6,CCC (CA CORRECTIONAL CENTER),5442,0,5442,3883,140.1,5533
6389,2011,6,ASP (AVENAL SP),5738,0,5738,2920,196.5,5760
6390,2011,7,VSP (VALLEY SP),3316,6,3322,1936,171.6,3244
6391,2011,7,CCWF (CENTRAL CA WOMEN'S FAC),3823,3,3826,2004,190.9,3859
6392,2011,7,CIW (CA INSTITUTION FOR WOMEN),1920,115,2035,1386,146.8,2147
6393,2011,7,WSP (WASCO SP),5683,6,5689,2984,190.7,5584
6394,2011,7,SCC (SIERRA CONSERVATION CENTER),5182,0,5182,3736,138.7,5548
6395,2011,7,SVSP (SALINAS VALLEY SP),3945,0,3945,2452,160.9,3859
6396,2011,7,RJD (RJ DONOVAN CORRECTIONAL FAC),4347,0,4347,2200,197.6,4436
6397,2011,7,PVSP (PLEASANT VALLEY SP),4572,0,4572,2308,198.1,4647
6398,2011,7,PBSP (PELICAN BAY SP),3212,0,3212,2380,135.0,3208
6399,2011,7,NKSP (NORTH KERN SP),5128,6,5134,2694,190.6,5110
6400,2011,7,MCSP (MULE CREEK SP),3572,0,3572,1700,210.1,3516
6401,2011,7,KVSP (KERN VALLEY SP),4708,0,4708,2448,192.3,4729
6402,2011,7,ISP (IRONWOOD SP),4153,0,4153,2200,188.8,4010
6403,2011,7,HDSP (HIGH DESERT SP),4226,5,4231,2324,182.1,4211
6404,2011,7,FOL (FOLSOM SP) (MALE),3707,1,3708,2469,150.2,3601
6405,2011,7,DVI (DEUEL VOCATIONAL INSTITUTION),3831,11,3842,1681,228.6,3811
6406,2011,7,CTF (CORRECTIONAL TRAINING FAC),6515,0,6515,3312,196.7,6127
6407,2011,7,CVSP (CHUCKAWALLA VALLEY SP),3109,0,3109,1738,178.9,3218
6408,2011,7,SATF (CA SUBSTANCE ABUSE TREAT FAC),6319,16,6335,3424,185.0,6138
6409,2011,7,"SOL (CA SP, SOLANO)",5029,0,5029,2610,192.7,4990
6410,2011,7,SQ (SAN QUENTIN SP),4780,8,4788,3082,155.4,4792
6411,2011,7,"SAC (CA SP, SACRAMENTO)",2829,0,2829,1828,154.8,2843
6412,2011,7,"LAC (CA SP, LOS ANGELES COUNTY)",4201,0,4201,2300,182.7,4380
6413,2011,7,"COR (CA SP, CORCORAN)",4851,0,4851,3116,155.7,4918
6414,2011,7,CEN (CENTINELA SP),4146,0,4146,2308,179.6,4143
6415,2011,7,CAL (CALIPATRIA SP),4244,0,4244,2308,183.9,4045
6416,2011,7,"CRC (CAL REHAB CTR, MEN)",3753,343,4096,2491,164.4,4176
6417,2011,7,CMC (CA MEN'S COLONY),6255,0,6255,3838,163.0,6361
6418,2011,7,CMF (CA MEDICAL FAC),2865,0,2865,2297,124.7,2780
6419,2011,7,CIM (CA INSTITUTION FOR MEN),6060,2,6062,2976,203.7,7407
6420,2011,7,CCI (CA CORRECTIONAL INSTITUTION),5718,0,5718,2783,205.5,5812
6421,2011,7,CCC (CA CORRECTIONAL CENTER),5452,0,5452,3883,140.4,5533
6422,2011,7,ASP (AVENAL SP),5725,0,5725,2920,196.1,5760
6423,2011,8,VSP (VALLEY SP),3457,9,3466,1980,175.1,3244
6424,2011,8,CCWF (CENTRAL CA WOMEN'S FAC),3780,6,3786,2004,188.9,3859
6425,2011,8,CIW (CA INSTITUTION FOR WOMEN),1901,111,2012,1356,148.4,2157
6426,2011,8,WSP (WASCO SP),5804,2,5806,2984,194.6,5584
6427,2011,8,SCC (SIERRA CONSERVATION CENTER),5165,1,5166,3736,138.3,5548
6428,2011,8,SVSP (SALINAS VALLEY SP),3928,0,3928,2452,160.2,3859
6429,2011,8,RJD (RJ DONOVAN CORRECTIONAL FAC),4420,0,4420,2200,200.9,4436
6430,2011,8,PVSP (PLEASANT VALLEY SP),4594,0,4594,2308,199.0,4647
6431,2011,8,PBSP (PELICAN BAY SP),3283,0,3283,2380,137.9,3208
6432,2011,8,NKSP (NORTH KERN SP),5076,3,5079,2694,188.5,5110
6433,2011,8,MCSP (MULE CREEK SP),3576,0,3576,1700,210.4,3516
6434,2011,8,KVSP (KERN VALLEY SP),4705,0,4705,2448,192.2,4729
6435,2011,8,ISP (IRONWOOD SP),4162,0,4162,2200,189.2,4010
6436,2011,8,HDSP (HIGH DESERT SP),4276,0,4276,2324,184.0,4211
6437,2011,8,FOL (FOLSOM SP) (MALE),3741,1,3742,2469,151.6,3601
6438,2011,8,DVI (DEUEL VOCATIONAL INSTITUTION),3853,5,3858,1681,229.5,3811
6439,2011,8,CTF (CORRECTIONAL TRAINING FAC),6633,0,6633,3312,200.3,6127
6440,2011,8,CVSP (CHUCKAWALLA VALLEY SP),3197,0,3197,1738,183.9,3218
6441,2011,8,SATF (CA SUBSTANCE ABUSE TREAT FAC),6264,13,6277,3424,183.3,6138
6442,2011,8,"SOL (CA SP, SOLANO)",4929,0,4929,2610,188.9,4990
6443,2011,8,SQ (SAN QUENTIN SP),4668,3,4671,3082,151.6,4792
6444,2011,8,"SAC (CA SP, SACRAMENTO)",2836,0,2836,1828,155.1,2843
6445,2011,8,"LAC (CA SP, LOS ANGELES COUNTY)",4252,0,4252,2300,184.9,4380
6446,2011,8,"COR (CA SP, CORCORAN)",4895,0,4895,3116,157.1,4918
6447,2011,8,CEN (CENTINELA SP),4155,0,4155,2308,180.0,4143
6448,2011,8,CAL (CALIPATRIA SP),4271,0,4271,2308,185.1,4095
6449,2011,8,"CRC (CAL REHAB CTR, MEN)",3688,313,4001,2491,160.6,4176
6450,2011,8,CMC (CA MEN'S COLONY),6245,0,6245,3838,162.7,6111
6451,2011,8,CMF (CA MEDICAL FAC),2881,0,2881,2297,125.4,2780
6452,2011,8,CIM (CA INSTITUTION FOR MEN),6096,3,6099,2976,204.9,7407
6453,2011,8,CCI (CA CORRECTIONAL INSTITUTION),5683,0,5683,2783,204.2,5812
6454,2011,8,CCC (CA CORRECTIONAL CENTER),5494,0,5494,3883,141.5,5533
6455,2011,8,ASP (AVENAL SP),5767,0,5767,2920,197.5,5760
6456,2011,9,VSP (VALLEY SP),3491,5,3496,1980,176.6,3321
6457,2011,9,CCWF (CENTRAL CA WOMEN'S FAC),3731,5,3736,2004,186.4,3859
6458,2011,9,CIW (CA INSTITUTION FOR WOMEN),1852,116,1968,1356,145.1,2157
6459,2011,9,WSP (WASCO SP),5778,7,5785,2984,193.9,5584
6460,2011,9,SCC (SIERRA CONSERVATION CENTER),5265,0,5265,3736,140.9,5548
6461,2011,9,SVSP (SALINAS VALLEY SP),3944,0,3944,2452,160.8,3909
6462,2011,9,RJD (RJ DONOVAN CORRECTIONAL FAC),4335,0,4335,2200,197.0,4436
6463,2011,9,PVSP (PLEASANT VALLEY SP),4619,0,4619,2308,200.1,4647
6464,2011,9,PBSP (PELICAN BAY SP),3267,0,3267,2380,137.3,3208
6465,2011,9,NKSP (NORTH KERN SP),5094,3,5097,2694,189.2,5110
6466,2011,9,MCSP (MULE CREEK SP),3597,0,3597,1700,211.6,3516
6467,2011,9,KVSP (KERN VALLEY SP),4672,0,4672,2448,190.8,4729
6468,2011,9,ISP (IRONWOOD SP),4179,0,4179,2200,190.0,4060
6469,2011,9,HDSP (HIGH DESERT SP),4257,1,4258,2324,183.2,4211
6470,2011,9,FOL (FOLSOM SP) (MALE),3705,1,3706,2469,150.1,3601
6471,2011,9,DVI (DEUEL VOCATIONAL INSTITUTION),3883,6,3889,1681,231.4,3811
6472,2011,9,CTF (CORRECTIONAL TRAINING FAC),6586,0,6586,3312,198.9,6127
6473,2011,9,CVSP (CHUCKAWALLA VALLEY SP),3153,0,3153,1738,181.4,3218
6474,2011,9,SATF (CA SUBSTANCE ABUSE TREAT FAC),6362,13,6375,3424,186.2,6138
6475,2011,9,"SOL (CA SP, SOLANO)",5004,0,5004,2610,191.7,4990
6476,2011,9,SQ (SAN QUENTIN SP),4671,4,4675,3082,151.7,4792
6477,2011,9,"SAC (CA SP, SACRAMENTO)",2871,0,2871,1828,157.1,2843
6478,2011,9,"LAC (CA SP, LOS ANGELES COUNTY)",4296,0,4296,2300,186.8,4380
6479,2011,9,"COR (CA SP, CORCORAN)",4983,0,4983,3116,159.9,4918
6480,2011,9,CEN (CENTINELA SP),4151,0,4151,2308,179.9,4143
6481,2011,9,CAL (CALIPATRIA SP),4295,0,4295,2308,186.1,4145
6482,2011,9,"CRC (CAL REHAB CTR, MEN)",3861,314,4175,2491,167.6,4176
6483,2011,9,CMC (CA MEN'S COLONY),6218,0,6218,3838,162.0,6111
6484,2011,9,CMF (CA MEDICAL FAC),2941,0,2941,2297,128.0,2780
6485,2011,9,CIM (CA INSTITUTION FOR MEN),6077,4,6081,2976,204.3,7407
6486,2011,9,CCI (CA CORRECTIONAL INSTITUTION),5710,0,5710,2783,205.2,5812
6487,2011,9,CCC (CA CORRECTIONAL CENTER),5460,0,5460,3883,140.6,5533
6488,2011,9,ASP (AVENAL SP),5740,0,5740,2920,196.6,5760
6489,2011,10,VSP (VALLEY SP),3411,8,3419,1980,172.7,3272
6490,2011,10,CCWF (CENTRAL CA WOMEN'S FAC),3580,6,3586,2004,178.9,3772
6491,2011,10,CIW (CA INSTITUTION FOR WOMEN),1787,114,1901,1356,140.2,1998
6492,2011,10,WSP (WASCO SP),5044,4,5048,2984,169.2,5584
6493,2011,10,SCC (SIERRA CONSERVATION CENTER),5287,0,5287,3736,141.5,5548
6494,2011,10,SVSP (SALINAS VALLEY SP),3982,0,3982,2452,162.4,3909
6495,2011,10,RJD (RJ DONOVAN CORRECTIONAL FAC),4125,0,4125,2200,187.5,4436
6496,2011,10,PVSP (PLEASANT VALLEY SP),4459,0,4459,2308,193.2,4647
6497,2011,10,PBSP (PELICAN BAY SP),3231,0,3231,2380,135.8,3208
6498,2011,10,NKSP (NORTH KERN SP),4872,3,4875,2694,181.0,5110
6499,2011,10,MCSP (MULE CREEK SP),3586,0,3586,1700,210.9,3516
6500,2011,10,KVSP (KERN VALLEY SP),4625,0,4625,2448,188.9,4729
6501,2011,10,ISP (IRONWOOD SP),4142,0,4142,2200,188.3,4060
6502,2011,10,HDSP (HIGH DESERT SP),4134,2,4136,2324,178.0,4211
6503,2011,10,FOL (FOLSOM SP) (MALE),3725,0,3725,2469,150.9,3601
6504,2011,10,DVI (DEUEL VOCATIONAL INSTITUTION),3569,8,3577,1681,212.8,3383
6505,2011,10,CTF (CORRECTIONAL TRAINING FAC),6591,0,6591,3312,199.0,6127
6506,2011,10,CVSP (CHUCKAWALLA VALLEY SP),3169,0,3169,1738,182.3,3218
6507,2011,10,SATF (CA SUBSTANCE ABUSE TREAT FAC),6242,9,6251,3424,182.6,6138
6508,2011,10,"SOL (CA SP, SOLANO)",4995,0,4995,2610,191.4,4990
6509,2011,10,SQ (SAN QUENTIN SP),4222,3,4225,3082,137.1,4792
6510,2011,10,"SAC (CA SP, SACRAMENTO)",2835,0,2835,1828,155.1,2843
6511,2011,10,"LAC (CA SP, LOS ANGELES COUNTY)",4289,0,4289,2300,186.5,4380
6512,2011,10,"COR (CA SP, CORCORAN)",4977,0,4977,3116,159.7,4918
6513,2011,10,CEN (CENTINELA SP),4163,0,4163,2308,180.4,4143
6514,2011,10,CAL (CALIPATRIA SP),4318,0,4318,2308,187.1,4145
6515,2011,10,"CRC (CAL REHAB CTR, MEN)",3825,297,4122,2491,165.5,4176
6516,2011,10,CMC (CA MEN'S COLONY),6181,0,6181,3838,161.0,6111
6517,2011,10,CMF (CA MEDICAL FAC),2887,0,2887,2297,125.7,2780
6518,2011,10,CIM (CA INSTITUTION FOR MEN),5687,6,5693,2976,191.3,6937
6519,2011,10,CCI (CA CORRECTIONAL INSTITUTION),5486,0,5486,2783,197.1,5812
6520,2011,10,CCC (CA CORRECTIONAL CENTER),5455,0,5455,3883,140.5,5533
6521,2011,10,ASP (AVENAL SP),5712,0,5712,2920,195.6,5760
6522,2011,11,VSP (VALLEY SP),3135,3,3138,1980,158.5,3077
6523,2011,11,CCWF (CENTRAL CA WOMEN'S FAC),3406,8,3414,2004,170.4,3554
6524,2011,11,CIW (CA INSTITUTION FOR WOMEN),1804,112,1916,1356,141.3,2044
6525,2011,11,WSP (WASCO SP),4846,1,4847,2984,162.4,5360
6526,2011,11,SCC (SIERRA CONSERVATION CENTER),5112,0,5112,3736,136.8,5266
6527,2011,11,SVSP (SALINAS VALLEY SP),3962,0,3962,2452,161.6,3909
6528,2011,11,RJD (RJ DONOVAN CORRECTIONAL FAC),4130,0,4130,2200,187.7,3820
6529,2011,11,PVSP (PLEASANT VALLEY SP),4066,0,4066,2308,176.2,4527
6530,2011,11,PBSP (PELICAN BAY SP),3221,0,3221,2380,135.3,3208
6531,2011,11,NKSP (NORTH KERN SP),4502,3,4505,2694,167.2,4970
6532,2011,11,MCSP (MULE CREEK SP),3534,0,3534,1700,207.9,3516
6533,2011,11,KVSP (KERN VALLEY SP),4409,0,4409,2448,180.1,4529
6534,2011,11,ISP (IRONWOOD SP),4094,0,4094,2200,186.1,4060
6535,2011,11,HDSP (HIGH DESERT SP),4027,1,4028,2324,173.3,4146
6536,2011,11,FOL (FOLSOM SP) (MALE),3548,0,3548,2469,143.7,3601
6537,2011,11,DVI (DEUEL VOCATIONAL INSTITUTION),3237,9,3246,1681,193.1,3177
6538,2011,11,CTF (CORRECTIONAL TRAINING FAC),6498,0,6498,3312,196.2,5970
6539,2011,11,CVSP (CHUCKAWALLA VALLEY SP),3156,0,3156,1738,181.6,3218
6540,2011,11,SATF (CA SUBSTANCE ABUSE TREAT FAC),6051,12,6063,3424,177.1,5898
6541,2011,11,"SOL (CA SP, SOLANO)",4760,0,4760,2610,182.4,4990
6542,2011,11,SQ (SAN QUENTIN SP),4170,4,4174,3082,135.4,4477
6543,2011,11,"SAC (CA SP, SACRAMENTO)",2831,0,2831,1828,154.9,2843
6544,2011,11,"LAC (CA SP, LOS ANGELES COUNTY)",3975,0,3975,2300,172.8,4110
6545,2011,11,"COR (CA SP, CORCORAN)",4808,0,4808,3116,154.3,4797
6546,2011,11,CEN (CENTINELA SP),4084,0,4084,2308,176.9,4143
6547,2011,11,CAL (CALIPATRIA SP),4362,0,4362,2308,189.0,4145
6548,2011,11,"CRC (CAL REHAB CTR, MEN)",3845,262,4107,2491,164.9,4176
6549,2011,11,CMC (CA MEN'S COLONY),6165,0,6165,3838,160.6,6111
6550,2011,11,CMF (CA MEDICAL FAC),2835,0,2835,2297,123.4,2780
6551,2011,11,CIM (CA INSTITUTION FOR MEN),5596,6,5602,2976,188.2,6505
6552,2011,11,CCI (CA CORRECTIONAL INSTITUTION),5202,0,5202,2783,186.9,5283
6553,2011,11,CCC (CA CORRECTIONAL CENTER),5419,0,5419,3883,139.6,5433
6554,2011,11,ASP (AVENAL SP),5759,0,5759,2920,197.2,5760
6555,2011,12,VSP (VALLEY SP),2749,1,2750,1980,138.9,2899
6556,2011,12,CCWF (CENTRAL CA WOMEN'S FAC),3208,7,3215,2004,160.4,3376
6557,2011,12,CIW (CA INSTITUTION FOR WOMEN),1831,98,1929,1356,142.3,1999
6558,2011,12,WSP (WASCO SP),4997,0,4997,2984,167.5,5135
6559,2011,12,SCC (SIERRA CONSERVATION CENTER),5044,0,5044,3736,135.0,5266
6560,2011,12,SVSP (SALINAS VALLEY SP),3947,0,3947,2452,161.0,3909
6561,2011,12,RJD (RJ DONOVAN CORRECTIONAL FAC),3845,0,3845,2200,174.8,3820
6562,2011,12,PVSP (PLEASANT VALLEY SP),3747,0,3747,2308,162.3,3868
6563,2011,12,PBSP (PELICAN BAY SP),3158,0,3158,2380,132.7,3143
6564,2011,12,NKSP (NORTH KERN SP),4413,1,4414,2694,163.8,4770
6565,2011,12,MCSP (MULE CREEK SP),3432,0,3432,1700,201.9,3356
6566,2011,12,KVSP (KERN VALLEY SP),4355,0,4355,2448,177.9,4464
6567,2011,12,ISP (IRONWOOD SP),3953,0,3953,2200,179.7,3910
6568,2011,12,HDSP (HIGH DESERT SP),4072,1,4073,2324,175.3,4026
6569,2011,12,FOL (FOLSOM SP) (MALE),3245,0,3245,2469,131.4,3473
6570,2011,12,DVI (DEUEL VOCATIONAL INSTITUTION),3153,9,3162,1681,188.1,3072
6571,2011,12,CTF (CORRECTIONAL TRAINING FAC),6263,0,6263,3312,189.1,5800
6572,2011,12,CVSP (CHUCKAWALLA VALLEY SP),3117,0,3117,1738,179.3,3218
6573,2011,12,SATF (CA SUBSTANCE ABUSE TREAT FAC),5980,9,5989,3424,174.9,5804
6574,2011,12,"SOL (CA SP, SOLANO)",4454,0,4454,2610,170.7,4638
6575,2011,12,SQ (SAN QUENTIN SP),4353,5,4358,3082,141.4,4128
6576,2011,12,"SAC (CA SP, SACRAMENTO)",2875,0,2875,1828,157.3,2843
6577,2011,12,"LAC (CA SP, LOS ANGELES COUNTY)",3866,0,3866,2300,168.1,4110
6578,2011,12,"COR (CA SP, CORCORAN)",4783,0,4783,3116,153.5,4797
6579,2011,12,CEN (CENTINELA SP),3832,0,3832,2308,166.0,4008
6580,2011,12,CAL (CALIPATRIA SP),4372,0,4372,2308,189.4,4145
6581,2011,12,"CRC (CAL REHAB CTR, MEN)",3787,251,4038,2491,162.1,4176
6582,2011,12,CMC (CA MEN'S COLONY),5859,0,5859,3838,152.7,5757
6583,2011,12,CMF (CA MEDICAL FAC),2540,0,2540,2297,110.6,2666
6584,2011,12,CIM (CA INSTITUTION FOR MEN),5296,6,5302,2976,178.2,6505
6585,2011,12,CCI (CA CORRECTIONAL INSTITUTION),5093,0,5093,2783,183.0,5283
6586,2011,12,CCC (CA CORRECTIONAL CENTER),5162,0,5162,3883,132.9,5273
6587,2011,12,ASP (AVENAL SP),5676,0,5676,2920,194.4,5760
6588,2012,1,VSP (VALLEY SP),2650,0,2650,1980,133.8,2899
6589,2012,1,CCWF (CENTRAL CA WOMEN'S FAC),3064,23,3087,2004,154.0,3376
6590,2012,1,CIW (CA INSTITUTION FOR WOMEN),1686,84,1770,1356,130.5,1953
6591,2012,1,WSP (WASCO SP),4985,3,4988,2984,167.2,5135
6592,2012,1,SCC (SIERRA CONSERVATION CENTER),4887,0,4887,3736,130.8,5266
6593,2012,1,SVSP (SALINAS VALLEY SP),3909,0,3909,2452,159.4,3909
6594,2012,1,RJD (RJ DONOVAN CORRECTIONAL FAC),3769,0,3769,2200,171.3,3820
6595,2012,1,PVSP (PLEASANT VALLEY SP),3768,0,3768,2308,163.3,3868
6596,2012,1,PBSP (PELICAN BAY SP),3081,0,3081,2380,129.5,3143
6597,2012,1,NKSP (NORTH KERN SP),4559,1,4560,2694,169.3,4770
6598,2012,1,MCSP (MULE CREEK SP),3302,0,3302,1700,194.2,3356
6599,2012,1,KVSP (KERN VALLEY SP),4319,0,4319,2448,176.4,4464
6600,2012,1,ISP (IRONWOOD SP),3796,0,3796,2200,172.5,3910
6601,2012,1,HDSP (HIGH DESERT SP),3971,1,3972,2324,170.9,4026
6602,2012,1,FOL (FOLSOM SP) (MALE),3274,0,3274,2469,132.6,3473
6603,2012,1,DVI (DEUEL VOCATIONAL INSTITUTION),2864,11,2875,1681,171.0,3072
6604,2012,1,CTF (CORRECTIONAL TRAINING FAC),6180,0,6180,3312,186.6,5800
6605,2012,1,CVSP (CHUCKAWALLA VALLEY SP),2956,0,2956,1738,170.1,3218
6606,2012,1,SATF (CA SUBSTANCE ABUSE TREAT FAC),5887,11,5898,3424,172.3,5804
6607,2012,1,"SOL (CA SP, SOLANO)",4536,0,4536,2610,173.8,4638
6608,2012,1,SQ (SAN QUENTIN SP),4134,2,4136,3082,134.2,4128
6609,2012,1,"SAC (CA SP, SACRAMENTO)",2874,0,2874,1828,157.2,2843
6610,2012,1,"LAC (CA SP, LOS ANGELES COUNTY)",3585,0,3585,2300,155.9,4110
6611,2012,1,"COR (CA SP, CORCORAN)",4501,0,4501,3116,144.4,4797
6612,2012,1,CEN (CENTINELA SP),3817,0,3817,2308,165.4,4008
6613,2012,1,CAL (CALIPATRIA SP),4315,0,4315,2308,187.0,4145
6614,2012,1,"CRC (CAL REHAB CTR, MEN)",3761,246,4007,2491,160.9,4176
6615,2012,1,CMC (CA MEN'S COLONY),5664,0,5664,3838,147.6,5757
6616,2012,1,CMF (CA MEDICAL FAC),2401,0,2401,2297,104.5,2666
6617,2012,1,CIM (CA INSTITUTION FOR MEN),5234,7,5241,2976,176.1,6505
6618,2012,1,CCI (CA CORRECTIONAL INSTITUTION),4628,0,4628,2783,166.3,5283
6619,2012,1,CCC (CA CORRECTIONAL CENTER),5018,0,5018,3883,129.2,5273
6620,2012,1,ASP (AVENAL SP),5485,0,5485,2920,187.8,5760
6621,2012,2,VSP (VALLEY SP),2550,0,2550,1980,128.8,2701
6622,2012,2,CCWF (CENTRAL CA WOMEN'S FAC),2989,36,3025,2004,150.9,3016
6623,2012,2,CIW (CA INSTITUTION FOR WOMEN),1572,72,1644,1356,121.2,1775
6624,2012,2,WSP (WASCO SP),4969,2,4971,2984,166.6,5135
6625,2012,2,SCC (SIERRA CONSERVATION CENTER),4869,0,4869,3736,130.3,4963
6626,2012,2,SVSP (SALINAS VALLEY SP),3699,0,3699,2452,150.9,3459
6627,2012,2,RJD (RJ DONOVAN CORRECTIONAL FAC),3632,0,3632,2200,165.1,3820
6628,2012,2,PVSP (PLEASANT VALLEY SP),3794,0,3794,2308,164.4,3868
6629,2012,2,PBSP (PELICAN BAY SP),3070,0,3070,2380,129.0,3143
6630,2012,2,NKSP (NORTH KERN SP),4738,3,4741,2694,176.0,4770
6631,2012,2,MCSP (MULE CREEK SP),3089,0,3089,1700,181.7,3036
6632,2012,2,KVSP (KERN VALLEY SP),4180,0,4180,2448,170.8,4344
6633,2012,2,ISP (IRONWOOD SP),3704,0,3704,2200,168.4,3660
6634,2012,2,HDSP (HIGH DESERT SP),3875,0,3875,2324,166.7,3746
6635,2012,2,FOL (FOLSOM SP) (MALE),3119,0,3119,2469,126.3,3272
6636,2012,2,DVI (DEUEL VOCATIONAL INSTITUTION),2569,7,2576,1681,153.2,2685
6637,2012,2,CTF (CORRECTIONAL TRAINING FAC),6039,0,6039,3312,182.3,5620
6638,2012,2,CVSP (CHUCKAWALLA VALLEY SP),2871,0,2871,1738,165.2,3006
6639,2012,2,SATF (CA SUBSTANCE ABUSE TREAT FAC),5794,11,5805,3424,169.5,5578
6640,2012,2,"SOL (CA SP, SOLANO)",4559,0,4559,2610,174.7,4538
6641,2012,2,SQ (SAN QUENTIN SP),3952,4,3956,3082,128.4,3932
6642,2012,2,"SAC (CA SP, SACRAMENTO)",2802,0,2802,1828,153.3,2743
6643,2012,2,"LAC (CA SP, LOS ANGELES COUNTY)",3722,0,3722,2300,161.8,3990
6644,2012,2,"COR (CA SP, CORCORAN)",4469,0,4469,3116,143.4,4617
6645,2012,2,CEN (CENTINELA SP),3705,0,3705,2308,160.5,3758
6646,2012,2,CAL (CALIPATRIA SP),4190,0,4190,2308,181.5,3960
6647,2012,2,"CRC (CAL REHAB CTR, MEN)",3727,249,3976,2491,159.6,4070
6648,2012,2,CMC (CA MEN'S COLONY),5497,0,5497,3838,143.2,5586
6649,2012,2,CMF (CA MEDICAL FAC),2374,0,2374,2297,103.4,2340
6650,2012,2,CIM (CA INSTITUTION FOR MEN),5181,6,5187,2976,174.3,6311
6651,2012,2,CCI (CA CORRECTIONAL INSTITUTION),4649,0,4649,2783,167.0,5083
6652,2012,2,CCC (CA CORRECTIONAL CENTER),4938,0,4938,3883,127.2,4843
6653,2012,2,ASP (AVENAL SP),5350,0,5350,2920,183.2,5427
6654,2012,3,VSP (VALLEY SP),2432,0,2432,1980,122.8,2497
6655,2012,3,CCWF (CENTRAL CA WOMEN'S FAC),2790,46,2836,2004,141.5,3016
6656,2012,3,CIW (CA INSTITUTION FOR WOMEN),1585,58,1643,1356,121.2,1775
6657,2012,3,WSP (WASCO SP),5188,1,5189,2984,173.9,5135
6658,2012,3,SCC (SIERRA CONSERVATION CENTER),4722,0,4722,3736,126.4,4811
6659,2012,3,SVSP (SALINAS VALLEY SP),3513,0,3513,2452,143.3,3459
6660,2012,3,RJD (RJ DONOVAN CORRECTIONAL FAC),3666,0,3666,2200,166.6,3820
6661,2012,3,PVSP (PLEASANT VALLEY SP),3731,0,3731,2308,161.7,3758
6662,2012,3,PBSP (PELICAN BAY SP),3091,0,3091,2380,129.9,3143
6663,2012,3,NKSP (NORTH KERN SP),4730,0,4730,2694,175.6,4770
6664,2012,3,MCSP (MULE CREEK SP),3065,0,3065,1700,180.3,3036
6665,2012,3,KVSP (KERN VALLEY SP),4171,0,4171,2448,170.4,4344
6666,2012,3,ISP (IRONWOOD SP),3514,0,3514,2200,159.7,3485
6667,2012,3,HDSP (HIGH DESERT SP),3778,0,3778,2324,162.6,3746
6668,2012,3,FOL (FOLSOM SP) (MALE),2912,0,2912,2469,117.9,2937
6669,2012,3,DVI (DEUEL VOCATIONAL INSTITUTION),2585,12,2597,1681,154.5,2685
6670,2012,3,CTF (CORRECTIONAL TRAINING FAC),5684,0,5684,3312,171.6,5320
6671,2012,3,CVSP (CHUCKAWALLA VALLEY SP),2716,0,2716,1738,156.3,2811
6672,2012,3,SATF (CA SUBSTANCE ABUSE TREAT FAC),5719,9,5728,3424,167.3,5483
6673,2012,3,"SOL (CA SP, SOLANO)",4473,0,4473,2610,171.4,4593
6674,2012,3,SQ (SAN QUENTIN SP),3933,1,3934,3082,127.6,3932
6675,2012,3,"SAC (CA SP, SACRAMENTO)",2777,0,2777,1828,151.9,2743
6676,2012,3,"LAC (CA SP, LOS ANGELES COUNTY)",3897,0,3897,2300,169.4,3990
6677,2012,3,"COR (CA SP, CORCORAN)",4500,0,4500,3116,144.4,4619
6678,2012,3,CEN (CENTINELA SP),3709,0,3709,2308,160.7,3758
6679,2012,3,CAL (CALIPATRIA SP),4015,0,4015,2308,174.0,3810
6680,2012,3,"CRC (CAL REHAB CTR, MEN)",3705,234,3939,2491,158.1,4022
6681,2012,3,CMC (CA MEN'S COLONY),5524,0,5524,3838,143.9,5586
6682,2012,3,CMF (CA MEDICAL FAC),2404,0,2404,2297,104.7,2340
6683,2012,3,CIM (CA INSTITUTION FOR MEN),5198,8,5206,2976,174.9,6311
6684,2012,3,CCI (CA CORRECTIONAL INSTITUTION),4753,0,4753,2783,170.8,5083
6685,2012,3,CCC (CA CORRECTIONAL CENTER),4818,0,4818,3883,124.1,4713
6686,2012,3,ASP (AVENAL SP),5190,0,5190,2920,177.7,5306
6687,2012,4,VSP (VALLEY SP),2296,0,2296,1980,116.0,2305
6688,2012,4,CCWF (CENTRAL CA WOMEN'S FAC),2697,54,2751,2004,137.3,2836
6689,2012,4,CIW (CA INSTITUTION FOR WOMEN),1580,48,1628,1356,120.1,1775
6690,2012,4,WSP (WASCO SP),5209,2,5211,2984,174.6,5135
6691,2012,4,SCC (SIERRA CONSERVATION CENTER),4610,0,4610,3736,123.4,4811
6692,2012,4,SVSP (SALINAS VALLEY SP),3517,0,3517,2452,143.4,3459
6693,2012,4,RJD (RJ DONOVAN CORRECTIONAL FAC),3635,0,3635,2200,165.2,3820
6694,2012,4,PVSP (PLEASANT VALLEY SP),3739,0,3739,2308,162.0,3758
6695,2012,4,PBSP (PELICAN BAY SP),3078,0,3078,2380,129.3,3143
6696,2012,4,NKSP (NORTH KERN SP),4751,1,4752,2694,176.4,4770
6697,2012,4,MCSP (MULE CREEK SP),3035,0,3035,1700,178.5,3036
6698,2012,4,KVSP (KERN VALLEY SP),4176,0,4176,2448,170.6,4344
6699,2012,4,ISP (IRONWOOD SP),3464,0,3464,2200,157.5,3485
6700,2012,4,HDSP (HIGH DESERT SP),3719,0,3719,2324,160.0,3746
6701,2012,4,FOL (FOLSOM SP) (MALE),2940,0,2940,2469,119.1,2937
6702,2012,4,DVI (DEUEL VOCATIONAL INSTITUTION),2492,12,2504,1681,149.0,2478
6703,2012,4,CTF (CORRECTIONAL TRAINING FAC),5649,0,5649,3312,170.6,5320
6704,2012,4,CVSP (CHUCKAWALLA VALLEY SP),2561,0,2561,1738,147.4,2615
6705,2012,4,SATF (CA SUBSTANCE ABUSE TREAT FAC),5668,8,5676,3424,165.8,5483
6706,2012,4,"SOL (CA SP, SOLANO)",4217,0,4217,2610,161.6,4240
6707,2012,4,SQ (SAN QUENTIN SP),3717,5,3722,3082,120.8,3882
6708,2012,4,"SAC (CA SP, SACRAMENTO)",2741,0,2741,1828,149.9,2743
6709,2012,4,"LAC (CA SP, LOS ANGELES COUNTY)",3916,0,3916,2300,170.3,3990
6710,2012,4,"COR (CA SP, CORCORAN)",4549,0,4549,3116,146.0,4619
6711,2012,4,CEN (CENTINELA SP),3663,0,3663,2308,158.7,3758
6712,2012,4,CAL (CALIPATRIA SP),3937,0,3937,2308,170.6,3810
6713,2012,4,"CRC (CAL REHAB CTR, MEN)",3606,211,3817,2491,153.2,3906
6714,2012,4,CMC (CA MEN'S COLONY),5551,0,5551,3838,144.6,5586
6715,2012,4,CMF (CA MEDICAL FAC),2402,0,2402,2297,104.6,2340
6716,2012,4,CIM (CA INSTITUTION FOR MEN),5162,8,5170,2976,173.7,6261
6717,2012,4,CCI (CA CORRECTIONAL INSTITUTION),4609,0,4609,2783,165.6,5083
6718,2012,4,CCC (CA CORRECTIONAL CENTER),4826,0,4826,3883,124.3,4690
6719,2012,4,ASP (AVENAL SP),5021,0,5021,2920,172.0,5185
6720,2012,5,VSP (VALLEY SP),2209,0,2209,1980,111.6,2305
6721,2012,5,CCWF (CENTRAL CA WOMEN'S FAC),2669,54,2723,2004,135.9,2836
6722,2012,5,CIW (CA INSTITUTION FOR WOMEN),1524,48,1572,1356,115.9,1595
6723,2012,5,WSP (WASCO SP),5205,1,5206,2984,174.5,5135
6724,2012,5,SCC (SIERRA CONSERVATION CENTER),4472,0,4472,3736,119.7,4701
6725,2012,5,SVSP (SALINAS VALLEY SP),3551,0,3551,2452,144.8,3459
6726,2012,5,RJD (RJ DONOVAN CORRECTIONAL FAC),3513,0,3513,2200,159.7,3610
6727,2012,5,PVSP (PLEASANT VALLEY SP),3718,0,3718,2308,161.1,3758
6728,2012,5,PBSP (PELICAN BAY SP),3124,0,3124,2380,131.3,3143
6729,2012,5,NKSP (NORTH KERN SP),4722,2,4724,2694,175.4,4770
6730,2012,5,MCSP (MULE CREEK SP),3037,0,3037,1700,178.6,3036
6731,2012,5,KVSP (KERN VALLEY SP),4202,0,4202,2448,171.7,4344
6732,2012,5,ISP (IRONWOOD SP),3343,0,3343,2200,152.0,3360
6733,2012,5,HDSP (HIGH DESERT SP),3738,1,3739,2324,160.9,3695
6734,2012,5,FOL (FOLSOM SP) (MALE),2906,0,2906,2469,117.7,2937
6735,2012,5,DVI (DEUEL VOCATIONAL INSTITUTION),2523,3,2526,1681,150.3,2478
6736,2012,5,CTF (CORRECTIONAL TRAINING FAC),5651,0,5651,3312,170.6,5202
6737,2012,5,CVSP (CHUCKAWALLA VALLEY SP),2513,0,2513,1738,144.6,2615
6738,2012,5,SATF (CA SUBSTANCE ABUSE TREAT FAC),5604,7,5611,3424,163.9,5483
6739,2012,5,"SOL (CA SP, SOLANO)",4255,0,4255,2610,163.0,4240
6740,2012,5,SQ (SAN QUENTIN SP),3664,4,3668,3082,119.0,3882
6741,2012,5,"SAC (CA SP, SACRAMENTO)",2694,0,2694,1828,147.4,2743
6742,2012,5,"LAC (CA SP, LOS ANGELES COUNTY)",3941,0,3941,2300,171.3,3990
6743,2012,5,"COR (CA SP, CORCORAN)",4626,0,4626,3116,148.5,4619
6744,2012,5,CEN (CENTINELA SP),3679,0,3679,2308,159.4,3758
6745,2012,5,CAL (CALIPATRIA SP),3836,0,3836,2308,166.2,3810
6746,2012,5,"CRC (CAL REHAB CTR, MEN)",3466,217,3683,2491,147.9,3769
6747,2012,5,CMC (CA MEN'S COLONY),5503,0,5503,3838,143.4,5511
6748,2012,5,CMF (CA MEDICAL FAC),2396,0,2396,2297,104.3,2340
6749,2012,5,CIM (CA INSTITUTION FOR MEN),5149,6,5155,2976,173.2,6161
6750,2012,5,CCI (CA CORRECTIONAL INSTITUTION),4540,0,4540,2783,163.1,5083
6751,2012,5,CCC (CA CORRECTIONAL CENTER),4699,0,4699,3883,121.0,4690
6752,2012,5,ASP (AVENAL SP),4819,0,4819,2920,165.0,5185
6753,2012,6,VSP (VALLEY SP),2142,0,2142,1980,108.2,2305
6754,2012,6,CCWF (CENTRAL CA WOMEN'S FAC),2642,54,2696,2004,134.5,2836
6755,2012,6,CIW (CA INSTITUTION FOR WOMEN),1445,43,1488,1356,109.7,1595
6756,2012,6,WSP (WASCO SP),5097,8,5105,2984,171.1,5135
6757,2012,6,SCC (SIERRA CONSERVATION CENTER),4404,0,4404,3736,117.9,4701
6758,2012,6,SVSP (SALINAS VALLEY SP),3552,0,3552,2452,144.9,3459
6759,2012,6,RJD (RJ DONOVAN CORRECTIONAL FAC),3504,0,3504,2200,159.3,3610
6760,2012,6,PVSP (PLEASANT VALLEY SP),3740,0,3740,2308,162.0,3758
6761,2012,6,PBSP (PELICAN BAY SP),3176,0,3176,2380,133.4,3143
6762,2012,6,NKSP (NORTH KERN SP),4695,0,4695,2694,174.3,4770
6763,2012,6,MCSP (MULE CREEK SP),3062,0,3062,1700,180.1,3036
6764,2012,6,KVSP (KERN VALLEY SP),4175,0,4175,2448,170.5,4344
6765,2012,6,ISP (IRONWOOD SP),3344,0,3344,2200,152.0,3360
6766,2012,6,HDSP (HIGH DESERT SP),3730,0,3730,2324,160.5,3695
6767,2012,6,FOL (FOLSOM SP) (MALE),2900,0,2900,2469,117.5,2937
6768,2012,6,DVI (DEUEL VOCATIONAL INSTITUTION),2505,8,2513,1681,149.5,2478
6769,2012,6,CTF (CORRECTIONAL TRAINING FAC),5613,1,5614,3312,169.5,5202
6770,2012,6,CVSP (CHUCKAWALLA VALLEY SP),2535,0,2535,1738,145.9,2615
6771,2012,6,SATF (CA SUBSTANCE ABUSE TREAT FAC),5518,5,5523,3424,161.3,5483
6772,2012,6,"SOL (CA SP, SOLANO)",4254,0,4254,2610,163.0,4240
6773,2012,6,SQ (SAN QUENTIN SP),3721,1,3722,3082,120.8,3882
6774,2012,6,"SAC (CA SP, SACRAMENTO)",2711,0,2711,1828,148.3,2743
6775,2012,6,"LAC (CA SP, LOS ANGELES COUNTY)",3940,0,3940,2300,171.3,3990
6776,2012,6,"COR (CA SP, CORCORAN)",4651,0,4651,3116,149.3,4619
6777,2012,6,CEN (CENTINELA SP),3739,0,3739,2308,162.0,3758
6778,2012,6,CAL (CALIPATRIA SP),3853,0,3853,2308,166.9,3810
6779,2012,6,"CRC (CAL REHAB CTR, MEN)",3448,207,3655,2491,146.7,3769
6780,2012,6,CMC (CA MEN'S COLONY),5419,0,5419,3838,141.2,5511
6781,2012,6,CMF (CA MEDICAL FAC),2372,0,2372,2297,103.3,2340
6782,2012,6,CIM (CA INSTITUTION FOR MEN),5011,5,5016,2976,168.5,6161
6783,2012,6,CCI (CA CORRECTIONAL INSTITUTION),4606,0,4606,2783,165.5,5083
6784,2012,6,CCC (CA CORRECTIONAL CENTER),4565,0,4565,3883,117.6,4690
6785,2012,6,ASP (AVENAL SP),4666,0,4666,2920,159.8,5185
6786,2012,7,VSP (VALLEY SP),1995,0,1995,1980,100.8,2101
6787,2012,7,CCWF (CENTRAL CA WOMEN'S FAC),2615,52,2667,2004,133.1,2836
6788,2012,7,CIW (CA INSTITUTION FOR WOMEN),1454,39,1493,1356,110.1,1642
6789,2012,7,WSP (WASCO SP),4886,3,4889,2984,163.8,5135
6790,2012,7,SCC (SIERRA CONSERVATION CENTER),4316,0,4316,3736,115.5,4701
6791,2012,7,SVSP (SALINAS VALLEY SP),3550,0,3550,2452,144.8,3459
6792,2012,7,RJD (RJ DONOVAN CORRECTIONAL FAC),3267,0,3267,2200,148.5,3560
6793,2012,7,PVSP (PLEASANT VALLEY SP),3816,0,3816,2308,165.3,3758
6794,2012,7,PBSP (PELICAN BAY SP),3173,0,3173,2380,133.3,3143
6795,2012,7,NKSP (NORTH KERN SP),4621,2,4623,2694,171.6,4789
6796,2012,7,MCSP (MULE CREEK SP),3049,0,3049,1700,179.4,3036
6797,2012,7,KVSP (KERN VALLEY SP),4151,0,4151,2448,169.6,4344
6798,2012,7,ISP (IRONWOOD SP),3420,0,3420,2200,155.5,3310
6799,2012,7,HDSP (HIGH DESERT SP),3730,2,3732,2324,160.6,3695
6800,2012,7,FOL (FOLSOM SP) (MALE),2839,0,2839,2469,115.0,2852
6801,2012,7,DVI (DEUEL VOCATIONAL INSTITUTION),2505,5,2510,1681,149.3,2478
6802,2012,7,CTF (CORRECTIONAL TRAINING FAC),5644,0,5644,3312,170.4,5202
6803,2012,7,CVSP (CHUCKAWALLA VALLEY SP),2657,0,2657,1738,152.9,2615
6804,2012,7,SATF (CA SUBSTANCE ABUSE TREAT FAC),5518,5,5523,3424,161.3,5300
6805,2012,7,"SOL (CA SP, SOLANO)",4219,0,4219,2610,161.6,4240
6806,2012,7,SQ (SAN QUENTIN SP),3699,0,3699,3082,120.0,3882
6807,2012,7,"SAC (CA SP, SACRAMENTO)",2651,0,2651,1828,145.0,2743
6808,2012,7,"LAC (CA SP, LOS ANGELES COUNTY)",3950,0,3950,2300,171.7,3990
6809,2012,7,"COR (CA SP, CORCORAN)",4731,0,4731,3116,151.8,4619
6810,2012,7,CEN (CENTINELA SP),3746,0,3746,2308,162.3,3758
6811,2012,7,CAL (CALIPATRIA SP),3749,0,3749,2308,162.4,3710
6812,2012,7,"CRC (CAL REHAB CTR, MEN)",3451,188,3639,2491,146.1,3769
6813,2012,7,CMC (CA MEN'S COLONY),5340,0,5340,3838,139.1,5320
6814,2012,7,CMF (CA MEDICAL FAC),2347,0,2347,2297,102.2,2377
6815,2012,7,CIM (CA INSTITUTION FOR MEN),4915,6,4921,2976,165.4,6005
6816,2012,7,CCI (CA CORRECTIONAL INSTITUTION),4679,0,4679,2783,168.1,5083
6817,2012,7,CCC (CA CORRECTIONAL CENTER),4485,0,4485,3883,115.5,4392
6818,2012,7,ASP (AVENAL SP),4641,0,4641,2920,158.9,4606
6819,2012,8,VSP (VALLEY SP),1866,0,1866,1980,94.2,2009
6820,2012,8,CCWF (CENTRAL CA WOMEN'S FAC),2653,37,2690,2004,134.2,2836
6821,2012,8,CIW (CA INSTITUTION FOR WOMEN),1494,40,1534,1356,113.1,1642
6822,2012,8,WSP (WASCO SP),5009,2,5011,2984,167.9,5135
6823,2012,8,SCC (SIERRA CONSERVATION CENTER),4293,0,4293,3736,114.9,4701
6824,2012,8,SVSP (SALINAS VALLEY SP),3563,0,3563,2452,145.3,3459
6825,2012,8,RJD (RJ DONOVAN CORRECTIONAL FAC),3291,0,3291,2200,149.6,3560
6826,2012,8,PVSP (PLEASANT VALLEY SP),3739,0,3739,2308,162.0,3758
6827,2012,8,PBSP (PELICAN BAY SP),3133,0,3133,2380,131.6,3143
6828,2012,8,NKSP (NORTH KERN SP),4685,0,4685,2694,173.9,4789
6829,2012,8,MCSP (MULE CREEK SP),3019,0,3019,1700,177.6,3036
6830,2012,8,KVSP (KERN VALLEY SP),4079,0,4079,2448,166.6,4344
6831,2012,8,ISP (IRONWOOD SP),3470,0,3470,2200,157.7,3310
6832,2012,8,HDSP (HIGH DESERT SP),3661,0,3661,2324,157.5,3695
6833,2012,8,FOL (FOLSOM SP) (MALE),2804,0,2804,2469,113.6,2852
6834,2012,8,DVI (DEUEL VOCATIONAL INSTITUTION),2517,6,2523,1681,150.1,2478
6835,2012,8,CTF (CORRECTIONAL TRAINING FAC),5666,0,5666,3312,171.1,5075
6836,2012,8,CVSP (CHUCKAWALLA VALLEY SP),2712,0,2712,1738,156.0,2615
6837,2012,8,SATF (CA SUBSTANCE ABUSE TREAT FAC),5533,2,5535,3424,161.7,5300
6838,2012,8,"SOL (CA SP, SOLANO)",4265,0,4265,2610,163.4,4240
6839,2012,8,SQ (SAN QUENTIN SP),3748,1,3749,3082,121.6,3882
6840,2012,8,"SAC (CA SP, SACRAMENTO)",2666,0,2666,1828,145.8,2743
6841,2012,8,"LAC (CA SP, LOS ANGELES COUNTY)",3927,0,3927,2300,170.7,3990
6842,2012,8,"COR (CA SP, CORCORAN)",4716,0,4716,3116,151.3,4619
6843,2012,8,CEN (CENTINELA SP),3700,0,3700,2308,160.3,3758
6844,2012,8,CAL (CALIPATRIA SP),3680,0,3680,2308,159.4,3710
6845,2012,8,"CRC (CAL REHAB CTR, MEN)",3446,143,3589,2491,144.1,3769
6846,2012,8,CMC (CA MEN'S COLONY),5231,0,5231,3838,136.3,5320
6847,2012,8,CMF (CA MEDICAL FAC),2316,0,2316,2297,100.8,2377
6848,2012,8,CIM (CA INSTITUTION FOR MEN),4852,16,4868,2976,163.6,6005
6849,2012,8,CCI (CA CORRECTIONAL INSTITUTION),4787,0,4787,2783,172.0,5083
6850,2012,8,CCC (CA CORRECTIONAL CENTER),4406,0,4406,3883,113.5,4392
6851,2012,8,ASP (AVENAL SP),4783,0,4783,2920,163.8,4606
6852,2012,9,VSP (VALLEY SP),1721,0,1721,1980,86.9,1692
6853,2012,9,CCWF (CENTRAL CA WOMEN'S FAC),2689,33,2722,2004,135.8,2836
6854,2012,9,CIW (CA INSTITUTION FOR WOMEN),1517,44,1561,1356,115.1,1642
6855,2012,9,WSP (WASCO SP),5031,0,5031,2984,168.6,5141
6856,2012,9,SCC (SIERRA CONSERVATION CENTER),4354,0,4354,3736,116.5,4701
6857,2012,9,SVSP (SALINAS VALLEY SP),3497,0,3497,2452,142.6,3409
6858,2012,9,RJD (RJ DONOVAN CORRECTIONAL FAC),3451,0,3451,2200,156.9,3560
6859,2012,9,PVSP (PLEASANT VALLEY SP),3775,0,3775,2308,163.6,3633
6860,2012,9,PBSP (PELICAN BAY SP),3098,0,3098,2380,130.2,3143
6861,2012,9,NKSP (NORTH KERN SP),4734,0,4734,2694,175.7,4789
6862,2012,9,MCSP (MULE CREEK SP),2933,0,2933,1700,172.5,3036
6863,2012,9,KVSP (KERN VALLEY SP),3959,0,3959,2448,161.7,4344
6864,2012,9,ISP (IRONWOOD SP),3513,0,3513,2200,159.7,3310
6865,2012,9,HDSP (HIGH DESERT SP),3612,0,3612,2324,155.4,3695
6866,2012,9,FOL (FOLSOM SP) (MALE),2746,0,2746,2469,111.2,2852
6867,2012,9,DVI (DEUEL VOCATIONAL INSTITUTION),2456,7,2463,1681,146.5,2478
6868,2012,9,CTF (CORRECTIONAL TRAINING FAC),5739,0,5739,3312,173.3,5075
6869,2012,9,CVSP (CHUCKAWALLA VALLEY SP),2758,0,2758,1738,158.7,2615
6870,2012,9,SATF (CA SUBSTANCE ABUSE TREAT FAC),5554,2,5556,3424,162.3,5388
6871,2012,9,"SOL (CA SP, SOLANO)",4222,0,4222,2610,161.8,4240
6872,2012,9,SQ (SAN QUENTIN SP),3842,0,3842,3082,124.7,3882
6873,2012,9,"SAC (CA SP, SACRAMENTO)",2655,0,2655,1828,145.2,2743
6874,2012,9,"LAC (CA SP, LOS ANGELES COUNTY)",3884,0,3884,2300,168.9,3990
6875,2012,9,"COR (CA SP, CORCORAN)",4720,0,4720,3116,151.5,4619
6876,2012,9,CEN (CENTINELA SP),3679,0,3679,2308,159.4,3758
6877,2012,9,CAL (CALIPATRIA SP),3620,0,3620,2308,156.8,3710
6878,2012,9,"CRC (CAL REHAB CTR, MEN)",3399,113,3512,2491,141.0,3581
6879,2012,9,CMC (CA MEN'S COLONY),5154,0,5154,3838,134.3,5207
6880,2012,9,CMF (CA MEDICAL FAC),2294,0,2294,2297,99.9,2414
6881,2012,9,CIM (CA INSTITUTION FOR MEN),4776,5,4781,2976,160.7,5855
6882,2012,9,CCI (CA CORRECTIONAL INSTITUTION),4756,0,4756,2783,170.9,4946
6883,2012,9,CCC (CA CORRECTIONAL CENTER),4457,0,4457,3883,114.8,4392
6884,2012,9,ASP (AVENAL SP),4918,0,4918,2920,168.4,4606
6885,2012,10,VSP (VALLEY SP),1171,0,1171,1536,76.2,1248
6886,2012,10,CCWF (CENTRAL CA WOMEN'S FAC),3071,30,3101,2004,154.7,2836
6887,2012,10,CIW (CA INSTITUTION FOR WOMEN),1653,32,1685,1356,124.3,1642
6888,2012,10,WSP (WASCO SP),5029,1,5030,2984,168.6,5141
6889,2012,10,VSP (VALLEY SP),445,0,445,444,100.2,488
6890,2012,10,SCC (SIERRA CONSERVATION CENTER),4507,0,4507,3736,120.6,4701
6891,2012,10,SVSP (SALINAS VALLEY SP),3553,0,3553,2452,144.9,3409
6892,2012,10,RJD (RJ DONOVAN CORRECTIONAL FAC),3487,0,3487,2200,158.5,3560
6893,2012,10,PVSP (PLEASANT VALLEY SP),3720,0,3720,2308,161.2,3633
6894,2012,10,PBSP (PELICAN BAY SP),3047,0,3047,2380,128.0,3143
6895,2012,10,NKSP (NORTH KERN SP),4741,0,4741,2694,176.0,4789
6896,2012,10,MCSP (MULE CREEK SP),2898,0,2898,1700,170.5,3036
6897,2012,10,KVSP (KERN VALLEY SP),3985,0,3985,2448,162.8,4344
6898,2012,10,ISP (IRONWOOD SP),3490,0,3490,2200,158.6,3310
6899,2012,10,HDSP (HIGH DESERT SP),3530,0,3530,2324,151.9,3695
6900,2012,10,FOL (FOLSOM SP) (MALE),2648,0,2648,2469,107.2,2852
6901,2012,10,DVI (DEUEL VOCATIONAL INSTITUTION),2425,6,2431,1681,144.6,2478
6902,2012,10,CTF (CORRECTIONAL TRAINING FAC),5797,0,5797,3312,175.0,5075
6903,2012,10,CVSP (CHUCKAWALLA VALLEY SP),2812,0,2812,1738,161.8,2615
6904,2012,10,SATF (CA SUBSTANCE ABUSE TREAT FAC),5666,2,5668,3424,165.5,5388
6905,2012,10,"SOL (CA SP, SOLANO)",4252,0,4252,2610,162.9,4240
6906,2012,10,SQ (SAN QUENTIN SP),3864,0,3864,3082,125.4,3882
6907,2012,10,"SAC (CA SP, SACRAMENTO)",2555,0,2555,1828,139.8,2743
6908,2012,10,"LAC (CA SP, LOS ANGELES COUNTY)",3867,0,3867,2300,168.1,3990
6909,2012,10,"COR (CA SP, CORCORAN)",4716,0,4716,3116,151.3,4619
6910,2012,10,CEN (CENTINELA SP),3554,0,3554,2308,154.0,3758
6911,2012,10,CAL (CALIPATRIA SP),3520,0,3520,2308,152.5,3710
6912,2012,10,"CRC (CAL REHAB CTR, MEN)",3341,110,3451,2491,138.5,3581
6913,2012,10,CMC (CA MEN'S COLONY),5113,0,5113,3838,133.2,5207
6914,2012,10,CMF (CA MEDICAL FAC),2316,0,2316,2297,100.8,2414
6915,2012,10,CIM (CA INSTITUTION FOR MEN),4741,5,4746,2976,159.5,5855
6916,2012,10,CCI (CA CORRECTIONAL INSTITUTION),4640,0,4640,2783,166.7,4946
6917,2012,10,CCC (CA CORRECTIONAL CENTER),4551,0,4551,3883,117.2,4392
6918,2012,10,ASP (AVENAL SP),5039,0,5039,2920,172.6,4606
6919,2012,11,VSP (VALLEY SP),720,0,720,1536,46.9,1020
6920,2012,11,CCWF (CENTRAL CA WOMEN'S FAC),3411,25,3436,2004,171.5,3082
6921,2012,11,CIW (CA INSTITUTION FOR WOMEN),1751,23,1774,1356,130.8,1822
6922,2012,11,WSP (WASCO SP),4886,0,4886,2984,163.7,5237
6923,2012,11,VSP (VALLEY SP),937,0,937,444,211.0,632
6924,2012,11,SCC (SIERRA CONSERVATION CENTER),4563,0,4563,3736,122.1,4601
6925,2012,11,SVSP (SALINAS VALLEY SP),3623,0,3623,2452,147.8,3554
6926,2012,11,RJD (RJ DONOVAN CORRECTIONAL FAC),3550,0,3550,2200,161.4,3340
6927,2012,11,PVSP (PLEASANT VALLEY SP),3628,0,3628,2308,157.2,3558
6928,2012,11,PBSP (PELICAN BAY SP),3017,0,3017,2380,126.8,3143
6929,2012,11,NKSP (NORTH KERN SP),4633,2,4635,2694,172.0,4789
6930,2012,11,MCSP (MULE CREEK SP),2851,0,2851,1700,167.7,2821
6931,2012,11,KVSP (KERN VALLEY SP),3921,0,3921,2448,160.2,4344
6932,2012,11,ISP (IRONWOOD SP),3526,0,3526,2200,160.3,3300
6933,2012,11,HDSP (HIGH DESERT SP),3491,0,3491,2324,150.2,3695
6934,2012,11,FOL (FOLSOM SP) (MALE),2488,0,2488,2469,100.8,2895
6935,2012,11,DVI (DEUEL VOCATIONAL INSTITUTION),2278,6,2284,1681,135.9,2478
6936,2012,11,CTF (CORRECTIONAL TRAINING FAC),5764,0,5764,3312,174.0,5480
6937,2012,11,CVSP (CHUCKAWALLA VALLEY SP),2728,0,2728,1738,157.0,2453
6938,2012,11,SATF (CA SUBSTANCE ABUSE TREAT FAC),5718,2,5720,3424,167.1,5550
6939,2012,11,"SOL (CA SP, SOLANO)",4231,0,4231,2610,162.1,4050
6940,2012,11,SQ (SAN QUENTIN SP),3943,0,3943,3082,127.9,3775
6941,2012,11,"SAC (CA SP, SACRAMENTO)",2531,0,2531,1828,138.5,2743
6942,2012,11,"LAC (CA SP, LOS ANGELES COUNTY)",3805,0,3805,2300,165.4,3866
6943,2012,11,"COR (CA SP, CORCORAN)",4655,0,4655,3116,149.4,4619
6944,2012,11,CEN (CENTINELA SP),3471,0,3471,2308,150.4,3508
6945,2012,11,CAL (CALIPATRIA SP),3547,0,3547,2308,153.7,3833
6946,2012,11,"CRC (CAL REHAB CTR, MEN)",3336,97,3433,2491,137.8,3381
6947,2012,11,CMC (CA MEN'S COLONY),5175,0,5175,3838,134.8,5157
6948,2012,11,CMF (CA MEDICAL FAC),2343,0,2343,2297,102.0,2598
6949,2012,11,CIM (CA INSTITUTION FOR MEN),4837,4,4841,2976,162.7,4505
6950,2012,11,CCI (CA CORRECTIONAL INSTITUTION),4552,0,4552,2783,163.6,4337
6951,2012,11,CCC (CA CORRECTIONAL CENTER),4552,0,4552,3883,117.2,4718
6952,2012,11,ASP (AVENAL SP),5019,0,5019,2920,171.9,4481
6953,2012,12,VSP (VALLEY SP),274,0,274,1536,17.8,650
6954,2012,12,CCWF (CENTRAL CA WOMEN'S FAC),3655,21,3676,2004,183.4,3519
6955,2012,12,CIW (CA INSTITUTION FOR WOMEN),1875,18,1893,1356,139.6,1822
6956,2012,12,WSP (WASCO SP),4970,1,4971,2984,166.6,5237
6957,2012,12,VSP (VALLEY SP),1353,0,1353,444,304.7,1032
6958,2012,12,SCC (SIERRA CONSERVATION CENTER),4687,0,4687,3736,125.5,4601
6959,2012,12,SVSP (SALINAS VALLEY SP),3633,0,3633,2452,148.2,3554
6960,2012,12,RJD (RJ DONOVAN CORRECTIONAL FAC),3559,0,3559,2200,161.8,3340
6961,2012,12,PVSP (PLEASANT VALLEY SP),3644,0,3644,2308,157.9,3558
6962,2012,12,PBSP (PELICAN BAY SP),2977,0,2977,2380,125.1,3143
6963,2012,12,NKSP (NORTH KERN SP),4528,2,4530,2694,168.2,4789
6964,2012,12,MCSP (MULE CREEK SP),2865,0,2865,1700,168.5,2701
6965,2012,12,KVSP (KERN VALLEY SP),3871,0,3871,2448,158.1,4344
6966,2012,12,ISP (IRONWOOD SP),3451,0,3451,2200,156.9,3300
6967,2012,12,HDSP (HIGH DESERT SP),3442,0,3442,2324,148.1,3695
6968,2012,12,FOL (FOLSOM SP) (MALE),2314,0,2314,2469,93.7,2895
6969,2012,12,DVI (DEUEL VOCATIONAL INSTITUTION),2213,9,2222,1681,132.2,2478
6970,2012,12,CTF (CORRECTIONAL TRAINING FAC),5636,0,5636,3312,170.2,5480
6971,2012,12,CVSP (CHUCKAWALLA VALLEY SP),2700,0,2700,1738,155.4,2453
6972,2012,12,SATF (CA SUBSTANCE ABUSE TREAT FAC),5722,2,5724,3424,167.2,5390
6973,2012,12,"SOL (CA SP, SOLANO)",4123,0,4123,2610,158.0,4050
6974,2012,12,SQ (SAN QUENTIN SP),3953,2,3955,3082,128.3,3710
6975,2012,12,"SAC (CA SP, SACRAMENTO)",2551,0,2551,1828,139.6,2743
6976,2012,12,"LAC (CA SP, LOS ANGELES COUNTY)",3741,0,3741,2300,162.7,3866
6977,2012,12,"COR (CA SP, CORCORAN)",4600,1,4601,3116,147.7,4494
6978,2012,12,CEN (CENTINELA SP),3388,0,3388,2308,146.8,3508
6979,2012,12,CAL (CALIPATRIA SP),3464,0,3464,2308,150.1,3833
6980,2012,12,"CRC (CAL REHAB CTR, MEN)",3342,101,3443,2491,138.2,3381
6981,2012,12,CMC (CA MEN'S COLONY),5122,0,5122,3838,133.5,5157
6982,2012,12,CMF (CA MEDICAL FAC),2349,0,2349,2297,102.3,2598
6983,2012,12,CIM (CA INSTITUTION FOR MEN),4844,2,4846,2976,162.8,4505
6984,2012,12,CCI (CA CORRECTIONAL INSTITUTION),4484,0,4484,2783,161.1,4337
6985,2012,12,CCC (CA CORRECTIONAL CENTER),4628,0,4628,3883,119.2,4718
6986,2012,12,ASP (AVENAL SP),4973,0,4973,2920,170.3,4481
6987,2013,1,FOL (FOLSOM SP) (FEMALE),78,0,78,203,38.4,200
6988,2013,1,CCWF (CENTRAL CA WOMEN'S FAC),3665,19,3684,2004,183.8,3519
6989,2013,1,CIW (CA INSTITUTION FOR WOMEN),2017,15,2032,1398,145.4,2042
6990,2013,1,WSP (WASCO SP),5046,1,5047,2984,169.1,4997
6991,2013,1,VSP (VALLEY SP),1936,0,1936,1980,97.8,1932
6992,2013,1,SCC (SIERRA CONSERVATION CENTER),4757,0,4757,3736,127.3,4576
6993,2013,1,SVSP (SALINAS VALLEY SP),3603,0,3603,2452,146.9,3484
6994,2013,1,RJD (RJ DONOVAN CORRECTIONAL FAC),3535,0,3535,2200,160.7,3340
6995,2013,1,PVSP (PLEASANT VALLEY SP),3628,0,3628,2308,157.2,3558
6996,2013,1,PBSP (PELICAN BAY SP),2895,0,2895,2380,121.6,3188
6997,2013,1,NKSP (NORTH KERN SP),4688,3,4691,2694,174.1,4397
6998,2013,1,MCSP (MULE CREEK SP),2814,0,2814,1700,165.5,2671
6999,2013,1,KVSP (KERN VALLEY SP),3788,0,3788,2448,154.7,4194
7000,2013,1,ISP (IRONWOOD SP),3461,0,3461,2200,157.3,3275
7001,2013,1,HDSP (HIGH DESERT SP),3500,0,3500,2324,150.6,3560
7002,2013,1,FOL (FOLSOM SP) (MALE),2251,0,2251,2469,91.2,2895
7003,2013,1,DVI (DEUEL VOCATIONAL INSTITUTION),2150,3,2153,1681,128.1,2478
7004,2013,1,CTF (CORRECTIONAL TRAINING FAC),5624,1,5625,3312,169.8,5480
7005,2013,1,CVSP (CHUCKAWALLA VALLEY SP),2695,0,2695,1738,155.1,2453
7006,2013,1,SATF (CA SUBSTANCE ABUSE TREAT FAC),5669,1,5670,3424,165.6,5365
7007,2013,1,"SOL (CA SP, SOLANO)",4054,0,4054,2610,155.3,3940
7008,2013,1,SQ (SAN QUENTIN SP),4012,0,4012,3082,130.2,3710
7009,2013,1,"SAC (CA SP, SACRAMENTO)",2461,0,2461,1828,134.6,2743
7010,2013,1,"LAC (CA SP, LOS ANGELES COUNTY)",3723,0,3723,2300,161.9,3866
7011,2013,1,"COR (CA SP, CORCORAN)",4565,1,4566,3116,146.5,4494
7012,2013,1,CEN (CENTINELA SP),3227,0,3227,2308,139.8,3483
7013,2013,1,CAL (CALIPATRIA SP),3411,0,3411,2308,147.8,3833
7014,2013,1,"CRC (CAL REHAB CTR, MEN)",3295,105,3400,2491,136.5,3381
7015,2013,1,CMC (CA MEN'S COLONY),5099,0,5099,3838,132.9,5157
7016,2013,1,CMF (CA MEDICAL FAC),2314,0,2314,2361,98.0,2634
7017,2013,1,CIM (CA INSTITUTION FOR MEN),4754,2,4756,2976,159.8,4455
7018,2013,1,CCI (CA CORRECTIONAL INSTITUTION),4475,0,4475,2783,160.8,4130
7019,2013,1,CCC (CA CORRECTIONAL CENTER),4655,0,4655,3883,119.9,4718
7020,2013,1,ASP (AVENAL SP),4891,0,4891,2920,167.5,4333
7021,2013,2,FOL (FOLSOM SP) (FEMALE),159,0,159,203,78.3,200
7022,2013,2,CCWF (CENTRAL CA WOMEN'S FAC),3585,14,3599,2004,179.6,3519
7023,2013,2,CIW (CA INSTITUTION FOR WOMEN),2005,16,2021,1398,144.6,2042
7024,2013,2,WSP (WASCO SP),5155,0,5155,2984,172.8,4997
7025,2013,2,VSP (VALLEY SP),2429,0,2429,1980,122.7,2332
7026,2013,2,SCC (SIERRA CONSERVATION CENTER),4783,0,4783,3736,128.0,4576
7027,2013,2,SVSP (SALINAS VALLEY SP),3569,0,3569,2452,145.6,3484
7028,2013,2,RJD (RJ DONOVAN CORRECTIONAL FAC),3501,0,3501,2200,159.1,3280
7029,2013,2,PVSP (PLEASANT VALLEY SP),3509,0,3509,2308,152.0,3558
7030,2013,2,PBSP (PELICAN BAY SP),2875,0,2875,2380,120.8,3188
7031,2013,2,NKSP (NORTH KERN SP),4711,2,4713,2694,174.9,4397
7032,2013,2,MCSP (MULE CREEK SP),2884,0,2884,1700,169.6,2671
7033,2013,2,KVSP (KERN VALLEY SP),3771,0,3771,2448,154.0,4194
7034,2013,2,ISP (IRONWOOD SP),3301,0,3301,2200,150.0,3275
7035,2013,2,HDSP (HIGH DESERT SP),3458,0,3458,2324,148.8,3560
7036,2013,2,FOL (FOLSOM SP) (MALE),2446,0,2446,2469,99.1,2895
7037,2013,2,DVI (DEUEL VOCATIONAL INSTITUTION),2254,4,2258,1681,134.3,2409
7038,2013,2,CTF (CORRECTIONAL TRAINING FAC),5461,0,5461,3312,164.9,5293
7039,2013,2,CVSP (CHUCKAWALLA VALLEY SP),2681,0,2681,1738,154.3,2453
7040,2013,2,SATF (CA SUBSTANCE ABUSE TREAT FAC),5601,1,5602,3424,163.6,5290
7041,2013,2,"SOL (CA SP, SOLANO)",3959,0,3959,2610,151.7,3940
7042,2013,2,SQ (SAN QUENTIN SP),3972,0,3972,3082,128.9,3710
7043,2013,2,"SAC (CA SP, SACRAMENTO)",2382,0,2382,1828,130.3,2743
7044,2013,2,"LAC (CA SP, LOS ANGELES COUNTY)",3802,0,3802,2300,165.3,3626
7045,2013,2,"COR (CA SP, CORCORAN)",4494,0,4494,3116,144.2,4494
7046,2013,2,CEN (CENTINELA SP),3107,0,3107,2308,134.6,3483
7047,2013,2,CAL (CALIPATRIA SP),3476,0,3476,2308,150.6,3833
7048,2013,2,"CRC (CAL REHAB CTR, MEN)",3305,94,3399,2491,136.5,3381
7049,2013,2,CMC (CA MEN'S COLONY),5048,0,5048,3838,131.5,5157
7050,2013,2,CMF (CA MEDICAL FAC),2325,0,2325,2361,98.5,2634
7051,2013,2,CIM (CA INSTITUTION FOR MEN),4710,2,4712,2976,158.3,4455
7052,2013,2,CCI (CA CORRECTIONAL INSTITUTION),4527,0,4527,2783,162.7,4130
7053,2013,2,CCC (CA CORRECTIONAL CENTER),4709,0,4709,3883,121.3,4718
7054,2013,2,ASP (AVENAL SP),4810,0,4810,2920,164.7,4333
7055,2013,3,FOL (FOLSOM SP) (FEMALE),195,0,195,203,96.1,200
7056,2013,3,CCWF (CENTRAL CA WOMEN'S FAC),3515,12,3527,2004,176.0,3519
7057,2013,3,CIW (CA INSTITUTION FOR WOMEN),1985,15,2000,1398,143.1,2042
7058,2013,3,WSP (WASCO SP),5249,1,5250,2984,175.9,4997
7059,2013,3,VSP (VALLEY SP),2842,0,2842,1980,143.5,2332
7060,2013,3,SCC (SIERRA CONSERVATION CENTER),4775,0,4775,3736,127.8,4576
7061,2013,3,SVSP (SALINAS VALLEY SP),3571,0,3571,2452,145.6,3484
7062,2013,3,RJD (RJ DONOVAN CORRECTIONAL FAC),3449,0,3449,2200,156.8,3280
7063,2013,3,PVSP (PLEASANT VALLEY SP),3577,0,3577,2308,155.0,3558
7064,2013,3,PBSP (PELICAN BAY SP),2861,0,2861,2380,120.2,3188
7065,2013,3,NKSP (NORTH KERN SP),4807,0,4807,2694,178.4,4397
7066,2013,3,MCSP (MULE CREEK SP),2849,0,2849,1700,167.6,2671
7067,2013,3,KVSP (KERN VALLEY SP),3712,0,3712,2448,151.6,4194
7068,2013,3,ISP (IRONWOOD SP),3317,0,3317,2200,150.8,3275
7069,2013,3,HDSP (HIGH DESERT SP),3450,0,3450,2324,148.5,3560
7070,2013,3,FOL (FOLSOM SP) (MALE),2747,0,2747,2469,111.3,2895
7071,2013,3,DVI (DEUEL VOCATIONAL INSTITUTION),2313,8,2321,1681,138.1,2409
7072,2013,3,CTF (CORRECTIONAL TRAINING FAC),5330,0,5330,3312,160.9,5293
7073,2013,3,CVSP (CHUCKAWALLA VALLEY SP),2656,0,2656,1738,152.8,2453
7074,2013,3,SATF (CA SUBSTANCE ABUSE TREAT FAC),5560,2,5562,3424,162.4,5290
7075,2013,3,"SOL (CA SP, SOLANO)",3930,0,3930,2610,150.6,3940
7076,2013,3,SQ (SAN QUENTIN SP),4101,0,4101,3082,133.1,3710
7077,2013,3,"SAC (CA SP, SACRAMENTO)",2322,0,2322,1828,127.0,2743
7078,2013,3,"LAC (CA SP, LOS ANGELES COUNTY)",3750,0,3750,2300,163.0,3626
7079,2013,3,"COR (CA SP, CORCORAN)",4490,0,4490,3116,144.1,4494
7080,2013,3,CEN (CENTINELA SP),2998,0,2998,2308,129.9,3483
7081,2013,3,CAL (CALIPATRIA SP),3520,0,3520,2308,152.5,3833
7082,2013,3,"CRC (CAL REHAB CTR, MEN)",3323,88,3411,2491,136.9,3381
7083,2013,3,CMC (CA MEN'S COLONY),4980,0,4980,3838,129.8,5157
7084,2013,3,CMF (CA MEDICAL FAC),2303,0,2303,2361,97.5,2634
7085,2013,3,CIM (CA INSTITUTION FOR MEN),4746,2,4748,2976,159.5,4455
7086,2013,3,CCI (CA CORRECTIONAL INSTITUTION),4614,0,4614,2783,165.8,4130
7087,2013,3,CCC (CA CORRECTIONAL CENTER),4704,0,4704,3883,121.1,4718
7088,2013,3,ASP (AVENAL SP),4711,0,4711,2920,161.3,4333
7089,2013,4,FOL (FOLSOM SP) (FEMALE),194,0,194,203,95.6,200
7090,2013,4,CCWF (CENTRAL CA WOMEN'S FAC),3557,13,3570,2004,178.1,3430
7091,2013,4,CIW (CA INSTITUTION FOR WOMEN),1991,13,2004,1398,143.3,2042
7092,2013,4,WSP (WASCO SP),5220,0,5220,2984,174.9,4997
7093,2013,4,VSP (VALLEY SP),3103,0,3103,1980,156.7,2970
7094,2013,4,SCC (SIERRA CONSERVATION CENTER),4768,0,4768,3736,127.6,4576
7095,2013,4,SVSP (SALINAS VALLEY SP),3501,0,3501,2452,142.8,3484
7096,2013,4,RJD (RJ DONOVAN CORRECTIONAL FAC),3365,0,3365,2200,153.0,3280
7097,2013,4,PVSP (PLEASANT VALLEY SP),3617,0,3617,2308,156.7,3558
7098,2013,4,PBSP (PELICAN BAY SP),2871,0,2871,2380,120.6,3188
7099,2013,4,NKSP (NORTH KERN SP),4804,1,4805,2694,178.4,4397
7100,2013,4,MCSP (MULE CREEK SP),2818,0,2818,1700,165.8,2575
7101,2013,4,KVSP (KERN VALLEY SP),3709,0,3709,2448,151.5,4194
7102,2013,4,ISP (IRONWOOD SP),3419,0,3419,2200,155.4,3175
7103,2013,4,HDSP (HIGH DESERT SP),3356,0,3356,2324,144.4,3560
7104,2013,4,FOL (FOLSOM SP) (MALE),2847,0,2847,2469,115.3,2895
7105,2013,4,DVI (DEUEL VOCATIONAL INSTITUTION),2401,6,2407,1681,143.2,2368
7106,2013,4,CTF (CORRECTIONAL TRAINING FAC),5271,0,5271,3312,159.1,4981
7107,2013,4,CVSP (CHUCKAWALLA VALLEY SP),2638,0,2638,1738,151.8,2453
7108,2013,4,SATF (CA SUBSTANCE ABUSE TREAT FAC),5511,1,5512,3424,161.0,5290
7109,2013,4,"SOL (CA SP, SOLANO)",3953,0,3953,2610,151.5,3940
7110,2013,4,SQ (SAN QUENTIN SP),4336,0,4336,3082,140.7,3710
7111,2013,4,"SAC (CA SP, SACRAMENTO)",2250,0,2250,1828,123.1,2743
7112,2013,4,"LAC (CA SP, LOS ANGELES COUNTY)",3784,0,3784,2300,164.5,3501
7113,2013,4,"COR (CA SP, CORCORAN)",4406,2,4408,3116,141.5,4419
7114,2013,4,CEN (CENTINELA SP),2923,0,2923,2308,126.6,3483
7115,2013,4,CAL (CALIPATRIA SP),3448,0,3448,2308,149.4,3708
7116,2013,4,"CRC (CAL REHAB CTR, MEN)",3352,91,3443,2491,138.2,3381
7117,2013,4,CMC (CA MEN'S COLONY),4921,0,4921,3838,128.2,5157
7118,2013,4,CMF (CA MEDICAL FAC),2269,0,2269,2361,96.1,2634
7119,2013,4,CIM (CA INSTITUTION FOR MEN),4689,2,4691,2976,157.6,4455
7120,2013,4,CCI (CA CORRECTIONAL INSTITUTION),4571,0,4571,2783,164.2,4130
7121,2013,4,CCC (CA CORRECTIONAL CENTER),4721,0,4721,3883,121.6,4718
7122,2013,4,ASP (AVENAL SP),4626,0,4626,2920,158.4,4333
7123,2013,5,FOL (FOLSOM SP) (FEMALE),189,0,189,403,46.9,200
7124,2013,5,CCWF (CENTRAL CA WOMEN'S FAC),3485,10,3495,2004,174.4,3430
7125,2013,5,CIW (CA INSTITUTION FOR WOMEN),2056,13,2069,1398,148.0,2042
7126,2013,5,WSP (WASCO SP),5235,1,5236,2984,175.5,4997
7127,2013,5,VSP (VALLEY SP),3195,0,3195,1980,161.4,2970
7128,2013,5,SCC (SIERRA CONSERVATION CENTER),4835,0,4835,3736,129.4,4576
7129,2013,5,SVSP (SALINAS VALLEY SP),3472,0,3472,2452,141.6,3484
7130,2013,5,RJD (RJ DONOVAN CORRECTIONAL FAC),3313,0,3313,2200,150.6,3280
7131,2013,5,PVSP (PLEASANT VALLEY SP),3558,0,3558,2308,154.2,3558
7132,2013,5,PBSP (PELICAN BAY SP),2871,0,2871,2380,120.6,3188
7133,2013,5,NKSP (NORTH KERN SP),4746,0,4746,2694,176.2,4397
7134,2013,5,MCSP (MULE CREEK SP),2844,0,2844,1700,167.3,2575
7135,2013,5,KVSP (KERN VALLEY SP),3687,0,3687,2448,150.6,4194
7136,2013,5,ISP (IRONWOOD SP),3372,0,3372,2200,153.3,3175
7137,2013,5,HDSP (HIGH DESERT SP),3284,0,3284,2324,141.3,3560
7138,2013,5,FOL (FOLSOM SP) (MALE),2940,0,2940,2066,142.3,2895
7139,2013,5,DVI (DEUEL VOCATIONAL INSTITUTION),2545,1,2546,1681,151.5,2368
7140,2013,5,CTF (CORRECTIONAL TRAINING FAC),5186,0,5186,3312,156.6,4981
7141,2013,5,CVSP (CHUCKAWALLA VALLEY SP),2644,0,2644,1738,152.1,2453
7142,2013,5,SATF (CA SUBSTANCE ABUSE TREAT FAC),5538,2,5540,3424,161.8,5290
7143,2013,5,"SOL (CA SP, SOLANO)",4008,0,4008,2610,153.6,3940
7144,2013,5,SQ (SAN QUENTIN SP),4431,0,4431,3082,143.8,3710
7145,2013,5,"SAC (CA SP, SACRAMENTO)",2220,0,2220,1828,121.4,2743
7146,2013,5,"LAC (CA SP, LOS ANGELES COUNTY)",3740,0,3740,2300,162.6,3501
7147,2013,5,"COR (CA SP, CORCORAN)",4385,0,4385,3116,140.7,4419
7148,2013,5,CEN (CENTINELA SP),3024,0,3024,2308,131.0,3483
7149,2013,5,CAL (CALIPATRIA SP),3600,0,3600,2308,156.0,3708
7150,2013,5,"CRC (CAL REHAB CTR, MEN)",3424,84,3508,2491,140.8,3381
7151,2013,5,CMC (CA MEN'S COLONY),4952,0,4952,3838,129.0,5157
7152,2013,5,CMF (CA MEDICAL FAC),2276,0,2276,2361,96.4,2634
7153,2013,5,CIM (CA INSTITUTION FOR MEN),4713,2,4715,2976,158.4,4455
7154,2013,5,CCI (CA CORRECTIONAL INSTITUTION),4614,0,4614,2783,165.8,4130
7155,2013,5,CCC (CA CORRECTIONAL CENTER),4800,0,4800,3883,123.6,4718
7156,2013,5,ASP (AVENAL SP),4538,0,4538,2920,155.4,4333
7157,2013,6,FOL (FOLSOM SP) (FEMALE),186,0,186,403,46.2,200
7158,2013,6,CCWF (CENTRAL CA WOMEN'S FAC),3519,6,3525,2004,175.9,3430
7159,2013,6,CIW (CA INSTITUTION FOR WOMEN),2118,13,2131,1398,152.4,2042
7160,2013,6,WSP (WASCO SP),5252,0,5252,2984,176.0,4997
7161,2013,6,VSP (VALLEY SP),3166,0,3166,1980,159.9,2970
7162,2013,6,SCC (SIERRA CONSERVATION CENTER),4814,0,4814,3736,128.9,4576
7163,2013,6,SVSP (SALINAS VALLEY SP),3470,0,3470,2452,141.5,3484
7164,2013,6,RJD (RJ DONOVAN CORRECTIONAL FAC),3269,0,3269,2200,148.6,3280
7165,2013,6,PVSP (PLEASANT VALLEY SP),3522,0,3522,2308,152.6,3558
7166,2013,6,PBSP (PELICAN BAY SP),2828,0,2828,2380,118.8,3188
7167,2013,6,NKSP (NORTH KERN SP),4861,0,4861,2694,180.4,4397
7168,2013,6,MCSP (MULE CREEK SP),2864,0,2864,1700,168.5,2570
7169,2013,6,KVSP (KERN VALLEY SP),3673,0,3673,2448,150.0,4194
7170,2013,6,ISP (IRONWOOD SP),3266,0,3266,2200,148.5,3175
7171,2013,6,HDSP (HIGH DESERT SP),3265,0,3265,2324,140.5,3560
7172,2013,6,FOL (FOLSOM SP) (MALE),2635,0,2635,2066,127.5,2895
7173,2013,6,DVI (DEUEL VOCATIONAL INSTITUTION),2655,0,2655,1681,157.9,2368
7174,2013,6,CTF (CORRECTIONAL TRAINING FAC),5169,0,5169,3312,156.1,4981
7175,2013,6,CVSP (CHUCKAWALLA VALLEY SP),2504,0,2504,1738,144.1,2453
7176,2013,6,SATF (CA SUBSTANCE ABUSE TREAT FAC),5571,1,5572,3424,162.7,5290
7177,2013,6,"SOL (CA SP, SOLANO)",3951,0,3951,2610,151.4,3940
7178,2013,6,SQ (SAN QUENTIN SP),4395,0,4395,3082,142.6,3710
7179,2013,6,"SAC (CA SP, SACRAMENTO)",2177,0,2177,1828,119.1,2539
7180,2013,6,"LAC (CA SP, LOS ANGELES COUNTY)",3673,0,3673,2300,159.7,3501
7181,2013,6,"COR (CA SP, CORCORAN)",4416,0,4416,3116,141.7,4419
7182,2013,6,CEN (CENTINELA SP),2884,0,2884,2308,125.0,3358
7183,2013,6,CAL (CALIPATRIA SP),3591,0,3591,2308,155.6,3608
7184,2013,6,"CRC (CAL REHAB CTR, MEN)",3437,52,3489,2491,140.1,3481
7185,2013,6,CMC (CA MEN'S COLONY),4863,1,4864,3838,126.7,5157
7186,2013,6,CMF (CA MEDICAL FAC),2255,0,2255,2361,95.5,2692
7187,2013,6,CIM (CA INSTITUTION FOR MEN),4777,3,4780,2976,160.6,4455
7188,2013,6,CCI (CA CORRECTIONAL INSTITUTION),4562,0,4562,2783,163.9,4267
7189,2013,6,CCC (CA CORRECTIONAL CENTER),4875,0,4875,3883,125.5,4718
7190,2013,6,ASP (AVENAL SP),4555,0,4555,2920,156.0,4456
7191,2013,7,FOL (FOLSOM SP) (FEMALE),238,0,238,403,59.1,200
7192,2013,7,CCWF (CENTRAL CA WOMEN'S FAC),3474,4,3478,2004,173.6,3430
7193,2013,7,CIW (CA INSTITUTION FOR WOMEN),2141,9,2150,1398,153.8,2042
7194,2013,7,WSP (WASCO SP),5107,0,5107,2984,171.1,4997
7195,2013,7,VSP (VALLEY SP),3105,0,3105,1980,156.8,2970
7196,2013,7,SCC (SIERRA CONSERVATION CENTER),4870,0,4870,3736,130.4,4576
7197,2013,7,SVSP (SALINAS VALLEY SP),3526,0,3526,2452,143.8,3484
7198,2013,7,RJD (RJ DONOVAN CORRECTIONAL FAC),3252,0,3252,2200,147.8,3280
7199,2013,7,PVSP (PLEASANT VALLEY SP),3400,0,3400,2308,147.3,3558
7200,2013,7,PBSP (PELICAN BAY SP),2826,0,2826,2380,118.7,3188
7201,2013,7,NKSP (NORTH KERN SP),4773,0,4773,2694,177.2,4397
7202,2013,7,MCSP (MULE CREEK SP),2789,0,2789,1700,164.1,2570
7203,2013,7,KVSP (KERN VALLEY SP),3705,0,3705,2448,151.3,4194
7204,2013,7,ISP (IRONWOOD SP),3192,0,3192,2200,145.1,3175
7205,2013,7,HDSP (HIGH DESERT SP),3308,0,3308,2324,142.3,3560
7206,2013,7,FOL (FOLSOM SP) (MALE),2684,0,2684,2066,129.9,2895
7207,2013,7,DVI (DEUEL VOCATIONAL INSTITUTION),2789,1,2790,1681,166.0,2368
7208,2013,7,CTF (CORRECTIONAL TRAINING FAC),5290,0,5290,3312,159.7,4981
7209,2013,7,CVSP (CHUCKAWALLA VALLEY SP),2599,2,2601,1738,149.7,2453
7210,2013,7,SATF (CA SUBSTANCE ABUSE TREAT FAC),5653,1,5654,3424,165.1,5290
7211,2013,7,"SOL (CA SP, SOLANO)",3951,0,3951,2610,151.4,3940
7212,2013,7,SQ (SAN QUENTIN SP),4303,0,4303,3082,139.6,3710
7213,2013,7,"SAC (CA SP, SACRAMENTO)",2229,0,2229,1828,121.9,2539
7214,2013,7,"LAC (CA SP, LOS ANGELES COUNTY)",3613,0,3613,2300,157.1,3501
7215,2013,7,"COR (CA SP, CORCORAN)",4284,0,4284,3116,137.5,4419
7216,2013,7,CEN (CENTINELA SP),2903,0,2903,2308,125.8,3358
7217,2013,7,CAL (CALIPATRIA SP),3641,0,3641,2308,157.8,3608
7218,2013,7,"CRC (CAL REHAB CTR, MEN)",3479,43,3522,2491,141.4,3481
7219,2013,7,CMC (CA MEN'S COLONY),4911,0,4911,3838,128.0,5157
7220,2013,7,CMF (CA MEDICAL FAC),2326,0,2326,2361,98.5,2692
7221,2013,7,CIM (CA INSTITUTION FOR MEN),4843,2,4845,2976,162.8,4455
7222,2013,7,CHCF (CA HEALTH CARE FAC - STOCKTON),182,0,182,1818,10.0,1818
7223,2013,7,CCI (CA CORRECTIONAL INSTITUTION),4557,0,4557,2783,163.7,4267
7224,2013,7,CCC (CA CORRECTIONAL CENTER),5007,0,5007,3883,128.9,4718
7225,2013,7,ASP (AVENAL SP),4523,0,4523,2920,154.9,4456
7226,2013,8,FOL (FOLSOM SP) (FEMALE),264,0,264,403,65.5,403
7227,2013,8,CIW (CA INSTITUTION FOR WOMEN),2159,2,2161,1398,154.6,2042
7228,2013,8,CCWF (CENTRAL CA WOMEN'S FAC),3470,0,3470,2004,173.2,3430
7229,2013,8,WSP (WASCO SP),5149,1,5150,2984,172.6,4997
7230,2013,8,VSP (VALLEY SP),3157,0,3157,1980,159.4,2970
7231,2013,8,SVSP (SALINAS VALLEY SP),3519,0,3519,2452,143.5,3505
7232,2013,8,SQ (SAN QUENTIN SP),4196,1,4197,3082,136.2,3775
7233,2013,8,"SOL (CA SP, SOLANO)",4028,0,4028,2610,154.3,3940
7234,2013,8,SCC (SIERRA CONSERVATION CENTER),4932,0,4932,3736,132.0,4640
7235,2013,8,SATF (CA SUBSTANCE ABUSE TREAT FAC),5703,0,5703,3424,166.6,5427
7236,2013,8,"SAC (CA SP, SACRAMENTO)",2168,0,2168,1828,118.6,2498
7237,2013,8,RJD (RJ DONOVAN CORRECTIONAL FAC),3280,1,3281,2200,149.1,3280
7238,2013,8,PVSP (PLEASANT VALLEY SP),3243,0,3243,2308,140.5,3533
7239,2013,8,PBSP (PELICAN BAY SP),2694,0,2694,2380,113.2,3188
7240,2013,8,NKSP (NORTH KERN SP),4816,0,4816,2694,178.8,4399
7241,2013,8,MCSP (MULE CREEK SP),2754,0,2754,1700,162.0,2570
7242,2013,8,"LAC (CA SP, LOS ANGELES COUNTY)",3667,0,3667,2300,159.4,3575
7243,2013,8,KVSP (KERN VALLEY SP),3698,0,3698,2448,151.1,3954
7244,2013,8,ISP (IRONWOOD SP),3210,0,3210,2200,145.9,3175
7245,2013,8,HDSP (HIGH DESERT SP),3303,0,3303,2324,142.1,3336
7246,2013,8,FOL (FOLSOM SP) (MALE),2848,0,2848,2066,137.9,2895
7247,2013,8,DVI (DEUEL VOCATIONAL INSTITUTION),2806,1,2807,1681,167.0,2368
7248,2013,8,CVSP (CHUCKAWALLA VALLEY SP),2649,1,2650,1738,152.5,2478
7249,2013,8,CTF (CORRECTIONAL TRAINING FAC),5155,0,5155,3312,155.6,4981
7250,2013,8,"CRC (CAL REHAB CTR, MEN)",3502,1,3503,2491,140.6,3481
7251,2013,8,"COR (CA SP, CORCORAN)",4335,0,4335,3116,139.1,4419
7252,2013,8,CMF (CA MEDICAL FAC),2280,0,2280,2361,96.6,2692
7253,2013,8,CMC (CA MEN'S COLONY),4938,0,4938,3838,128.7,5206
7254,2013,8,CIM (CA INSTITUTION FOR MEN),4746,0,4746,2976,159.5,4615
7255,2013,8,CHCF (CA HEALTH CARE FAC - STOCKTON),432,0,432,1818,23.8,1818
7256,2013,8,CEN (CENTINELA SP),2973,0,2973,2308,128.8,3358
7257,2013,8,CCI (CA CORRECTIONAL INSTITUTION),4705,0,4705,2783,169.1,4427
7258,2013,8,CCC (CA CORRECTIONAL CENTER),5057,1,5058,3883,130.3,4718
7259,2013,8,CAL (CALIPATRIA SP),3647,0,3647,2308,158.0,3608
7260,2013,8,ASP (AVENAL SP),4378,0,4378,2920,149.9,4702
7261,2013,9,FOL (FOLSOM SP) (FEMALE),294,0,294,403,73.0,403
7262,2013,9,CIW (CA INSTITUTION FOR WOMEN),2149,1,2150,1398,153.8,2042
7263,2013,9,CCWF (CENTRAL CA WOMEN'S FAC),3449,0,3449,2004,172.1,3430
7264,2013,9,WSP (WASCO SP),5097,1,5098,2984,170.8,4997
7265,2013,9,VSP (VALLEY SP),3258,0,3258,1980,164.5,2948
7266,2013,9,SVSP (SALINAS VALLEY SP),3522,0,3522,2452,143.6,3505
7267,2013,9,SQ (SAN QUENTIN SP),4244,0,4244,3082,137.7,3775
7268,2013,9,"SOL (CA SP, SOLANO)",3988,0,3988,2610,152.8,3940
7269,2013,9,SCC (SIERRA CONSERVATION CENTER),4944,0,4944,3736,132.3,4640
7270,2013,9,SATF (CA SUBSTANCE ABUSE TREAT FAC),5776,0,5776,3424,168.7,5572
7271,2013,9,"SAC (CA SP, SACRAMENTO)",2092,0,2092,1828,114.4,2434
7272,2013,9,RJD (RJ DONOVAN CORRECTIONAL FAC),3300,1,3301,2200,150.0,3180
7273,2013,9,PVSP (PLEASANT VALLEY SP),3061,0,3061,2308,132.6,3533
7274,2013,9,PBSP (PELICAN BAY SP),2713,0,2713,2380,114.0,3188
7275,2013,9,NKSP (NORTH KERN SP),4770,0,4770,2694,177.1,4399
7276,2013,9,MCSP (MULE CREEK SP),2718,0,2718,1700,159.9,2570
7277,2013,9,"LAC (CA SP, LOS ANGELES COUNTY)",3713,0,3713,2300,161.4,3575
7278,2013,9,KVSP (KERN VALLEY SP),3695,0,3695,2448,150.9,3910
7279,2013,9,ISP (IRONWOOD SP),3254,0,3254,2200,147.9,3175
7280,2013,9,HDSP (HIGH DESERT SP),3326,0,3326,2324,143.1,3336
7281,2013,9,FOL (FOLSOM SP) (MALE),2971,0,2971,2066,143.8,2895
7282,2013,9,DVI (DEUEL VOCATIONAL INSTITUTION),2788,1,2789,1681,165.9,2368
7283,2013,9,CVSP (CHUCKAWALLA VALLEY SP),2654,1,2655,1738,152.8,2478
7284,2013,9,CTF (CORRECTIONAL TRAINING FAC),5185,0,5185,3312,156.6,5231
7285,2013,9,"CRC (CAL REHAB CTR, MEN)",3400,1,3401,2491,136.5,3481
7286,2013,9,"COR (CA SP, CORCORAN)",4365,0,4365,3116,140.1,4419
7287,2013,9,CMF (CA MEDICAL FAC),2243,0,2243,2361,95.0,2692
7288,2013,9,CMC (CA MEN'S COLONY),5032,0,5032,3838,131.1,5206
7289,2013,9,CIM (CA INSTITUTION FOR MEN),4777,0,4777,2976,160.5,4615
7290,2013,9,CHCF (CA HEALTH CARE FAC - STOCKTON),646,0,646,1818,35.5,1818
7291,2013,9,CEN (CENTINELA SP),3036,0,3036,2308,131.5,3358
7292,2013,9,CCI (CA CORRECTIONAL INSTITUTION),4725,0,4725,2783,169.8,4427
7293,2013,9,CCC (CA CORRECTIONAL CENTER),5036,1,5037,3883,129.7,4870
7294,2013,9,CAL (CALIPATRIA SP),3687,0,3687,2308,159.7,3608
7295,2013,9,ASP (AVENAL SP),4318,1,4319,2920,147.9,4702
7296,2013,10,FOL (FOLSOM SP) (FEMALE),326,0,326,403,80.9,403
7297,2013,10,CIW (CA INSTITUTION FOR WOMEN),2154,1,2155,1398,154.1,2042
7298,2013,10,CCWF (CENTRAL CA WOMEN'S FAC),3479,0,3479,2004,173.6,3430
7299,2013,10,WSP (WASCO SP),4998,0,4998,2984,167.5,4997
7300,2013,10,VSP (VALLEY SP),3290,0,3290,1980,166.2,3389
7301,2013,10,SVSP (SALINAS VALLEY SP),3483,0,3483,2452,142.0,3497
7302,2013,10,SQ (SAN QUENTIN SP),4226,0,4226,3082,137.1,3775
7303,2013,10,"SOL (CA SP, SOLANO)",4054,0,4054,2610,155.3,3890
7304,2013,10,SCC (SIERRA CONSERVATION CENTER),4950,0,4950,3736,132.5,4640
7305,2013,10,SATF (CA SUBSTANCE ABUSE TREAT FAC),5595,0,5595,3424,163.4,5655
7306,2013,10,"SAC (CA SP, SACRAMENTO)",2122,0,2122,1828,116.1,2434
7307,2013,10,RJD (RJ DONOVAN CORRECTIONAL FAC),3314,1,3315,2200,150.7,3180
7308,2013,10,PVSP (PLEASANT VALLEY SP),3199,0,3199,2308,138.6,3533
7309,2013,10,PBSP (PELICAN BAY SP),2676,0,2676,2380,112.4,3007
7310,2013,10,NKSP (NORTH KERN SP),4759,0,4759,2694,176.7,4399
7311,2013,10,MCSP (MULE CREEK SP),2763,0,2763,1700,162.5,2570
7312,2013,10,"LAC (CA SP, LOS ANGELES COUNTY)",3777,0,3777,2300,164.2,3575
7313,2013,10,KVSP (KERN VALLEY SP),3723,0,3723,2448,152.1,3910
7314,2013,10,ISP (IRONWOOD SP),3309,0,3309,2200,150.4,3175
7315,2013,10,HDSP (HIGH DESERT SP),3399,0,3399,2324,146.3,3336
7316,2013,10,FOL (FOLSOM SP) (MALE),2988,0,2988,2066,144.6,2895
7317,2013,10,DVI (DEUEL VOCATIONAL INSTITUTION),2650,1,2651,1681,157.7,2368
7318,2013,10,CVSP (CHUCKAWALLA VALLEY SP),2567,0,2567,1738,147.7,2478
7319,2013,10,CTF (CORRECTIONAL TRAINING FAC),5181,0,5181,3312,156.4,5231
7320,2013,10,"CRC (CAL REHAB CTR, MEN)",3457,1,3458,2491,138.8,3481
7321,2013,10,"COR (CA SP, CORCORAN)",4396,0,4396,3116,141.1,4419
7322,2013,10,CMF (CA MEDICAL FAC),2135,0,2135,2361,90.4,2692
7323,2013,10,CMC (CA MEN'S COLONY),5022,0,5022,3838,130.8,5206
7324,2013,10,CIM (CA INSTITUTION FOR MEN),4863,0,4863,2976,163.4,4615
7325,2013,10,CHCF (CA HEALTH CARE FAC - STOCKTON),919,0,919,1818,50.6,1818
7326,2013,10,CEN (CENTINELA SP),3097,0,3097,2308,134.2,3308
7327,2013,10,CCI (CA CORRECTIONAL INSTITUTION),4573,0,4573,2783,164.3,4427
7328,2013,10,CCC (CA CORRECTIONAL CENTER),5115,1,5116,3883,131.8,4870
7329,2013,10,CAL (CALIPATRIA SP),3747,0,3747,2308,162.3,3608
7330,2013,10,ASP (AVENAL SP),4294,1,4295,2920,147.1,4702
7331,2013,11,FOL (FOLSOM SP) (FEMALE),327,0,327,403,81.1,403
7332,2013,11,CIW (CA INSTITUTION FOR WOMEN),2156,1,2157,1398,154.3,2042
7333,2013,11,CCWF (CENTRAL CA WOMEN'S FAC),3505,0,3505,2004,174.9,3430
7334,2013,11,WSP (WASCO SP),5045,0,5045,2984,169.1,4997
7335,2013,11,VSP (VALLEY SP),3297,0,3297,1980,166.5,3389
7336,2013,11,SVSP (SALINAS VALLEY SP),3411,0,3411,2452,139.1,3497
7337,2013,11,SQ (SAN QUENTIN SP),4123,0,4123,3082,133.8,3775
7338,2013,11,"SOL (CA SP, SOLANO)",4069,1,4070,2610,155.9,3890
7339,2013,11,SCC (SIERRA CONSERVATION CENTER),4959,0,4959,3736,132.7,4640
7340,2013,11,SATF (CA SUBSTANCE ABUSE TREAT FAC),5500,0,5500,3424,160.6,5578
7341,2013,11,"SAC (CA SP, SACRAMENTO)",2174,0,2174,1828,118.9,2382
7342,2013,11,RJD (RJ DONOVAN CORRECTIONAL FAC),3295,1,3296,2200,149.8,3180
7343,2013,11,PVSP (PLEASANT VALLEY SP),3316,0,3316,2308,143.7,3533
7344,2013,11,PBSP (PELICAN BAY SP),2661,0,2661,2380,111.8,3007
7345,2013,11,NKSP (NORTH KERN SP),4789,0,4789,2694,177.8,4399
7346,2013,11,MCSP (MULE CREEK SP),2794,0,2794,1700,164.4,2570
7347,2013,11,"LAC (CA SP, LOS ANGELES COUNTY)",3719,0,3719,2300,161.7,3575
7348,2013,11,KVSP (KERN VALLEY SP),3741,0,3741,2448,152.8,3910
7349,2013,11,ISP (IRONWOOD SP),3162,0,3162,2200,143.7,3175
7350,2013,11,HDSP (HIGH DESERT SP),3313,0,3313,2324,142.6,3336
7351,2013,11,FOL (FOLSOM SP) (MALE),3025,0,3025,2066,146.4,2895
7352,2013,11,DVI (DEUEL VOCATIONAL INSTITUTION),2523,0,2523,1681,150.1,2557
7353,2013,11,CVSP (CHUCKAWALLA VALLEY SP),2424,0,2424,1738,139.5,2478
7354,2013,11,CTF (CORRECTIONAL TRAINING FAC),5148,0,5148,3312,155.4,5231
7355,2013,11,"CRC (CAL REHAB CTR, MEN)",3361,0,3361,2491,134.9,3481
7356,2013,11,"COR (CA SP, CORCORAN)",4349,0,4349,3116,139.6,4419
7357,2013,11,CMF (CA MEDICAL FAC),2117,0,2117,2361,89.7,2692
7358,2013,11,CMC (CA MEN'S COLONY),5059,0,5059,3838,131.8,5206
7359,2013,11,CIM (CA INSTITUTION FOR MEN),4739,0,4739,2976,159.2,4615
7360,2013,11,CHCF (CA HEALTH CARE FAC - STOCKTON),1009,0,1009,1818,55.5,1818
7361,2013,11,CEN (CENTINELA SP),3081,0,3081,2308,133.5,3308
7362,2013,11,CCI (CA CORRECTIONAL INSTITUTION),4425,0,4425,2783,159.0,4427
7363,2013,11,CCC (CA CORRECTIONAL CENTER),5141,1,5142,3883,132.4,4870
7364,2013,11,CAL (CALIPATRIA SP),3835,0,3835,2308,166.2,3608
7365,2013,11,ASP (AVENAL SP),4128,0,4128,2920,141.4,4702
7366,2013,12,FOL (FOLSOM SP) (FEMALE),341,0,341,403,84.6,403
7367,2013,12,CIW (CA INSTITUTION FOR WOMEN),2148,1,2149,1398,153.7,2042
7368,2013,12,CCWF (CENTRAL CA WOMEN'S FAC),3582,0,3582,2004,178.7,3430
7369,2013,12,WSP (WASCO SP),4979,0,4979,2984,166.9,4997
7370,2013,12,VSP (VALLEY SP),3292,0,3292,1980,166.3,3389
7371,2013,12,SVSP (SALINAS VALLEY SP),3373,0,3373,2452,137.6,3497
7372,2013,12,SQ (SAN QUENTIN SP),4083,0,4083,3082,132.5,3775
7373,2013,12,"SOL (CA SP, SOLANO)",4113,1,4114,2610,157.6,3890
7374,2013,12,SCC (SIERRA CONSERVATION CENTER),4911,0,4911,3736,131.5,4640
7375,2013,12,SATF (CA SUBSTANCE ABUSE TREAT FAC),5503,0,5503,3424,160.7,5578
7376,2013,12,"SAC (CA SP, SACRAMENTO)",2205,0,2205,1828,120.6,2369
7377,2013,12,RJD (RJ DONOVAN CORRECTIONAL FAC),3124,1,3125,2200,142.0,3180
7378,2013,12,PVSP (PLEASANT VALLEY SP),3246,0,3246,2308,140.6,3533
7379,2013,12,PBSP (PELICAN BAY SP),2654,0,2654,2380,111.5,3032
7380,2013,12,NKSP (NORTH KERN SP),4615,0,4615,2694,171.3,4399
7381,2013,12,MCSP (MULE CREEK SP),2859,0,2859,1700,168.2,2570
7382,2013,12,"LAC (CA SP, LOS ANGELES COUNTY)",3697,0,3697,2300,160.7,3700
7383,2013,12,KVSP (KERN VALLEY SP),3746,0,3746,2448,153.0,3910
7384,2013,12,ISP (IRONWOOD SP),3070,0,3070,2200,139.5,3175
7385,2013,12,HDSP (HIGH DESERT SP),3373,0,3373,2324,145.1,3461
7386,2013,12,FOL (FOLSOM SP) (MALE),3069,0,3069,2066,148.5,2895
7387,2013,12,DVI (DEUEL VOCATIONAL INSTITUTION),2365,0,2365,1681,140.7,2412
7388,2013,12,CVSP (CHUCKAWALLA VALLEY SP),2390,0,2390,1738,137.5,2478
7389,2013,12,CTF (CORRECTIONAL TRAINING FAC),5204,0,5204,3312,157.1,5231
7390,2013,12,"CRC (CAL REHAB CTR, MEN)",3271,0,3271,2491,131.3,3481
7391,2013,12,"COR (CA SP, CORCORAN)",4318,0,4318,3116,138.6,4419
7392,2013,12,CMF (CA MEDICAL FAC),2057,0,2057,2361,87.1,2555
7393,2013,12,CMC (CA MEN'S COLONY),4891,0,4891,3838,127.4,5206
7394,2013,12,CIM (CA INSTITUTION FOR MEN),4779,0,4779,2976,160.6,4615
7395,2013,12,CHCF (CA HEALTH CARE FAC - STOCKTON),1202,0,1202,1818,66.1,1818
7396,2013,12,CEN (CENTINELA SP),2965,0,2965,2308,128.5,3308
7397,2013,12,CCI (CA CORRECTIONAL INSTITUTION),4423,0,4423,2783,158.9,4427
7398,2013,12,CCC (CA CORRECTIONAL CENTER),5023,1,5024,3883,129.4,4870
7399,2013,12,CAL (CALIPATRIA SP),3850,0,3850,2308,166.8,3608
7400,2013,12,ASP (AVENAL SP),4073,0,4073,2920,139.5,4702
7401,2014,1,FOL (FOLSOM SP) (FEMALE),352,0,352,403,87.3,403
7402,2014,1,CIW (CA INSTITUTION FOR WOMEN),2138,1,2139,1398,153.0,2074
7403,2014,1,CCWF (CENTRAL CA WOMEN'S FAC),3586,0,3586,2004,178.9,3430
7404,2014,1,WSP (WASCO SP),5090,0,5090,2984,170.6,4997
7405,2014,1,VSP (VALLEY SP),3257,0,3257,1980,164.5,3389
7406,2014,1,SVSP (SALINAS VALLEY SP),3398,0,3398,2452,138.6,3497
7407,2014,1,SQ (SAN QUENTIN SP),4000,0,4000,3082,129.8,3898
7408,2014,1,"SOL (CA SP, SOLANO)",4092,1,4093,2610,156.8,3890
7409,2014,1,SCC (SIERRA CONSERVATION CENTER),4778,0,4778,3736,127.9,4754
7410,2014,1,SATF (CA SUBSTANCE ABUSE TREAT FAC),5448,0,5448,3424,159.1,5374
7411,2014,1,"SAC (CA SP, SACRAMENTO)",2199,0,2199,1828,120.3,2356
7412,2014,1,RJD (RJ DONOVAN CORRECTIONAL FAC),3100,0,3100,2200,140.9,3180
7413,2014,1,PVSP (PLEASANT VALLEY SP),3202,0,3202,2308,138.7,3533
7414,2014,1,PBSP (PELICAN BAY SP),2683,0,2683,2380,112.7,3032
7415,2014,1,NKSP (NORTH KERN SP),4664,0,4664,2694,173.1,4399
7416,2014,1,MCSP (MULE CREEK SP),2852,0,2852,1700,167.8,2570
7417,2014,1,"LAC (CA SP, LOS ANGELES COUNTY)",3706,0,3706,2300,161.1,3700
7418,2014,1,KVSP (KERN VALLEY SP),3679,0,3679,2448,150.3,3910
7419,2014,1,ISP (IRONWOOD SP),3021,0,3021,2200,137.3,3175
7420,2014,1,HDSP (HIGH DESERT SP),3368,0,3368,2324,144.9,3461
7421,2014,1,FOL (FOLSOM SP) (MALE),2958,0,2958,2066,143.2,2895
7422,2014,1,DVI (DEUEL VOCATIONAL INSTITUTION),2370,0,2370,1681,141.0,2585
7423,2014,1,CVSP (CHUCKAWALLA VALLEY SP),2356,0,2356,1738,135.6,2478
7424,2014,1,CTF (CORRECTIONAL TRAINING FAC),5055,0,5055,3312,152.6,5231
7425,2014,1,"CRC (CAL REHAB CTR, MEN)",3116,0,3116,2491,125.1,3481
7426,2014,1,"COR (CA SP, CORCORAN)",4371,0,4371,3116,140.3,4419
7427,2014,1,CMF (CA MEDICAL FAC),2054,0,2054,2361,87.0,2508
7428,2014,1,CMC (CA MEN'S COLONY),4774,0,4774,3838,124.4,5023
7429,2014,1,CIM (CA INSTITUTION FOR MEN),4643,0,4643,2976,156.0,4615
7430,2014,1,CHCF (CA HEALTH CARE FAC - STOCKTON),1330,0,1330,1818,73.2,1818
7431,2014,1,CEN (CENTINELA SP),2981,0,2981,2308,129.2,3308
7432,2014,1,CCI (CA CORRECTIONAL INSTITUTION),4422,0,4422,2783,158.9,4427
7433,2014,1,CCC (CA CORRECTIONAL CENTER),5043,1,5044,3883,129.9,5087
7434,2014,1,CAL (CALIPATRIA SP),3900,0,3900,2308,169.0,3833
7435,2014,1,ASP (AVENAL SP),3999,0,3999,2920,137.0,4702
7436,2014,2,FOL (FOLSOM SP) (FEMALE),358,0,358,403,88.8,403
7437,2014,2,CIW (CA INSTITUTION FOR WOMEN),2096,0,2096,1398,149.9,2042
7438,2014,2,CCWF (CENTRAL CA WOMEN'S FAC),3624,0,3624,2004,180.8,3515
7439,2014,2,WSP (WASCO SP),5183,0,5183,2984,173.7,4997
7440,2014,2,VSP (VALLEY SP),3236,0,3236,1980,163.4,3389
7441,2014,2,SVSP (SALINAS VALLEY SP),3320,0,3320,2452,135.4,3497
7442,2014,2,SQ (SAN QUENTIN SP),3955,0,3955,3082,128.3,3898
7443,2014,2,"SOL (CA SP, SOLANO)",4105,1,4106,2610,157.3,3890
7444,2014,2,SCC (SIERRA CONSERVATION CENTER),4743,0,4743,3736,127.0,4574
7445,2014,2,SATF (CA SUBSTANCE ABUSE TREAT FAC),5492,0,5492,3424,160.4,5374
7446,2014,2,"SAC (CA SP, SACRAMENTO)",2208,0,2208,1828,120.8,2312
7447,2014,2,RJD (RJ DONOVAN CORRECTIONAL FAC),3087,0,3087,2200,140.3,3180
7448,2014,2,PVSP (PLEASANT VALLEY SP),3106,0,3106,2308,134.6,3533
7449,2014,2,PBSP (PELICAN BAY SP),2737,0,2737,2380,115.0,3032
7450,2014,2,NKSP (NORTH KERN SP),4705,1,4706,2694,174.7,4399
7451,2014,2,MCSP (MULE CREEK SP),2887,0,2887,1700,169.8,2570
7452,2014,2,"LAC (CA SP, LOS ANGELES COUNTY)",3665,0,3665,2300,159.3,3700
7453,2014,2,KVSP (KERN VALLEY SP),3743,0,3743,2448,152.9,3910
7454,2014,2,ISP (IRONWOOD SP),3082,0,3082,2200,140.1,3175
7455,2014,2,HDSP (HIGH DESERT SP),3421,0,3421,2324,147.2,3461
7456,2014,2,FOL (FOLSOM SP) (MALE),2899,0,2899,2066,140.3,2895
7457,2014,2,DVI (DEUEL VOCATIONAL INSTITUTION),2492,0,2492,1681,148.2,2585
7458,2014,2,CVSP (CHUCKAWALLA VALLEY SP),2298,0,2298,1738,132.2,2478
7459,2014,2,CTF (CORRECTIONAL TRAINING FAC),5082,0,5082,3312,153.4,5231
7460,2014,2,"CRC (CAL REHAB CTR, MEN)",3049,0,3049,2491,122.4,3481
7461,2014,2,"COR (CA SP, CORCORAN)",4360,0,4360,3116,139.9,4320
7462,2014,2,CMF (CA MEDICAL FAC),2057,0,2057,2361,87.1,2522
7463,2014,2,CMC (CA MEN'S COLONY),4641,0,4641,3838,120.9,4933
7464,2014,2,CIM (CA INSTITUTION FOR MEN),4679,0,4679,2976,157.2,4718
7465,2014,2,CHCF (CA HEALTH CARE FAC - STOCKTON),1317,0,1317,1818,72.4,1818
7466,2014,2,CEN (CENTINELA SP),2953,0,2953,2308,127.9,3308
7467,2014,2,CCI (CA CORRECTIONAL INSTITUTION),4384,0,4384,2783,157.5,4427
7468,2014,2,CCC (CA CORRECTIONAL CENTER),4941,1,4942,3883,127.3,4872
7469,2014,2,CAL (CALIPATRIA SP),3859,0,3859,2308,167.2,3833
7470,2014,2,ASP (AVENAL SP),4001,0,4001,2920,137.0,4702
7471,2014,3,FOL (FOLSOM SP) (FEMALE),378,0,378,403,93.8,403
7472,2014,3,CIW (CA INSTITUTION FOR WOMEN),2112,0,2112,1398,151.1,2042
7473,2014,3,CCWF (CENTRAL CA WOMEN'S FAC),3630,0,3630,2004,181.1,3515
7474,2014,3,WSP (WASCO SP),5122,0,5122,2984,171.6,4997
7475,2014,3,VSP (VALLEY SP),3177,0,3177,1980,160.5,3389
7476,2014,3,SVSP (SALINAS VALLEY SP),3347,0,3347,2452,136.5,3497
7477,2014,3,SQ (SAN QUENTIN SP),3932,0,3932,3082,127.6,3898
7478,2014,3,"SOL (CA SP, SOLANO)",4051,1,4052,2610,155.2,3890
7479,2014,3,SCC (SIERRA CONSERVATION CENTER),4577,0,4577,3736,122.5,4674
7480,2014,3,SATF (CA SUBSTANCE ABUSE TREAT FAC),5561,0,5561,3424,162.4,5474
7481,2014,3,"SAC (CA SP, SACRAMENTO)",2188,0,2188,1828,119.7,2312
7482,2014,3,RJD (RJ DONOVAN CORRECTIONAL FAC),3127,0,3127,2200,142.1,3180
7483,2014,3,PVSP (PLEASANT VALLEY SP),3102,0,3102,2308,134.4,3533
7484,2014,3,PBSP (PELICAN BAY SP),2753,0,2753,2380,115.7,3032
7485,2014,3,NKSP (NORTH KERN SP),4683,1,4684,2694,173.9,4399
7486,2014,3,MCSP (MULE CREEK SP),2911,0,2911,1700,171.2,2570
7487,2014,3,"LAC (CA SP, LOS ANGELES COUNTY)",3595,0,3595,2300,156.3,3700
7488,2014,3,KVSP (KERN VALLEY SP),3769,0,3769,2448,154.0,3910
7489,2014,3,ISP (IRONWOOD SP),3014,0,3014,2200,137.0,3175
7490,2014,3,HDSP (HIGH DESERT SP),3386,0,3386,2324,145.7,3461
7491,2014,3,FOL (FOLSOM SP) (MALE),2826,0,2826,2066,136.8,2895
7492,2014,3,DVI (DEUEL VOCATIONAL INSTITUTION),2605,0,2605,1681,155.0,2585
7493,2014,3,CVSP (CHUCKAWALLA VALLEY SP),2290,0,2290,1738,131.8,2478
7494,2014,3,CTF (CORRECTIONAL TRAINING FAC),4947,0,4947,3312,149.4,5231
7495,2014,3,"CRC (CAL REHAB CTR, MEN)",2961,0,2961,2491,118.9,3481
7496,2014,3,"COR (CA SP, CORCORAN)",4292,0,4292,3116,137.7,4453
7497,2014,3,CMF (CA MEDICAL FAC),2061,0,2061,2361,87.3,2522
7498,2014,3,CMC (CA MEN'S COLONY),4472,0,4472,3838,116.5,4753
7499,2014,3,CIM (CA INSTITUTION FOR MEN),4740,0,4740,2976,159.3,4718
7500,2014,3,CHCF (CA HEALTH CARE FAC - STOCKTON),1340,0,1340,1818,73.7,1818
7501,2014,3,CEN (CENTINELA SP),2857,0,2857,2308,123.8,3308
7502,2014,3,CCI (CA CORRECTIONAL INSTITUTION),4346,0,4346,2783,156.2,4414
7503,2014,3,CCC (CA CORRECTIONAL CENTER),5014,1,5015,3883,129.2,4872
7504,2014,3,CAL (CALIPATRIA SP),3856,0,3856,2308,167.1,3833
7505,2014,3,ASP (AVENAL SP),3923,0,3923,2920,134.3,4702
7506,2014,4,FOL (FOLSOM SP) (FEMALE),362,0,362,403,89.8,403
7507,2014,4,CIW (CA INSTITUTION FOR WOMEN),2080,0,2080,1398,148.8,2042
7508,2014,4,CCWF (CENTRAL CA WOMEN'S FAC),3720,0,3720,2004,185.6,3515
7509,2014,4,WSP (WASCO SP),5106,0,5106,2984,171.1,4997
7510,2014,4,VSP (VALLEY SP),3243,0,3243,1980,163.8,3390
7511,2014,4,SVSP (SALINAS VALLEY SP),3346,0,3346,2452,136.5,3684
7512,2014,4,SQ (SAN QUENTIN SP),3864,0,3864,3082,125.4,3898
7513,2014,4,"SOL (CA SP, SOLANO)",4009,1,4010,2610,153.6,3890
7514,2014,4,SCC (SIERRA CONSERVATION CENTER),4581,0,4581,3736,122.6,4674
7515,2014,4,SATF (CA SUBSTANCE ABUSE TREAT FAC),5415,0,5415,3424,158.1,5474
7516,2014,4,"SAC (CA SP, SACRAMENTO)",2254,0,2254,1828,123.3,2312
7517,2014,4,RJD (RJ DONOVAN CORRECTIONAL FAC),3072,0,3072,2200,139.6,3180
7518,2014,4,PVSP (PLEASANT VALLEY SP),3054,0,3054,2308,132.3,3533
7519,2014,4,PBSP (PELICAN BAY SP),2764,0,2764,2380,116.1,3032
7520,2014,4,NKSP (NORTH KERN SP),4538,1,4539,2694,168.5,4529
7521,2014,4,MCSP (MULE CREEK SP),2896,0,2896,1700,170.4,2744
7522,2014,4,"LAC (CA SP, LOS ANGELES COUNTY)",3599,0,3599,2300,156.5,3700
7523,2014,4,KVSP (KERN VALLEY SP),3785,0,3785,2448,154.6,3910
7524,2014,4,ISP (IRONWOOD SP),3009,0,3009,2200,136.8,3175
7525,2014,4,HDSP (HIGH DESERT SP),3329,0,3329,2324,143.2,3461
7526,2014,4,FOL (FOLSOM SP) (MALE),2745,0,2745,2066,132.9,2895
7527,2014,4,DVI (DEUEL VOCATIONAL INSTITUTION),2678,0,2678,1681,159.3,2585
7528,2014,4,CVSP (CHUCKAWALLA VALLEY SP),2325,0,2325,1738,133.8,2478
7529,2014,4,CTF (CORRECTIONAL TRAINING FAC),4862,0,4862,3312,146.8,5231
7530,2014,4,"CRC (CAL REHAB CTR, MEN)",2871,0,2871,2491,115.3,3481
7531,2014,4,"COR (CA SP, CORCORAN)",4331,0,4331,3116,139.0,4453
7532,2014,4,CMF (CA MEDICAL FAC),2021,0,2021,2361,85.6,2522
7533,2014,4,CMC (CA MEN'S COLONY),4358,0,4358,3838,113.5,4693
7534,2014,4,CIM (CA INSTITUTION FOR MEN),4759,0,4759,2976,159.9,4718
7535,2014,4,CHCF (CA HEALTH CARE FAC - STOCKTON),1416,0,1416,2951,48.0,2951
7536,2014,4,CEN (CENTINELA SP),2824,0,2824,2308,122.4,3308
7537,2014,4,CCI (CA CORRECTIONAL INSTITUTION),4397,0,4397,2783,158.0,4414
7538,2014,4,CCC (CA CORRECTIONAL CENTER),5010,1,5011,3883,129.0,4872
7539,2014,4,CAL (CALIPATRIA SP),3881,0,3881,2308,168.2,3833
7540,2014,4,ASP (AVENAL SP),3927,0,3927,2920,134.5,4702
7541,2014,5,FOL (FOLSOM SP) (FEMALE),343,0,343,403,85.1,403
7542,2014,5,CIW (CA INSTITUTION FOR WOMEN),2116,0,2116,1398,151.4,2042
7543,2014,5,CCWF (CENTRAL CA WOMEN'S FAC),3722,0,3722,2004,185.7,3515
7544,2014,5,WSP (WASCO SP),5108,0,5108,2984,171.2,4997
7545,2014,5,VSP (VALLEY SP),3277,0,3277,1980,165.5,3390
7546,2014,5,SVSP (SALINAS VALLEY SP),3349,0,3349,2452,136.6,3709
7547,2014,5,SQ (SAN QUENTIN SP),3879,0,3879,3082,125.9,3898
7548,2014,5,"SOL (CA SP, SOLANO)",4012,1,4013,2610,153.8,3890
7549,2014,5,SCC (SIERRA CONSERVATION CENTER),4630,0,4630,3736,123.9,4674
7550,2014,5,SATF (CA SUBSTANCE ABUSE TREAT FAC),5404,0,5404,3424,157.8,5474
7551,2014,5,"SAC (CA SP, SACRAMENTO)",2260,0,2260,1828,123.6,2312
7552,2014,5,RJD (RJ DONOVAN CORRECTIONAL FAC),3083,0,3083,2200,140.1,3280
7553,2014,5,PVSP (PLEASANT VALLEY SP),3069,0,3069,2308,133.0,3533
7554,2014,5,PBSP (PELICAN BAY SP),2773,0,2773,2380,116.5,3032
7555,2014,5,NKSP (NORTH KERN SP),4598,0,4598,2694,170.7,4529
7556,2014,5,MCSP (MULE CREEK SP),2941,0,2941,1700,173.0,2744
7557,2014,5,"LAC (CA SP, LOS ANGELES COUNTY)",3548,0,3548,2300,154.3,3625
7558,2014,5,KVSP (KERN VALLEY SP),3843,0,3843,2448,157.0,3910
7559,2014,5,ISP (IRONWOOD SP),3048,0,3048,2200,138.5,3175
7560,2014,5,HDSP (HIGH DESERT SP),3300,0,3300,2324,142.0,3461
7561,2014,5,FOL (FOLSOM SP) (MALE),2656,0,2656,2066,128.6,2895
7562,2014,5,DVI (DEUEL VOCATIONAL INSTITUTION),2723,0,2723,1681,162.0,2585
7563,2014,5,CVSP (CHUCKAWALLA VALLEY SP),2417,0,2417,1738,139.1,2478
7564,2014,5,CTF (CORRECTIONAL TRAINING FAC),4960,0,4960,3312,149.8,5231
7565,2014,5,"CRC (CAL REHAB CTR, MEN)",2915,0,2915,2491,117.0,3481
7566,2014,5,"COR (CA SP, CORCORAN)",4340,0,4340,3116,139.3,4453
7567,2014,5,CMF (CA MEDICAL FAC),2071,0,2071,2361,87.7,2522
7568,2014,5,CMC (CA MEN'S COLONY),4347,1,4348,3838,113.3,4659
7569,2014,5,CIM (CA INSTITUTION FOR MEN),4673,0,4673,2976,157.0,4728
7570,2014,5,CHCF (CA HEALTH CARE FAC - STOCKTON),1462,0,1462,2951,49.5,2951
7571,2014,5,CEN (CENTINELA SP),2839,0,2839,2308,123.0,3433
7572,2014,5,CCI (CA CORRECTIONAL INSTITUTION),4431,0,4431,2783,159.2,4414
7573,2014,5,CCC (CA CORRECTIONAL CENTER),4987,1,4988,3883,128.5,4872
7574,2014,5,CAL (CALIPATRIA SP),3897,0,3897,2308,168.8,3833
7575,2014,5,ASP (AVENAL SP),3953,0,3953,2920,135.4,4702
7576,2014,6,FOL (FOLSOM SP) (FEMALE),385,0,385,403,95.5,403
7577,2014,6,CIW (CA INSTITUTION FOR WOMEN),2110,0,2110,1398,150.9,2042
7578,2014,6,CCWF (CENTRAL CA WOMEN'S FAC),3660,0,3660,2004,182.6,3515
7579,2014,6,WSP (WASCO SP),5140,0,5140,2984,172.3,4997
7580,2014,6,VSP (VALLEY SP),3252,0,3252,1980,164.2,3390
7581,2014,6,SVSP (SALINAS VALLEY SP),3368,0,3368,2452,137.4,3699
7582,2014,6,SQ (SAN QUENTIN SP),3927,0,3927,3082,127.4,3898
7583,2014,6,"SOL (CA SP, SOLANO)",3994,1,3995,2610,153.1,3890
7584,2014,6,SCC (SIERRA CONSERVATION CENTER),4672,0,4672,3736,125.1,4674
7585,2014,6,SATF (CA SUBSTANCE ABUSE TREAT FAC),5345,0,5345,3424,156.1,5474
7586,2014,6,"SAC (CA SP, SACRAMENTO)",2254,0,2254,1828,123.3,2312
7587,2014,6,RJD (RJ DONOVAN CORRECTIONAL FAC),3027,0,3027,2200,137.6,3280
7588,2014,6,PVSP (PLEASANT VALLEY SP),3077,0,3077,2308,133.3,3533
7589,2014,6,PBSP (PELICAN BAY SP),2822,0,2822,2380,118.6,3032
7590,2014,6,NKSP (NORTH KERN SP),4574,0,4574,2694,169.8,4529
7591,2014,6,MCSP (MULE CREEK SP),2947,0,2947,1700,173.4,2744
7592,2014,6,"LAC (CA SP, LOS ANGELES COUNTY)",3547,0,3547,2300,154.2,3625
7593,2014,6,KVSP (KERN VALLEY SP),3842,0,3842,2448,156.9,3910
7594,2014,6,ISP (IRONWOOD SP),2888,0,2888,2200,131.3,3175
7595,2014,6,HDSP (HIGH DESERT SP),3301,0,3301,2324,142.0,3461
7596,2014,6,FOL (FOLSOM SP) (MALE),2617,0,2617,2066,126.7,2895
7597,2014,6,DVI (DEUEL VOCATIONAL INSTITUTION),2660,0,2660,1681,158.2,2585
7598,2014,6,CVSP (CHUCKAWALLA VALLEY SP),2365,0,2365,1738,136.1,2478
7599,2014,6,CTF (CORRECTIONAL TRAINING FAC),4967,0,4967,3312,150.0,5231
7600,2014,6,"CRC (CAL REHAB CTR, MEN)",2867,0,2867,2491,115.1,3481
7601,2014,6,"COR (CA SP, CORCORAN)",4285,0,4285,3116,137.5,4445
7602,2014,6,CMF (CA MEDICAL FAC),2090,0,2090,2361,88.5,2522
7603,2014,6,CMC (CA MEN'S COLONY),4274,1,4275,3838,111.4,4659
7604,2014,6,CIM (CA INSTITUTION FOR MEN),4683,0,4683,2976,157.4,4728
7605,2014,6,CHCF (CA HEALTH CARE FAC - STOCKTON),1502,0,1502,2951,50.9,2951
7606,2014,6,CEN (CENTINELA SP),2823,0,2823,2308,122.3,3433
7607,2014,6,CCI (CA CORRECTIONAL INSTITUTION),4366,0,4366,2783,156.9,4412
7608,2014,6,CCC (CA CORRECTIONAL CENTER),4972,1,4973,3883,128.1,4872
7609,2014,6,CAL (CALIPATRIA SP),3856,0,3856,2308,167.1,3833
7610,2014,6,ASP (AVENAL SP),3893,0,3893,2920,133.3,4702
7611,2014,7,FOL (FOLSOM SP) (FEMALE),407,0,407,403,101.0,443
7612,2014,7,CIW (CA INSTITUTION FOR WOMEN),2072,0,2072,1398,148.2,2042
7613,2014,7,CCWF (CENTRAL CA WOMEN'S FAC),3734,0,3734,2004,186.3,3515
7614,2014,7,WSP (WASCO SP),5145,0,5145,2984,172.4,4997
7615,2014,7,VSP (VALLEY SP),3287,0,3287,1980,166.0,3390
7616,2014,7,SVSP (SALINAS VALLEY SP),3378,0,3378,2452,137.8,3699
7617,2014,7,SQ (SAN QUENTIN SP),3867,0,3867,3082,125.5,3898
7618,2014,7,"SOL (CA SP, SOLANO)",3965,1,3966,2610,152.0,3890
7619,2014,7,SCC (SIERRA CONSERVATION CENTER),4641,0,4641,3736,124.2,4674
7620,2014,7,SATF (CA SUBSTANCE ABUSE TREAT FAC),5427,0,5427,3424,158.5,5474
7621,2014,7,"SAC (CA SP, SACRAMENTO)",2234,0,2234,1828,122.2,2312
7622,2014,7,RJD (RJ DONOVAN CORRECTIONAL FAC),3006,0,3006,2200,136.6,3280
7623,2014,7,PVSP (PLEASANT VALLEY SP),3080,0,3080,2308,133.4,3533
7624,2014,7,PBSP (PELICAN BAY SP),2821,0,2821,2380,118.5,3032
7625,2014,7,NKSP (NORTH KERN SP),4634,0,4634,2694,172.0,4529
7626,2014,7,MCSP (MULE CREEK SP),2946,0,2946,1700,173.3,2744
7627,2014,7,"LAC (CA SP, LOS ANGELES COUNTY)",3605,0,3605,2300,156.7,3625
7628,2014,7,KVSP (KERN VALLEY SP),3842,0,3842,2448,156.9,3910
7629,2014,7,ISP (IRONWOOD SP),2935,0,2935,2200,133.4,3175
7630,2014,7,HDSP (HIGH DESERT SP),3362,0,3362,2324,144.7,3461
7631,2014,7,FOL (FOLSOM SP) (MALE),2575,0,2575,2066,124.6,2895
7632,2014,7,DVI (DEUEL VOCATIONAL INSTITUTION),2567,0,2567,1681,152.7,2585
7633,2014,7,CVSP (CHUCKAWALLA VALLEY SP),2296,0,2296,1738,132.1,2478
7634,2014,7,CTF (CORRECTIONAL TRAINING FAC),5051,0,5051,3312,152.5,5231
7635,2014,7,"CRC (CAL REHAB CTR, MEN)",2785,0,2785,2491,111.8,3481
7636,2014,7,"COR (CA SP, CORCORAN)",4317,0,4317,3116,138.5,4445
7637,2014,7,CMF (CA MEDICAL FAC),2070,0,2070,2361,87.7,2522
7638,2014,7,CMC (CA MEN'S COLONY),4276,1,4277,3838,111.4,4659
7639,2014,7,CIM (CA INSTITUTION FOR MEN),4728,0,4728,2976,158.9,4728
7640,2014,7,CHCF (CA HEALTH CARE FAC - STOCKTON),1577,0,1577,2951,53.4,2951
7641,2014,7,CEN (CENTINELA SP),2777,0,2777,2308,120.3,3433
7642,2014,7,CCI (CA CORRECTIONAL INSTITUTION),4431,0,4431,2783,159.2,4412
7643,2014,7,CCC (CA CORRECTIONAL CENTER),4923,1,4924,3883,126.8,4872
7644,2014,7,CAL (CALIPATRIA SP),3851,0,3851,2308,166.9,3833
7645,2014,7,ASP (AVENAL SP),3647,0,3647,2920,124.9,4702
7646,2014,8,FOL (FOLSOM SP) (FEMALE),431,0,431,403,106.9,443
7647,2014,8,CIW (CA INSTITUTION FOR WOMEN),1921,0,1921,1398,137.4,2042
7648,2014,8,CCWF (CENTRAL CA WOMEN'S FAC),3645,0,3645,2004,181.9,3515
7649,2014,8,WSP (WASCO SP),5274,0,5274,2984,176.7,4997
7650,2014,8,VSP (VALLEY SP),3292,0,3292,1980,166.3,3390
7651,2014,8,SVSP (SALINAS VALLEY SP),3451,0,3451,2452,140.7,3699
7652,2014,8,SQ (SAN QUENTIN SP),3862,0,3862,3082,125.3,4006
7653,2014,8,"SOL (CA SP, SOLANO)",3943,1,3944,2610,151.1,3890
7654,2014,8,SCC (SIERRA CONSERVATION CENTER),4612,0,4612,3736,123.4,4674
7655,2014,8,SATF (CA SUBSTANCE ABUSE TREAT FAC),5373,0,5373,3424,156.9,5474
7656,2014,8,"SAC (CA SP, SACRAMENTO)",2213,0,2213,1828,121.1,2312
7657,2014,8,RJD (RJ DONOVAN CORRECTIONAL FAC),2996,0,2996,2200,136.2,3280
7658,2014,8,PVSP (PLEASANT VALLEY SP),3034,0,3034,2308,131.5,3533
7659,2014,8,PBSP (PELICAN BAY SP),2862,0,2862,2380,120.3,3032
7660,2014,8,NKSP (NORTH KERN SP),4614,0,4614,2694,171.3,4529
7661,2014,8,MCSP (MULE CREEK SP),2933,0,2933,1700,172.5,2744
7662,2014,8,"LAC (CA SP, LOS ANGELES COUNTY)",3587,0,3587,2300,156.0,3625
7663,2014,8,KVSP (KERN VALLEY SP),3808,0,3808,2448,155.6,3910
7664,2014,8,ISP (IRONWOOD SP),3074,0,3074,2200,139.7,3175
7665,2014,8,HDSP (HIGH DESERT SP),3431,0,3431,2324,147.6,3461
7666,2014,8,FOL (FOLSOM SP) (MALE),2582,0,2582,2066,125.0,2895
7667,2014,8,DVI (DEUEL VOCATIONAL INSTITUTION),2530,0,2530,1681,150.5,2585
7668,2014,8,CVSP (CHUCKAWALLA VALLEY SP),2224,0,2224,1738,128.0,2478
7669,2014,8,CTF (CORRECTIONAL TRAINING FAC),5015,0,5015,3312,151.4,5231
7670,2014,8,"CRC (CAL REHAB CTR, MEN)",2723,0,2723,2491,109.3,3481
7671,2014,8,"COR (CA SP, CORCORAN)",4302,0,4302,3116,138.1,4445
7672,2014,8,CMF (CA MEDICAL FAC),2066,0,2066,2361,87.5,2606
7673,2014,8,CMC (CA MEN'S COLONY),4207,1,4208,3838,109.6,4659
7674,2014,8,CIM (CA INSTITUTION FOR MEN),4634,0,4634,2976,155.7,4728
7675,2014,8,CHCF (CA HEALTH CARE FAC - STOCKTON),1749,0,1749,2951,59.3,2951
7676,2014,8,CEN (CENTINELA SP),2810,0,2810,2308,121.8,3433
7677,2014,8,CCI (CA CORRECTIONAL INSTITUTION),4468,0,4468,2783,160.5,4412
7678,2014,8,CCC (CA CORRECTIONAL CENTER),4882,1,4883,3883,125.8,4872
7679,2014,8,CAL (CALIPATRIA SP),3836,0,3836,2308,166.2,3833
7680,2014,8,ASP (AVENAL SP),3897,0,3897,2920,133.5,4702
7681,2014,9,FOL (FOLSOM SP) (FEMALE),440,0,440,403,109.2,483
7682,2014,9,CIW (CA INSTITUTION FOR WOMEN),1837,0,1837,1398,131.4,2042
7683,2014,9,CCWF (CENTRAL CA WOMEN'S FAC),3667,0,3667,2004,183.0,3515
7684,2014,9,WSP (WASCO SP),5296,0,5296,2984,177.5,4997
7685,2014,9,VSP (VALLEY SP),3257,0,3257,1980,164.5,3390
7686,2014,9,SVSP (SALINAS VALLEY SP),3483,0,3483,2452,142.0,3757
7687,2014,9,SQ (SAN QUENTIN SP),3901,0,3901,3082,126.6,4006
7688,2014,9,"SOL (CA SP, SOLANO)",3925,1,3926,2610,150.4,3890
7689,2014,9,SCC (SIERRA CONSERVATION CENTER),4524,0,4524,3736,121.1,4674
7690,2014,9,SATF (CA SUBSTANCE ABUSE TREAT FAC),5374,0,5374,3424,157.0,5474
7691,2014,9,"SAC (CA SP, SACRAMENTO)",2213,0,2213,1828,121.1,2312
7692,2014,9,RJD (RJ DONOVAN CORRECTIONAL FAC),3004,0,3004,2200,136.5,3280
7693,2014,9,PVSP (PLEASANT VALLEY SP),3068,0,3068,2308,132.9,3533
7694,2014,9,PBSP (PELICAN BAY SP),2826,0,2826,2380,118.7,3032
7695,2014,9,NKSP (NORTH KERN SP),4690,0,4690,2694,174.1,4529
7696,2014,9,MCSP (MULE CREEK SP),2924,0,2924,1700,172.0,2744
7697,2014,9,"LAC (CA SP, LOS ANGELES COUNTY)",3571,0,3571,2300,155.3,3625
7698,2014,9,KVSP (KERN VALLEY SP),3839,0,3839,2448,156.8,3910
7699,2014,9,ISP (IRONWOOD SP),3011,0,3011,2200,136.9,3175
7700,2014,9,HDSP (HIGH DESERT SP),3483,0,3483,2324,149.9,3461
7701,2014,9,FOL (FOLSOM SP) (MALE),2597,0,2597,2066,125.7,2895
7702,2014,9,DVI (DEUEL VOCATIONAL INSTITUTION),2563,0,2563,1681,152.5,2585
7703,2014,9,CVSP (CHUCKAWALLA VALLEY SP),2207,0,2207,1738,127.0,2478
7704,2014,9,CTF (CORRECTIONAL TRAINING FAC),4926,0,4926,3312,148.7,5231
7705,2014,9,"CRC (CAL REHAB CTR, MEN)",2653,0,2653,2491,106.5,3481
7706,2014,9,"COR (CA SP, CORCORAN)",4372,0,4372,3116,140.3,4445
7707,2014,9,CMF (CA MEDICAL FAC),2062,0,2062,2361,87.3,2606
7708,2014,9,CMC (CA MEN'S COLONY),4208,1,4209,3838,109.7,4659
7709,2014,9,CIM (CA INSTITUTION FOR MEN),4565,0,4565,2976,153.4,4728
7710,2014,9,CHCF (CA HEALTH CARE FAC - STOCKTON),1898,0,1898,2951,64.3,2951
7711,2014,9,CEN (CENTINELA SP),2819,0,2819,2308,122.1,3433
7712,2014,9,CCI (CA CORRECTIONAL INSTITUTION),4464,0,4464,2783,160.4,4412
7713,2014,9,CCC (CA CORRECTIONAL CENTER),4886,1,4887,3883,125.9,4872
7714,2014,9,CAL (CALIPATRIA SP),3883,0,3883,2308,168.2,3833
7715,2014,9,ASP (AVENAL SP),4193,0,4193,2920,143.6,4702
7716,2014,10,FOL (FOLSOM SP) (FEMALE),484,0,484,403,120.1,483
7717,2014,10,CIW (CA INSTITUTION FOR WOMEN),1800,0,1800,1398,128.8,2042
7718,2014,10,CCWF (CENTRAL CA WOMEN'S FAC),3659,0,3659,2004,182.6,3515
7719,2014,10,WSP (WASCO SP),5217,0,5217,2984,174.8,4997
7720,2014,10,VSP (VALLEY SP),3246,0,3246,1980,163.9,3390
7721,2014,10,SVSP (SALINAS VALLEY SP),3476,0,3476,2452,141.8,3757
7722,2014,10,SQ (SAN QUENTIN SP),3943,0,3943,3082,127.9,4006
7723,2014,10,"SOL (CA SP, SOLANO)",3979,1,3980,2610,152.5,3890
7724,2014,10,SCC (SIERRA CONSERVATION CENTER),4610,0,4610,3736,123.4,4674
7725,2014,10,SATF (CA SUBSTANCE ABUSE TREAT FAC),5398,0,5398,3424,157.7,5474
7726,2014,10,"SAC (CA SP, SACRAMENTO)",2173,0,2173,1828,118.9,2312
7727,2014,10,RJD (RJ DONOVAN CORRECTIONAL FAC),3094,0,3094,2200,140.6,3280
7728,2014,10,PVSP (PLEASANT VALLEY SP),3145,0,3145,2308,136.3,3533
7729,2014,10,PBSP (PELICAN BAY SP),2783,0,2783,2380,116.9,3032
7730,2014,10,NKSP (NORTH KERN SP),4506,0,4506,2694,167.3,4529
7731,2014,10,MCSP (MULE CREEK SP),2884,0,2884,1700,169.6,2807
7732,2014,10,"LAC (CA SP, LOS ANGELES COUNTY)",3533,0,3533,2300,153.6,3600
7733,2014,10,KVSP (KERN VALLEY SP),3828,0,3828,2448,156.4,3910
7734,2014,10,ISP (IRONWOOD SP),3043,0,3043,2200,138.3,3175
7735,2014,10,HDSP (HIGH DESERT SP),3520,0,3520,2324,151.5,3461
7736,2014,10,FOL (FOLSOM SP) (MALE),2603,0,2603,2066,126.0,2895
7737,2014,10,DVI (DEUEL VOCATIONAL INSTITUTION),2529,0,2529,1681,150.4,2586
7738,2014,10,CVSP (CHUCKAWALLA VALLEY SP),2334,0,2334,1738,134.3,2641
7739,2014,10,CTF (CORRECTIONAL TRAINING FAC),4936,0,4936,3312,149.0,5231
7740,2014,10,"CRC (CAL REHAB CTR, MEN)",2676,0,2676,2491,107.4,3487
7741,2014,10,"COR (CA SP, CORCORAN)",4368,0,4368,3116,140.2,4445
7742,2014,10,CMF (CA MEDICAL FAC),2125,0,2125,2361,90.0,2606
7743,2014,10,CMC (CA MEN'S COLONY),4299,1,4300,3838,112.0,4668
7744,2014,10,CIM (CA INSTITUTION FOR MEN),4439,0,4439,2976,149.2,4728
7745,2014,10,CHCF (CA HEALTH CARE FAC - STOCKTON),1916,0,1916,2951,64.9,2951
7746,2014,10,CEN (CENTINELA SP),2771,0,2771,2308,120.1,3433
7747,2014,10,CCI (CA CORRECTIONAL INSTITUTION),4384,0,4384,2783,157.5,4414
7748,2014,10,CCC (CA CORRECTIONAL CENTER),4794,1,4795,3883,123.5,4872
7749,2014,10,CAL (CALIPATRIA SP),3864,0,3864,2308,167.4,3833
7750,2014,10,ASP (AVENAL SP),4343,0,4343,2920,148.7,4702
7751,2014,11,FOL (FOLSOM SP) (FEMALE),486,0,486,403,120.6,483
7752,2014,11,CIW (CA INSTITUTION FOR WOMEN),1770,0,1770,1398,126.6,2042
7753,2014,11,CCWF (CENTRAL CA WOMEN'S FAC),3617,0,3617,2004,180.5,3515
7754,2014,11,WSP (WASCO SP),5062,0,5062,2984,169.6,4997
7755,2014,11,VSP (VALLEY SP),3223,0,3223,1980,162.8,3390
7756,2014,11,SVSP (SALINAS VALLEY SP),3545,0,3545,2452,144.6,3657
7757,2014,11,SQ (SAN QUENTIN SP),3873,0,3873,3082,125.7,4006
7758,2014,11,"SOL (CA SP, SOLANO)",3967,1,3968,2610,152.0,3890
7759,2014,11,SCC (SIERRA CONSERVATION CENTER),4629,0,4629,3736,123.9,4674
7760,2014,11,SATF (CA SUBSTANCE ABUSE TREAT FAC),5390,0,5390,3424,157.4,5474
7761,2014,11,"SAC (CA SP, SACRAMENTO)",2225,0,2225,1828,121.7,2312
7762,2014,11,RJD (RJ DONOVAN CORRECTIONAL FAC),3128,0,3128,2200,142.2,3280
7763,2014,11,PVSP (PLEASANT VALLEY SP),3258,0,3258,2308,141.2,3533
7764,2014,11,PBSP (PELICAN BAY SP),2759,0,2759,2380,115.9,3032
7765,2014,11,NKSP (NORTH KERN SP),4304,0,4304,2694,159.8,4529
7766,2014,11,MCSP (MULE CREEK SP),2861,0,2861,1700,168.3,2807
7767,2014,11,"LAC (CA SP, LOS ANGELES COUNTY)",3540,0,3540,2300,153.9,3600
7768,2014,11,KVSP (KERN VALLEY SP),3791,0,3791,2448,154.9,3910
7769,2014,11,ISP (IRONWOOD SP),3041,0,3041,2200,138.2,3175
7770,2014,11,HDSP (HIGH DESERT SP),3543,0,3543,2324,152.5,3461
7771,2014,11,FOL (FOLSOM SP) (MALE),2544,0,2544,2066,123.1,2895
7772,2014,11,DVI (DEUEL VOCATIONAL INSTITUTION),2676,0,2676,1681,159.2,2586
7773,2014,11,CVSP (CHUCKAWALLA VALLEY SP),2285,0,2285,1738,131.5,2641
7774,2014,11,CTF (CORRECTIONAL TRAINING FAC),4827,0,4827,3312,145.7,5231
7775,2014,11,"CRC (CAL REHAB CTR, MEN)",2661,0,2661,2491,106.8,3487
7776,2014,11,"COR (CA SP, CORCORAN)",4271,0,4271,3116,137.1,4445
7777,2014,11,CMF (CA MEDICAL FAC),2121,0,2121,2361,89.8,2756
7778,2014,11,CMC (CA MEN'S COLONY),4281,1,4282,3838,111.6,4668
7779,2014,11,CIM (CA INSTITUTION FOR MEN),4525,0,4525,2976,152.0,4728
7780,2014,11,CHCF (CA HEALTH CARE FAC - STOCKTON),1962,0,1962,2951,66.5,2951
7781,2014,11,CEN (CENTINELA SP),2960,0,2960,2308,128.2,3433
7782,2014,11,CCI (CA CORRECTIONAL INSTITUTION),4374,0,4374,2783,157.2,4414
7783,2014,11,CCC (CA CORRECTIONAL CENTER),4770,1,4771,3883,122.9,4872
7784,2014,11,CAL (CALIPATRIA SP),3850,0,3850,2308,166.8,3833
7785,2014,11,ASP (AVENAL SP),4291,0,4291,2920,147.0,4702
7786,2014,12,FOL (FOLSOM SP) (FEMALE),508,0,508,403,126.1,483
7787,2014,12,CIW (CA INSTITUTION FOR WOMEN),1872,0,1872,1398,133.9,2042
7788,2014,12,CCWF (CENTRAL CA WOMEN'S FAC),3437,0,3437,2004,171.5,3515
7789,2014,12,WSP (WASCO SP),4790,0,4790,2984,160.5,4997
7790,2014,12,VSP (VALLEY SP),3173,0,3173,1980,160.3,3390
7791,2014,12,SVSP (SALINAS VALLEY SP),3586,0,3586,2452,146.2,3657
7792,2014,12,SQ (SAN QUENTIN SP),3986,0,3986,3082,129.3,4006
7793,2014,12,"SOL (CA SP, SOLANO)",3924,0,3924,2610,150.3,3890
7794,2014,12,SCC (SIERRA CONSERVATION CENTER),4549,0,4549,3736,121.8,4784
7795,2014,12,SATF (CA SUBSTANCE ABUSE TREAT FAC),5406,0,5406,3424,157.9,5474
7796,2014,12,"SAC (CA SP, SACRAMENTO)",2191,0,2191,1828,119.9,2312
7797,2014,12,RJD (RJ DONOVAN CORRECTIONAL FAC),3108,0,3108,2200,141.3,3305
7798,2014,12,PVSP (PLEASANT VALLEY SP),3291,0,3291,2308,142.6,3533
7799,2014,12,PBSP (PELICAN BAY SP),2680,0,2680,2380,112.6,3032
7800,2014,12,NKSP (NORTH KERN SP),4257,0,4257,2694,158.0,4529
7801,2014,12,MCSP (MULE CREEK SP),2840,0,2840,1700,167.1,2807
7802,2014,12,"LAC (CA SP, LOS ANGELES COUNTY)",3510,0,3510,2300,152.6,3600
7803,2014,12,KVSP (KERN VALLEY SP),3798,0,3798,2448,155.1,3910
7804,2014,12,ISP (IRONWOOD SP),3035,0,3035,2200,138.0,3175
7805,2014,12,HDSP (HIGH DESERT SP),3562,0,3562,2324,153.3,3461
7806,2014,12,FOL (FOLSOM SP) (MALE),2557,0,2557,2066,123.8,2895
7807,2014,12,DVI (DEUEL VOCATIONAL INSTITUTION),2455,0,2455,1681,146.0,2586
7808,2014,12,CVSP (CHUCKAWALLA VALLEY SP),2275,0,2275,1738,130.9,2641
7809,2014,12,CTF (CORRECTIONAL TRAINING FAC),4740,0,4740,3312,143.1,5231
7810,2014,12,"CRC (CAL REHAB CTR, MEN)",2564,0,2564,2491,102.9,3487
7811,2014,12,"COR (CA SP, CORCORAN)",4186,0,4186,3116,134.3,4445
7812,2014,12,CMF (CA MEDICAL FAC),2136,0,2136,2361,90.5,2756
7813,2014,12,CMC (CA MEN'S COLONY),4186,1,4187,3838,109.1,4668
7814,2014,12,CIM (CA INSTITUTION FOR MEN),4440,0,4440,2976,149.2,4728
7815,2014,12,CHCF (CA HEALTH CARE FAC - STOCKTON),1976,0,1976,2951,67.0,2951
7816,2014,12,CEN (CENTINELA SP),3099,0,3099,2308,134.3,3433
7817,2014,12,CCI (CA CORRECTIONAL INSTITUTION),4321,0,4321,2783,155.3,4414
7818,2014,12,CCC (CA CORRECTIONAL CENTER),4651,1,4652,3883,119.8,4872
7819,2014,12,CAL (CALIPATRIA SP),3815,0,3815,2308,165.3,3883
7820,2014,12,ASP (AVENAL SP),4165,0,4165,2920,142.6,4702
7821,2015,1,FOL (FOLSOM SP) (FEMALE),496,0,496,403,123.1,483
7822,2015,1,CIW (CA INSTITUTION FOR WOMEN),1836,0,1836,1398,131.3,2042
7823,2015,1,CCWF (CENTRAL CA WOMEN'S FAC),3348,0,3348,2004,167.1,3515
7824,2015,1,WSP (WASCO SP),4859,0,4859,2984,162.8,4997
7825,2015,1,VSP (VALLEY SP),3112,0,3112,1980,157.2,3390
7826,2015,1,SVSP (SALINAS VALLEY SP),3592,0,3592,2452,146.5,3657
7827,2015,1,SQ (SAN QUENTIN SP),4096,0,4096,3082,132.9,4006
7828,2015,1,"SOL (CA SP, SOLANO)",3889,0,3889,2610,149.0,3890
7829,2015,1,SCC (SIERRA CONSERVATION CENTER),4372,0,4372,3736,117.0,4784
7830,2015,1,SATF (CA SUBSTANCE ABUSE TREAT FAC),5370,0,5370,3424,156.8,5474
7831,2015,1,"SAC (CA SP, SACRAMENTO)",2177,0,2177,1828,119.1,2312
7832,2015,1,RJD (RJ DONOVAN CORRECTIONAL FAC),3063,0,3063,2200,139.2,3305
7833,2015,1,PVSP (PLEASANT VALLEY SP),3232,0,3232,2308,140.0,3533
7834,2015,1,PBSP (PELICAN BAY SP),2631,0,2631,2380,110.5,3032
7835,2015,1,NKSP (NORTH KERN SP),4121,0,4121,2694,153.0,4529
7836,2015,1,MCSP (MULE CREEK SP),2838,0,2838,1700,166.9,2807
7837,2015,1,"LAC (CA SP, LOS ANGELES COUNTY)",3512,0,3512,2300,152.7,3600
7838,2015,1,KVSP (KERN VALLEY SP),3774,0,3774,2448,154.2,3910
7839,2015,1,ISP (IRONWOOD SP),3095,0,3095,2200,140.7,3175
7840,2015,1,HDSP (HIGH DESERT SP),3494,0,3494,2324,150.3,3461
7841,2015,1,FOL (FOLSOM SP) (MALE),2499,0,2499,2066,121.0,2895
7842,2015,1,DVI (DEUEL VOCATIONAL INSTITUTION),2372,0,2372,1681,141.1,2586
7843,2015,1,CVSP (CHUCKAWALLA VALLEY SP),2222,0,2222,1738,127.8,2641
7844,2015,1,CTF (CORRECTIONAL TRAINING FAC),4592,0,4592,3312,138.6,5231
7845,2015,1,"CRC (CAL REHAB CTR, MEN)",2473,0,2473,2491,99.3,3487
7846,2015,1,"COR (CA SP, CORCORAN)",4077,0,4077,3116,130.8,4445
7847,2015,1,CMF (CA MEDICAL FAC),2129,0,2129,2361,90.2,2756
7848,2015,1,CMC (CA MEN'S COLONY),4036,1,4037,3838,105.2,4668
7849,2015,1,CIM (CA INSTITUTION FOR MEN),4278,0,4278,2976,143.8,4728
7850,2015,1,CHCF (CA HEALTH CARE FAC - STOCKTON),1951,0,1951,2951,66.1,2951
7851,2015,1,CEN (CENTINELA SP),3215,0,3215,2308,139.3,3433
7852,2015,1,CCI (CA CORRECTIONAL INSTITUTION),4189,0,4189,2783,150.5,4414
7853,2015,1,CCC (CA CORRECTIONAL CENTER),4461,1,4462,3883,114.9,4872
7854,2015,1,CAL (CALIPATRIA SP),3747,0,3747,2308,162.3,3883
7855,2015,1,ASP (AVENAL SP),4064,0,4064,2920,139.2,4702
7856,2015,2,FOL (FOLSOM SP) (FEMALE),502,0,502,403,124.6,483
7857,2015,2,CIW (CA INSTITUTION FOR WOMEN),1811,0,1811,1398,129.5,2042
7858,2015,2,CCWF (CENTRAL CA WOMEN'S FAC),3292,0,3292,2004,164.3,3515
7859,2015,2,WSP (WASCO SP),4966,0,4966,2984,166.4,4997
7860,2015,2,VSP (VALLEY SP),3026,0,3026,1980,152.8,3390
7861,2015,2,SVSP (SALINAS VALLEY SP),3583,0,3583,2452,146.1,3657
7862,2015,2,SQ (SAN QUENTIN SP),3954,0,3954,3082,128.3,4006
7863,2015,2,"SOL (CA SP, SOLANO)",3877,0,3877,2610,148.5,3890
7864,2015,2,SCC (SIERRA CONSERVATION CENTER),4369,0,4369,3736,116.9,4784
7865,2015,2,SATF (CA SUBSTANCE ABUSE TREAT FAC),5401,0,5401,3424,157.7,5474
7866,2015,2,"SAC (CA SP, SACRAMENTO)",2181,0,2181,1828,119.3,2312
7867,2015,2,RJD (RJ DONOVAN CORRECTIONAL FAC),3017,0,3017,2200,137.1,3305
7868,2015,2,PVSP (PLEASANT VALLEY SP),3216,0,3216,2308,139.3,3533
7869,2015,2,PBSP (PELICAN BAY SP),2630,0,2630,2380,110.5,3032
7870,2015,2,NKSP (NORTH KERN SP),4031,0,4031,2694,149.6,4529
7871,2015,2,MCSP (MULE CREEK SP),2843,0,2843,1700,167.2,2807
7872,2015,2,"LAC (CA SP, LOS ANGELES COUNTY)",3481,0,3481,2300,151.3,3600
7873,2015,2,KVSP (KERN VALLEY SP),3707,0,3707,2448,151.4,3910
7874,2015,2,ISP (IRONWOOD SP),3179,0,3179,2200,144.5,3175
7875,2015,2,HDSP (HIGH DESERT SP),3478,0,3478,2324,149.7,3461
7876,2015,2,FOL (FOLSOM SP) (MALE),2447,0,2447,2066,118.4,2895
7877,2015,2,DVI (DEUEL VOCATIONAL INSTITUTION),2400,0,2400,1681,142.8,2586
7878,2015,2,CVSP (CHUCKAWALLA VALLEY SP),2132,0,2132,1738,122.7,2641
7879,2015,2,CTF (CORRECTIONAL TRAINING FAC),4628,0,4628,3312,139.7,5231
7880,2015,2,"CRC (CAL REHAB CTR, MEN)",2483,0,2483,2491,99.7,3487
7881,2015,2,"COR (CA SP, CORCORAN)",4000,0,4000,3116,128.4,4445
7882,2015,2,CMF (CA MEDICAL FAC),2114,0,2114,2361,89.5,2756
7883,2015,2,CMC (CA MEN'S COLONY),3949,1,3950,3838,102.9,4668
7884,2015,2,CIM (CA INSTITUTION FOR MEN),4150,0,4150,2976,139.4,4728
7885,2015,2,CHCF (CA HEALTH CARE FAC - STOCKTON),1943,0,1943,2951,65.8,2951
7886,2015,2,CEN (CENTINELA SP),3255,0,3255,2308,141.0,3433
7887,2015,2,CCI (CA CORRECTIONAL INSTITUTION),4250,0,4250,2783,152.7,4414
7888,2015,2,CCC (CA CORRECTIONAL CENTER),4343,1,4344,3883,111.9,4872
7889,2015,2,CAL (CALIPATRIA SP),3726,0,3726,2308,161.4,3883
7890,2015,2,ASP (AVENAL SP),3992,0,3992,2920,136.7,4702
7891,2015,3,FOL (FOLSOM SP) (FEMALE),504,0,504,403,125.1,483
7892,2015,3,CIW (CA INSTITUTION FOR WOMEN),1771,0,1771,1398,126.7,2042
7893,2015,3,CCWF (CENTRAL CA WOMEN'S FAC),3244,0,3244,2004,161.9,3515
7894,2015,3,WSP (WASCO SP),4958,0,4958,2984,166.2,4997
7895,2015,3,VSP (VALLEY SP),3023,0,3023,1980,152.7,3390
7896,2015,3,SVSP (SALINAS VALLEY SP),3574,0,3574,2452,145.8,3657
7897,2015,3,SQ (SAN QUENTIN SP),3897,0,3897,3082,126.4,4006
7898,2015,3,"SOL (CA SP, SOLANO)",3810,0,3810,2610,146.0,3890
7899,2015,3,SCC (SIERRA CONSERVATION CENTER),4303,0,4303,3736,115.2,4774
7900,2015,3,SATF (CA SUBSTANCE ABUSE TREAT FAC),5416,0,5416,3424,158.2,5474
7901,2015,3,"SAC (CA SP, SACRAMENTO)",2228,0,2228,1828,121.9,2312
7902,2015,3,RJD (RJ DONOVAN CORRECTIONAL FAC),3015,0,3015,2200,137.0,3305
7903,2015,3,PVSP (PLEASANT VALLEY SP),3157,0,3157,2308,136.8,3533
7904,2015,3,PBSP (PELICAN BAY SP),2626,0,2626,2380,110.3,3032
7905,2015,3,NKSP (NORTH KERN SP),4214,0,4214,2694,156.4,4529
7906,2015,3,MCSP (MULE CREEK SP),2835,0,2835,1700,166.8,2807
7907,2015,3,"LAC (CA SP, LOS ANGELES COUNTY)",3486,0,3486,2300,151.6,3600
7908,2015,3,KVSP (KERN VALLEY SP),3732,0,3732,2448,152.5,3910
7909,2015,3,ISP (IRONWOOD SP),3142,0,3142,2200,142.8,3175
7910,2015,3,HDSP (HIGH DESERT SP),3391,0,3391,2324,145.9,3461
7911,2015,3,FOL (FOLSOM SP) (MALE),2414,0,2414,2066,116.8,2895
7912,2015,3,DVI (DEUEL VOCATIONAL INSTITUTION),2354,0,2354,1681,140.0,2586
7913,2015,3,CVSP (CHUCKAWALLA VALLEY SP),2223,0,2223,1738,127.9,2641
7914,2015,3,CTF (CORRECTIONAL TRAINING FAC),4661,0,4661,3312,140.7,5231
7915,2015,3,"CRC (CAL REHAB CTR, MEN)",2455,0,2455,2491,98.6,3487
7916,2015,3,"COR (CA SP, CORCORAN)",4093,0,4093,3116,131.4,4445
7917,2015,3,CMF (CA MEDICAL FAC),2123,0,2123,2361,89.9,2756
7918,2015,3,CMC (CA MEN'S COLONY),3884,1,3885,3838,101.2,4668
7919,2015,3,CIM (CA INSTITUTION FOR MEN),4049,0,4049,2976,136.1,4728
7920,2015,3,CHCF (CA HEALTH CARE FAC - STOCKTON),1945,0,1945,2951,65.9,2951
7921,2015,3,CEN (CENTINELA SP),3321,0,3321,2308,143.9,3433
7922,2015,3,CCI (CA CORRECTIONAL INSTITUTION),4086,0,4086,2783,146.8,4414
7923,2015,3,CCC (CA CORRECTIONAL CENTER),4240,1,4241,3883,109.2,4872
7924,2015,3,CAL (CALIPATRIA SP),3668,0,3668,2308,158.9,3883
7925,2015,3,ASP (AVENAL SP),3853,0,3853,2920,132.0,4702
7926,2015,4,FOL (FOLSOM SP) (FEMALE),512,0,512,403,127.0,483
7927,2015,4,CIW (CA INSTITUTION FOR WOMEN),1811,0,1811,1398,129.5,2042
7928,2015,4,CCWF (CENTRAL CA WOMEN'S FAC),3172,0,3172,2004,158.3,3513
7929,2015,4,WSP (WASCO SP),4934,0,4934,2984,165.3,4997
7930,2015,4,VSP (VALLEY SP),3158,0,3158,1980,159.5,3390
7931,2015,4,SVSP (SALINAS VALLEY SP),3670,0,3670,2452,149.7,3657
7932,2015,4,SQ (SAN QUENTIN SP),3898,0,3898,3082,126.5,4006
7933,2015,4,"SOL (CA SP, SOLANO)",3835,0,3835,2610,146.9,3890
7934,2015,4,SCC (SIERRA CONSERVATION CENTER),4270,0,4270,3736,114.3,4774
7935,2015,4,SATF (CA SUBSTANCE ABUSE TREAT FAC),5515,0,5515,3424,161.1,5474
7936,2015,4,"SAC (CA SP, SACRAMENTO)",2225,0,2225,1828,121.7,2312
7937,2015,4,RJD (RJ DONOVAN CORRECTIONAL FAC),3032,0,3032,2200,137.8,3305
7938,2015,4,PVSP (PLEASANT VALLEY SP),2723,0,2723,2308,118.0,3533
7939,2015,4,PBSP (PELICAN BAY SP),2680,0,2680,2380,112.6,3032
7940,2015,4,NKSP (NORTH KERN SP),4356,0,4356,2694,161.7,4529
7941,2015,4,MCSP (MULE CREEK SP),2866,0,2866,1700,168.6,2807
7942,2015,4,"LAC (CA SP, LOS ANGELES COUNTY)",3473,0,3473,2300,151.0,3600
7943,2015,4,KVSP (KERN VALLEY SP),3747,0,3747,2448,153.1,3910
7944,2015,4,ISP (IRONWOOD SP),3107,0,3107,2200,141.2,3175
7945,2015,4,HDSP (HIGH DESERT SP),3319,0,3319,2324,142.8,3461
7946,2015,4,FOL (FOLSOM SP) (MALE),2392,0,2392,2066,115.8,2895
7947,2015,4,DVI (DEUEL VOCATIONAL INSTITUTION),2260,0,2260,1681,134.4,2586
7948,2015,4,CVSP (CHUCKAWALLA VALLEY SP),2233,0,2233,1738,128.5,2641
7949,2015,4,CTF (CORRECTIONAL TRAINING FAC),4893,0,4893,3312,147.7,5231
7950,2015,4,"CRC (CAL REHAB CTR, MEN)",2422,0,2422,2491,97.2,3487
7951,2015,4,"COR (CA SP, CORCORAN)",4324,0,4324,3116,138.8,4445
7952,2015,4,CMF (CA MEDICAL FAC),2151,0,2151,2361,91.1,2756
7953,2015,4,CMC (CA MEN'S COLONY),3885,1,3886,3838,101.3,4668
7954,2015,4,CIM (CA INSTITUTION FOR MEN),4045,0,4045,2976,135.9,4728
7955,2015,4,CHCF (CA HEALTH CARE FAC - STOCKTON),1941,0,1941,2951,65.8,2951
7956,2015,4,CEN (CENTINELA SP),3357,0,3357,2308,145.5,3433
7957,2015,4,CCI (CA CORRECTIONAL INSTITUTION),3838,0,3838,2783,137.9,4414
7958,2015,4,CCC (CA CORRECTIONAL CENTER),4123,1,4124,3883,106.2,4872
7959,2015,4,CAL (CALIPATRIA SP),3653,0,3653,2308,158.3,3883
7960,2015,4,ASP (AVENAL SP),3374,0,3374,2920,115.5,4702
7961,2015,5,FOL (FOLSOM SP) (FEMALE),485,0,485,403,120.3,483
7962,2015,5,CIW (CA INSTITUTION FOR WOMEN),1841,0,1841,1398,131.7,2042
7963,2015,5,CCWF (CENTRAL CA WOMEN'S FAC),3114,0,3114,2004,155.4,3513
7964,2015,5,WSP (WASCO SP),5022,0,5022,2984,168.3,4997
7965,2015,5,VSP (VALLEY SP),3316,0,3316,1980,167.5,3346
7966,2015,5,SVSP (SALINAS VALLEY SP),3723,0,3723,2452,151.8,3657
7967,2015,5,SQ (SAN QUENTIN SP),3787,0,3787,3082,122.9,4006
7968,2015,5,"SOL (CA SP, SOLANO)",3850,0,3850,2610,147.5,3890
7969,2015,5,SCC (SIERRA CONSERVATION CENTER),4247,0,4247,3736,113.7,4774
7970,2015,5,SATF (CA SUBSTANCE ABUSE TREAT FAC),5611,0,5611,3424,163.9,5449
7971,2015,5,"SAC (CA SP, SACRAMENTO)",2266,0,2266,1828,124.0,2312
7972,2015,5,RJD (RJ DONOVAN CORRECTIONAL FAC),3107,0,3107,2200,141.2,3305
7973,2015,5,PVSP (PLEASANT VALLEY SP),2511,0,2511,2308,108.8,3533
7974,2015,5,PBSP (PELICAN BAY SP),2693,0,2693,2380,113.2,3032
7975,2015,5,NKSP (NORTH KERN SP),4247,0,4247,2694,157.6,4529
7976,2015,5,MCSP (MULE CREEK SP),2898,0,2898,1700,170.5,2807
7977,2015,5,"LAC (CA SP, LOS ANGELES COUNTY)",3503,0,3503,2300,152.3,3600
7978,2015,5,KVSP (KERN VALLEY SP),3716,0,3716,2448,151.8,3760
7979,2015,5,ISP (IRONWOOD SP),3127,0,3127,2200,142.1,3175
7980,2015,5,HDSP (HIGH DESERT SP),3307,0,3307,2324,142.3,3461
7981,2015,5,FOL (FOLSOM SP) (MALE),2418,0,2418,2066,117.0,2895
7982,2015,5,DVI (DEUEL VOCATIONAL INSTITUTION),2199,0,2199,1681,130.8,2586
7983,2015,5,CVSP (CHUCKAWALLA VALLEY SP),2273,0,2273,1738,130.8,2641
7984,2015,5,CTF (CORRECTIONAL TRAINING FAC),4977,0,4977,3312,150.3,5231
7985,2015,5,"CRC (CAL REHAB CTR, MEN)",2392,0,2392,2491,96.0,3487
7986,2015,5,"COR (CA SP, CORCORAN)",4341,0,4341,3116,139.3,4445
7987,2015,5,CMF (CA MEDICAL FAC),2197,0,2197,2361,93.1,2756
7988,2015,5,CMC (CA MEN'S COLONY),3889,1,3890,3838,101.4,4668
7989,2015,5,CIM (CA INSTITUTION FOR MEN),3927,0,3927,2976,132.0,4728
7990,2015,5,CHCF (CA HEALTH CARE FAC - STOCKTON),1912,0,1912,2951,64.8,2951
7991,2015,5,CEN (CENTINELA SP),3488,0,3488,2308,151.1,3433
7992,2015,5,CCI (CA CORRECTIONAL INSTITUTION),3818,0,3818,2783,137.2,4414
7993,2015,5,CCC (CA CORRECTIONAL CENTER),4141,1,4142,3883,106.7,4872
7994,2015,5,CAL (CALIPATRIA SP),3728,0,3728,2308,161.5,3883
7995,2015,5,ASP (AVENAL SP),3005,0,3005,2920,102.9,4702
7996,2015,6,FOL (FOLSOM SP) (FEMALE),468,0,468,403,116.1,483
7997,2015,6,CIW (CA INSTITUTION FOR WOMEN),1838,0,1838,1398,131.5,2042
7998,2015,6,CCWF (CENTRAL CA WOMEN'S FAC),3076,0,3076,2004,153.5,3513
7999,2015,6,WSP (WASCO SP),4920,0,4920,2984,164.9,4997
8000,2015,6,VSP (VALLEY SP),3376,0,3376,1980,170.5,3346
8001,2015,6,SVSP (SALINAS VALLEY SP),3677,0,3677,2452,150.0,3657
8002,2015,6,SQ (SAN QUENTIN SP),3705,0,3705,3082,120.2,4006
8003,2015,6,"SOL (CA SP, SOLANO)",3862,0,3862,2610,148.0,3890
8004,2015,6,SCC (SIERRA CONSERVATION CENTER),4325,0,4325,3836,112.7,4774
8005,2015,6,SATF (CA SUBSTANCE ABUSE TREAT FAC),5565,0,5565,3424,162.5,5449
8006,2015,6,"SAC (CA SP, SACRAMENTO)",2302,0,2302,1828,125.9,2312
8007,2015,6,RJD (RJ DONOVAN CORRECTIONAL FAC),3132,0,3132,2200,142.4,3305
8008,2015,6,PVSP (PLEASANT VALLEY SP),2245,0,2245,2308,97.3,3533
8009,2015,6,PBSP (PELICAN BAY SP),2739,0,2739,2380,115.1,3032
8010,2015,6,NKSP (NORTH KERN SP),4384,0,4384,2694,162.7,4529
8011,2015,6,MCSP (MULE CREEK SP),2932,0,2932,1700,172.5,2807
8012,2015,6,"LAC (CA SP, LOS ANGELES COUNTY)",3484,0,3484,2300,151.5,3600
8013,2015,6,KVSP (KERN VALLEY SP),3630,0,3630,2448,148.3,3910
8014,2015,6,ISP (IRONWOOD SP),3419,0,3419,2200,155.4,3175
8015,2015,6,HDSP (HIGH DESERT SP),3311,0,3311,2324,142.5,3461
8016,2015,6,FOL (FOLSOM SP) (MALE),2379,0,2379,2066,115.2,2895
8017,2015,6,DVI (DEUEL VOCATIONAL INSTITUTION),2118,0,2118,1681,126.0,2586
8018,2015,6,CVSP (CHUCKAWALLA VALLEY SP),2269,0,2269,1738,130.6,2641
8019,2015,6,CTF (CORRECTIONAL TRAINING FAC),5132,0,5132,3312,155.0,5231
8020,2015,6,"CRC (CAL REHAB CTR, MEN)",2407,0,2407,2491,96.6,3487
8021,2015,6,"COR (CA SP, CORCORAN)",4409,0,4409,3116,141.5,4445
8022,2015,6,CMF (CA MEDICAL FAC),2261,0,2261,2361,95.8,2756
8023,2015,6,CMC (CA MEN'S COLONY),3791,1,3792,3838,98.8,4668
8024,2015,6,CIM (CA INSTITUTION FOR MEN),3864,0,3864,2976,129.8,4728
8025,2015,6,CHCF (CA HEALTH CARE FAC - STOCKTON),1973,0,1973,2951,66.9,2951
8026,2015,6,CEN (CENTINELA SP),3478,0,3478,2308,150.7,3433
8027,2015,6,CCI (CA CORRECTIONAL INSTITUTION),3971,0,3971,2783,142.7,4414
8028,2015,6,CCC (CA CORRECTIONAL CENTER),4078,1,4079,3883,105.0,4872
8029,2015,6,CAL (CALIPATRIA SP),3763,0,3763,2308,163.0,3883
8030,2015,6,ASP (AVENAL SP),2708,0,2708,2920,92.7,4702
8031,2015,7,FOL (FOLSOM SP) (FEMALE),455,0,455,403,112.9,483
8032,2015,7,CIW (CA INSTITUTION FOR WOMEN),1843,0,1843,1398,131.8,2042
8033,2015,7,CCWF (CENTRAL CA WOMEN'S FAC),3004,0,3004,2004,149.9,3513
8034,2015,7,WSP (WASCO SP),4953,0,4953,2984,166.0,4997
8035,2015,7,VSP (VALLEY SP),3461,0,3461,1980,174.8,3346
8036,2015,7,SVSP (SALINAS VALLEY SP),3718,0,3718,2452,151.6,3657
8037,2015,7,SQ (SAN QUENTIN SP),3626,0,3626,3082,117.7,4006
8038,2015,7,"SOL (CA SP, SOLANO)",3838,0,3838,2610,147.0,3890
8039,2015,7,SCC (SIERRA CONSERVATION CENTER),4364,0,4364,3836,113.8,4774
8040,2015,7,SATF (CA SUBSTANCE ABUSE TREAT FAC),5533,0,5533,3424,161.6,5449
8041,2015,7,"SAC (CA SP, SACRAMENTO)",2317,0,2317,1828,126.8,2312
8042,2015,7,RJD (RJ DONOVAN CORRECTIONAL FAC),3167,0,3167,2200,144.0,3305
8043,2015,7,PVSP (PLEASANT VALLEY SP),2301,0,2301,2308,99.7,3533
8044,2015,7,PBSP (PELICAN BAY SP),2724,0,2724,2380,114.5,3032
8045,2015,7,NKSP (NORTH KERN SP),4479,0,4479,2694,166.3,4529
8046,2015,7,MCSP (MULE CREEK SP),2947,0,2947,1700,173.4,2807
8047,2015,7,"LAC (CA SP, LOS ANGELES COUNTY)",3516,0,3516,2300,152.9,3600
8048,2015,7,KVSP (KERN VALLEY SP),3605,0,3605,2448,147.3,3910
8049,2015,7,ISP (IRONWOOD SP),3671,0,3671,2200,166.9,3175
8050,2015,7,HDSP (HIGH DESERT SP),3385,0,3385,2324,145.7,3461
8051,2015,7,FOL (FOLSOM SP) (MALE),2340,0,2340,2066,113.3,2895
8052,2015,7,DVI (DEUEL VOCATIONAL INSTITUTION),2201,0,2201,1681,130.9,2586
8053,2015,7,CVSP (CHUCKAWALLA VALLEY SP),2246,0,2246,1738,129.2,2641
8054,2015,7,CTF (CORRECTIONAL TRAINING FAC),5154,0,5154,3312,155.6,5231
8055,2015,7,"CRC (CAL REHAB CTR, MEN)",2404,0,2404,2491,96.5,3487
8056,2015,7,"COR (CA SP, CORCORAN)",4406,0,4406,3116,141.4,4445
8057,2015,7,CMF (CA MEDICAL FAC),2394,0,2394,2361,101.4,2756
8058,2015,7,CMC (CA MEN'S COLONY),3749,1,3750,3838,97.7,4668
8059,2015,7,CIM (CA INSTITUTION FOR MEN),3794,0,3794,2976,127.5,4728
8060,2015,7,CHCF (CA HEALTH CARE FAC - STOCKTON),2027,0,2027,2951,68.7,2951
8061,2015,7,CEN (CENTINELA SP),3522,0,3522,2308,152.6,3433
8062,2015,7,CCI (CA CORRECTIONAL INSTITUTION),3928,0,3928,2783,141.1,4414
8063,2015,7,CCC (CA CORRECTIONAL CENTER),3991,1,3992,3883,102.8,4872
8064,2015,7,CAL (CALIPATRIA SP),3796,0,3796,2308,164.5,3883
8065,2015,7,ASP (AVENAL SP),2555,0,2555,2920,87.5,4702
8066,2015,8,FOL (FOLSOM SP) (FEMALE),493,0,493,403,122.3,483
8067,2015,8,CIW (CA INSTITUTION FOR WOMEN),1987,0,1987,1398,142.1,2042
8068,2015,8,CCWF (CENTRAL CA WOMEN'S FAC),2718,0,2718,2004,135.6,3513
8069,2015,8,WSP (WASCO SP),4805,0,4805,2984,161.0,4997
8070,2015,8,VSP (VALLEY SP),3588,0,3588,1980,181.2,3346
8071,2015,8,SVSP (SALINAS VALLEY SP),3681,0,3681,2452,150.1,3657
8072,2015,8,SQ (SAN QUENTIN SP),3687,0,3687,3082,119.6,4006
8073,2015,8,"SOL (CA SP, SOLANO)",3810,0,3810,2610,146.0,3890
8074,2015,8,SCC (SIERRA CONSERVATION CENTER),4395,0,4395,3836,114.6,4774
8075,2015,8,SATF (CA SUBSTANCE ABUSE TREAT FAC),5465,0,5465,3424,159.6,5449
8076,2015,8,"SAC (CA SP, SACRAMENTO)",2264,0,2264,1828,123.9,2312
8077,2015,8,RJD (RJ DONOVAN CORRECTIONAL FAC),3180,0,3180,2200,144.5,3305
8078,2015,8,PVSP (PLEASANT VALLEY SP),2502,0,2502,2308,108.4,3533
8079,2015,8,PBSP (PELICAN BAY SP),2734,0,2734,2380,114.9,3032
8080,2015,8,NKSP (NORTH KERN SP),4379,0,4379,2694,162.5,4529
8081,2015,8,MCSP (MULE CREEK SP),2914,0,2914,1700,171.4,2807
8082,2015,8,"LAC (CA SP, LOS ANGELES COUNTY)",3485,0,3485,2300,151.5,3600
8083,2015,8,KVSP (KERN VALLEY SP),3694,0,3694,2448,150.9,3910
8084,2015,8,ISP (IRONWOOD SP),3649,0,3649,2200,165.9,3175
8085,2015,8,HDSP (HIGH DESERT SP),3277,0,3277,2324,141.0,3461
8086,2015,8,FOL (FOLSOM SP) (MALE),2361,0,2361,2066,114.3,2895
8087,2015,8,DVI (DEUEL VOCATIONAL INSTITUTION),2313,0,2313,1681,137.6,2580
8088,2015,8,CVSP (CHUCKAWALLA VALLEY SP),2068,0,2068,1738,119.0,2641
8089,2015,8,CTF (CORRECTIONAL TRAINING FAC),5085,0,5085,3312,153.5,5231
8090,2015,8,"CRC (CAL REHAB CTR, MEN)",2467,0,2467,2491,99.0,3487
8091,2015,8,"COR (CA SP, CORCORAN)",4344,0,4344,3116,139.4,4445
8092,2015,8,CMF (CA MEDICAL FAC),2519,0,2519,2361,106.7,2756
8093,2015,8,CMC (CA MEN'S COLONY),3690,1,3691,3838,96.2,4668
8094,2015,8,CIM (CA INSTITUTION FOR MEN),3781,0,3781,2976,127.0,4728
8095,2015,8,CHCF (CA HEALTH CARE FAC - STOCKTON),2043,0,2043,2951,69.2,2951
8096,2015,8,CEN (CENTINELA SP),3453,0,3453,2308,149.6,3433
8097,2015,8,CCI (CA CORRECTIONAL INSTITUTION),3891,0,3891,2783,139.8,4414
8098,2015,8,CCC (CA CORRECTIONAL CENTER),3997,1,3998,3883,103.0,4872
8099,2015,8,CAL (CALIPATRIA SP),3799,0,3799,2308,164.6,3883
8100,2015,8,ASP (AVENAL SP),2719,0,2719,2920,93.1,4727
8101,2015,9,FOL (FOLSOM SP) (FEMALE),487,0,487,403,120.8,483
8102,2015,9,CIW (CA INSTITUTION FOR WOMEN),1962,0,1962,1398,140.3,2042
8103,2015,9,CCWF (CENTRAL CA WOMEN'S FAC),2747,0,2747,2004,137.1,3513
8104,2015,9,WSP (WASCO SP),4973,0,4973,2984,166.7,4997
8105,2015,9,VSP (VALLEY SP),3556,0,3556,1980,179.6,3346
8106,2015,9,SVSP (SALINAS VALLEY SP),3704,0,3704,2452,151.1,3657
8107,2015,9,SQ (SAN QUENTIN SP),3347,0,3347,3082,108.6,4006
8108,2015,9,"SOL (CA SP, SOLANO)",3843,0,3843,2610,147.2,3890
8109,2015,9,SCC (SIERRA CONSERVATION CENTER),4354,0,4354,3836,113.5,4774
8110,2015,9,SATF (CA SUBSTANCE ABUSE TREAT FAC),5540,0,5540,3424,161.8,5449
8111,2015,9,"SAC (CA SP, SACRAMENTO)",2224,0,2224,1828,121.7,2312
8112,2015,9,RJD (RJ DONOVAN CORRECTIONAL FAC),3113,0,3113,2200,141.5,3305
8113,2015,9,PVSP (PLEASANT VALLEY SP),2674,0,2674,2308,115.9,3533
8114,2015,9,PBSP (PELICAN BAY SP),2731,0,2731,2380,114.7,3032
8115,2015,9,NKSP (NORTH KERN SP),4444,0,4444,2694,165.0,4529
8116,2015,9,MCSP (MULE CREEK SP),2899,0,2899,1700,170.5,2807
8117,2015,9,"LAC (CA SP, LOS ANGELES COUNTY)",3514,0,3514,2300,152.8,3600
8118,2015,9,KVSP (KERN VALLEY SP),3747,0,3747,2448,153.1,3910
8119,2015,9,ISP (IRONWOOD SP),3605,0,3605,2200,163.9,3175
8120,2015,9,HDSP (HIGH DESERT SP),3352,0,3352,2324,144.2,3461
8121,2015,9,FOL (FOLSOM SP) (MALE),2357,0,2357,2066,114.1,2895
8122,2015,9,DVI (DEUEL VOCATIONAL INSTITUTION),2331,0,2331,1681,138.7,2580
8123,2015,9,CVSP (CHUCKAWALLA VALLEY SP),1826,0,1826,1738,105.1,2641
8124,2015,9,CTF (CORRECTIONAL TRAINING FAC),5124,0,5124,3312,154.7,5231
8125,2015,9,"CRC (CAL REHAB CTR, MEN)",2524,0,2524,2491,101.3,3487
8126,2015,9,"COR (CA SP, CORCORAN)",4408,0,4408,3116,141.5,4445
8127,2015,9,CMF (CA MEDICAL FAC),2584,0,2584,2361,109.4,2756
8128,2015,9,CMC (CA MEN'S COLONY),3850,1,3851,3838,100.3,4668
8129,2015,9,CIM (CA INSTITUTION FOR MEN),3583,0,3583,2976,120.4,4728
8130,2015,9,CHCF (CA HEALTH CARE FAC - STOCKTON),2194,0,2194,2951,74.3,2951
8131,2015,9,CEN (CENTINELA SP),3379,0,3379,2308,146.4,3433
8132,2015,9,CCI (CA CORRECTIONAL INSTITUTION),3847,0,3847,2783,138.2,4414
8133,2015,9,CCC (CA CORRECTIONAL CENTER),3975,0,3975,3883,102.4,4872
8134,2015,9,CAL (CALIPATRIA SP),3855,0,3855,2308,167.0,3883
8135,2015,9,ASP (AVENAL SP),3046,0,3046,2920,104.3,4727
8136,2015,10,FOL (FOLSOM SP) (FEMALE),503,0,503,403,124.8,483
8137,2015,10,CIW (CA INSTITUTION FOR WOMEN),1985,0,1985,1398,142.0,2042
8138,2015,10,CCWF (CENTRAL CA WOMEN'S FAC),2619,0,2619,2004,130.7,3513
8139,2015,10,WSP (WASCO SP),5051,0,5051,2984,169.3,4997
8140,2015,10,VSP (VALLEY SP),3558,0,3558,1980,179.7,3346
8141,2015,10,SVSP (SALINAS VALLEY SP),3765,0,3765,2452,153.5,3657
8142,2015,10,SQ (SAN QUENTIN SP),3398,0,3398,3082,110.3,4006
8143,2015,10,"SOL (CA SP, SOLANO)",3865,0,3865,2610,148.1,3890
8144,2015,10,SCC (SIERRA CONSERVATION CENTER),4431,0,4431,3836,115.5,4774
8145,2015,10,SATF (CA SUBSTANCE ABUSE TREAT FAC),5499,0,5499,3424,160.6,5449
8146,2015,10,"SAC (CA SP, SACRAMENTO)",2193,0,2193,1828,120.0,2312
8147,2015,10,RJD (RJ DONOVAN CORRECTIONAL FAC),3064,0,3064,2200,139.3,3305
8148,2015,10,PVSP (PLEASANT VALLEY SP),2996,0,2996,2308,129.8,3533
8149,2015,10,PBSP (PELICAN BAY SP),2593,0,2593,2380,108.9,3032
8150,2015,10,NKSP (NORTH KERN SP),4109,0,4109,2694,152.5,4529
8151,2015,10,MCSP (MULE CREEK SP),2847,0,2847,1700,167.5,2807
8152,2015,10,"LAC (CA SP, LOS ANGELES COUNTY)",3563,0,3563,2300,154.9,3600
8153,2015,10,KVSP (KERN VALLEY SP),3807,0,3807,2448,155.5,3910
8154,2015,10,ISP (IRONWOOD SP),3585,0,3585,2200,163.0,3175
8155,2015,10,HDSP (HIGH DESERT SP),3430,0,3430,2324,147.6,3461
8156,2015,10,FOL (FOLSOM SP) (MALE),2445,0,2445,2066,118.3,2895
8157,2015,10,DVI (DEUEL VOCATIONAL INSTITUTION),2436,0,2436,1681,144.9,2580
8158,2015,10,CVSP (CHUCKAWALLA VALLEY SP),1850,0,1850,1738,106.4,2056
8159,2015,10,CTF (CORRECTIONAL TRAINING FAC),5046,0,5046,3312,152.4,5231
8160,2015,10,"CRC (CAL REHAB CTR, MEN)",2679,0,2679,2491,107.5,3487
8161,2015,10,"COR (CA SP, CORCORAN)",4403,0,4403,3116,141.3,4445
8162,2015,10,CMF (CA MEDICAL FAC),2558,0,2558,2361,108.3,2756
8163,2015,10,CMC (CA MEN'S COLONY),3936,1,3937,3838,102.6,4668
8164,2015,10,CIM (CA INSTITUTION FOR MEN),3554,0,3554,2976,119.4,4728
8165,2015,10,CHCF (CA HEALTH CARE FAC - STOCKTON),2187,0,2187,2951,74.1,2951
8166,2015,10,CEN (CENTINELA SP),3223,0,3223,2308,139.6,3433
8167,2015,10,CCI (CA CORRECTIONAL INSTITUTION),3782,0,3782,2783,135.9,4414
8168,2015,10,CCC (CA CORRECTIONAL CENTER),3945,1,3946,3883,101.6,4872
8169,2015,10,CAL (CALIPATRIA SP),3897,0,3897,2308,168.8,3883
8170,2015,10,ASP (AVENAL SP),3271,0,3271,2920,112.0,4727
8171,2015,11,FOL (FOLSOM SP) (FEMALE),492,0,492,403,122.1,483
8172,2015,11,CIW (CA INSTITUTION FOR WOMEN),1979,0,1979,1398,141.6,2042
8173,2015,11,CCWF (CENTRAL CA WOMEN'S FAC),2616,0,2616,2004,130.5,3513
8174,2015,11,WSP (WASCO SP),4745,0,4745,2984,159.0,4997
8175,2015,11,VSP (VALLEY SP),3556,0,3556,1980,179.6,3346
8176,2015,11,SVSP (SALINAS VALLEY SP),3693,0,3693,2452,150.6,3657
8177,2015,11,SQ (SAN QUENTIN SP),3506,0,3506,3082,113.8,4006
8178,2015,11,"SOL (CA SP, SOLANO)",3875,0,3875,2610,148.5,3890
8179,2015,11,SCC (SIERRA CONSERVATION CENTER),4415,0,4415,3836,115.1,4774
8180,2015,11,SATF (CA SUBSTANCE ABUSE TREAT FAC),5557,0,5557,3424,162.3,5449
8181,2015,11,"SAC (CA SP, SACRAMENTO)",2245,0,2245,1828,122.8,2312
8182,2015,11,RJD (RJ DONOVAN CORRECTIONAL FAC),3083,0,3083,2200,140.1,3305
8183,2015,11,PVSP (PLEASANT VALLEY SP),3057,0,3057,2308,132.5,3533
8184,2015,11,PBSP (PELICAN BAY SP),2515,0,2515,2380,105.7,3032
8185,2015,11,NKSP (NORTH KERN SP),4027,0,4027,2694,149.5,4529
8186,2015,11,MCSP (MULE CREEK SP),2801,0,2801,1700,164.8,2807
8187,2015,11,"LAC (CA SP, LOS ANGELES COUNTY)",3569,0,3569,2300,155.2,3600
8188,2015,11,KVSP (KERN VALLEY SP),3944,0,3944,2448,161.1,3910
8189,2015,11,ISP (IRONWOOD SP),3590,0,3590,2200,163.2,3175
8190,2015,11,HDSP (HIGH DESERT SP),3482,0,3482,2324,149.8,3461
8191,2015,11,FOL (FOLSOM SP) (MALE),2399,0,2399,2066,116.1,2895
8192,2015,11,DVI (DEUEL VOCATIONAL INSTITUTION),2624,0,2624,1681,156.1,2580
8193,2015,11,CVSP (CHUCKAWALLA VALLEY SP),2076,0,2076,1738,119.4,2641
8194,2015,11,CTF (CORRECTIONAL TRAINING FAC),5093,0,5093,3312,153.8,5231
8195,2015,11,"CRC (CAL REHAB CTR, MEN)",2803,0,2803,2491,112.5,3487
8196,2015,11,"COR (CA SP, CORCORAN)",4300,0,4300,3116,138.0,4445
8197,2015,11,CMF (CA MEDICAL FAC),2514,0,2514,2361,106.5,2756
8198,2015,11,CMC (CA MEN'S COLONY),3954,1,3955,3838,103.0,4668
8199,2015,11,CIM (CA INSTITUTION FOR MEN),3436,0,3436,2976,115.5,4728
8200,2015,11,CHCF (CA HEALTH CARE FAC - STOCKTON),2193,0,2193,2951,74.3,2951
8201,2015,11,CEN (CENTINELA SP),2968,0,2968,2308,128.6,3433
8202,2015,11,CCI (CA CORRECTIONAL INSTITUTION),3741,0,3741,2783,134.4,4414
8203,2015,11,CCC (CA CORRECTIONAL CENTER),3922,0,3922,3883,101.0,4872
8204,2015,11,CAL (CALIPATRIA SP),3910,0,3910,2308,169.4,3883
8205,2015,11,ASP (AVENAL SP),3361,0,3361,2920,115.1,4727
8206,2015,12,FOL (FOLSOM SP) (FEMALE),506,0,506,403,125.6,483
8207,2015,12,CIW (CA INSTITUTION FOR WOMEN),1961,0,1961,1398,140.3,2042
8208,2015,12,CCWF (CENTRAL CA WOMEN'S FAC),2701,0,2701,2004,134.8,3513
8209,2015,12,WSP (WASCO SP),4805,0,4805,2984,161.0,4997
8210,2015,12,VSP (VALLEY SP),3494,0,3494,1980,176.5,3346
8211,2015,12,SVSP (SALINAS VALLEY SP),3662,0,3662,2452,149.3,3657
8212,2015,12,SQ (SAN QUENTIN SP),3717,0,3717,3082,120.6,3956
8213,2015,12,"SOL (CA SP, SOLANO)",3858,0,3858,2610,147.8,3890
8214,2015,12,SCC (SIERRA CONSERVATION CENTER),4377,0,4377,3836,114.1,4774
8215,2015,12,SATF (CA SUBSTANCE ABUSE TREAT FAC),5482,0,5482,3424,160.1,5449
8216,2015,12,"SAC (CA SP, SACRAMENTO)",2264,0,2264,1828,123.9,2312
8217,2015,12,RJD (RJ DONOVAN CORRECTIONAL FAC),3238,0,3238,2200,147.2,3305
8218,2015,12,PVSP (PLEASANT VALLEY SP),3107,0,3107,2308,134.6,3533
8219,2015,12,PBSP (PELICAN BAY SP),2424,0,2424,2380,101.8,3032
8220,2015,12,NKSP (NORTH KERN SP),4053,0,4053,2694,150.4,4529
8221,2015,12,MCSP (MULE CREEK SP),2814,0,2814,1700,165.5,2807
8222,2015,12,"LAC (CA SP, LOS ANGELES COUNTY)",3559,0,3559,2300,154.7,3600
8223,2015,12,KVSP (KERN VALLEY SP),3889,0,3889,2448,158.9,3910
8224,2015,12,ISP (IRONWOOD SP),3557,0,3557,2200,161.7,3175
8225,2015,12,HDSP (HIGH DESERT SP),3574,0,3574,2324,153.8,3461
8226,2015,12,FOL (FOLSOM SP) (MALE),2390,0,2390,2066,115.7,2895
8227,2015,12,DVI (DEUEL VOCATIONAL INSTITUTION),2646,0,2646,1681,157.4,2580
8228,2015,12,CVSP (CHUCKAWALLA VALLEY SP),2222,0,2222,1738,127.8,2641
8229,2015,12,CTF (CORRECTIONAL TRAINING FAC),5134,0,5134,3312,155.0,5231
8230,2015,12,"CRC (CAL REHAB CTR, MEN)",2837,0,2837,2491,113.9,3487
8231,2015,12,"COR (CA SP, CORCORAN)",4191,0,4191,3116,134.5,4445
8232,2015,12,CMF (CA MEDICAL FAC),2517,0,2517,2361,106.6,2756
8233,2015,12,CMC (CA MEN'S COLONY),3975,1,3976,3838,103.6,4668
8234,2015,12,CIM (CA INSTITUTION FOR MEN),3490,0,3490,2976,117.3,4728
8235,2015,12,CHCF (CA HEALTH CARE FAC - STOCKTON),2194,0,2194,2951,74.3,2951
8236,2015,12,CEN (CENTINELA SP),3096,0,3096,2308,134.1,3433
8237,2015,12,CCI (CA CORRECTIONAL INSTITUTION),3664,0,3664,2783,131.7,4414
8238,2015,12,CCC (CA CORRECTIONAL CENTER),3950,0,3950,3883,101.7,4872
8239,2015,12,CAL (CALIPATRIA SP),3833,0,3833,2308,166.1,3883
8240,2015,12,ASP (AVENAL SP),3387,0,3387,2920,116.0,4727
8241,2016,1,FOL (FOLSOM SP) (FEMALE),496,0,496,403,123.1,483
8242,2016,1,CIW (CA INSTITUTION FOR WOMEN),1897,0,1897,1398,135.7,2042
8243,2016,1,CCWF (CENTRAL CA WOMEN'S FAC),2746,0,2746,2004,137.0,3513
8244,2016,1,WSP (WASCO SP),4849,0,4849,2984,162.5,4997
8245,2016,1,VSP (VALLEY SP),3386,0,3386,1980,171.0,3346
8246,2016,1,SVSP (SALINAS VALLEY SP),3663,0,3663,2452,149.4,3657
8247,2016,1,SQ (SAN QUENTIN SP),3780,0,3780,3082,122.6,3956
8248,2016,1,"SOL (CA SP, SOLANO)",3836,0,3836,2610,147.0,3890
8249,2016,1,SCC (SIERRA CONSERVATION CENTER),4329,0,4329,3936,110.0,4774
8250,2016,1,SATF (CA SUBSTANCE ABUSE TREAT FAC),5369,0,5369,3424,156.8,5449
8251,2016,1,"SAC (CA SP, SACRAMENTO)",2280,0,2280,1828,124.7,2312
8252,2016,1,RJD (RJ DONOVAN CORRECTIONAL FAC),3213,0,3213,2200,146.0,3305
8253,2016,1,PVSP (PLEASANT VALLEY SP),3127,0,3127,2308,135.5,3533
8254,2016,1,PBSP (PELICAN BAY SP),2284,0,2284,2380,96.0,3048
8255,2016,1,NKSP (NORTH KERN SP),4141,0,4141,2694,153.7,4529
8256,2016,1,MCSP (MULE CREEK SP),2808,0,2808,1700,165.2,2807
8257,2016,1,"LAC (CA SP, LOS ANGELES COUNTY)",3553,0,3553,2300,154.5,3600
8258,2016,1,KVSP (KERN VALLEY SP),3935,0,3935,2448,160.7,3910
8259,2016,1,ISP (IRONWOOD SP),3471,0,3471,2200,157.8,3200
8260,2016,1,HDSP (HIGH DESERT SP),3553,0,3553,2324,152.9,3461
8261,2016,1,FOL (FOLSOM SP) (MALE),2364,0,2364,2066,114.4,2895
8262,2016,1,DVI (DEUEL VOCATIONAL INSTITUTION),2663,0,2663,1681,158.4,2580
8263,2016,1,CVSP (CHUCKAWALLA VALLEY SP),2353,0,2353,1738,135.4,2641
8264,2016,1,CTF (CORRECTIONAL TRAINING FAC),5071,0,5071,3312,153.1,5231
8265,2016,1,"CRC (CAL REHAB CTR, MEN)",2900,0,2900,2491,116.4,3487
8266,2016,1,"COR (CA SP, CORCORAN)",4122,0,4122,3116,132.3,4445
8267,2016,1,CMF (CA MEDICAL FAC),2523,0,2523,2361,106.9,2756
8268,2016,1,CMC (CA MEN'S COLONY),4060,1,4061,3838,105.8,4668
8269,2016,1,CIM (CA INSTITUTION FOR MEN),3463,0,3463,2976,116.4,4728
8270,2016,1,CHCF (CA HEALTH CARE FAC - STOCKTON),2175,0,2175,2951,73.7,2951
8271,2016,1,CEN (CENTINELA SP),3366,0,3366,2308,145.8,3433
8272,2016,1,CCI (CA CORRECTIONAL INSTITUTION),3564,0,3564,2783,128.1,4414
8273,2016,1,CCC (CA CORRECTIONAL CENTER),3884,0,3884,3883,100.0,4872
8274,2016,1,CAL (CALIPATRIA SP),3815,0,3815,2308,165.3,3883
8275,2016,1,ASP (AVENAL SP),3299,0,3299,2920,113.0,4727
8276,2016,2,FOL (FOLSOM SP) (FEMALE),500,0,500,403,124.1,483
8277,2016,2,CIW (CA INSTITUTION FOR WOMEN),1827,0,1827,1398,130.7,2042
8278,2016,2,CCWF (CENTRAL CA WOMEN'S FAC),2829,0,2829,2004,141.2,3513
8279,2016,2,WSP (WASCO SP),5016,0,5016,2984,168.1,4997
8280,2016,2,VSP (VALLEY SP),3356,0,3356,1980,169.5,3346
8281,2016,2,SVSP (SALINAS VALLEY SP),3642,0,3642,2452,148.5,3657
8282,2016,2,SQ (SAN QUENTIN SP),3854,0,3854,3082,125.0,3956
8283,2016,2,"SOL (CA SP, SOLANO)",3844,0,3844,2610,147.3,3890
8284,2016,2,SCC (SIERRA CONSERVATION CENTER),4337,0,4337,3936,110.2,4774
8285,2016,2,SATF (CA SUBSTANCE ABUSE TREAT FAC),5285,0,5285,3424,154.4,5449
8286,2016,2,"SAC (CA SP, SACRAMENTO)",2313,0,2313,1828,126.5,2312
8287,2016,2,RJD (RJ DONOVAN CORRECTIONAL FAC),3163,0,3163,2200,143.8,3305
8288,2016,2,PVSP (PLEASANT VALLEY SP),3160,0,3160,2308,136.9,3533
8289,2016,2,PBSP (PELICAN BAY SP),2266,0,2266,2380,95.2,3048
8290,2016,2,NKSP (NORTH KERN SP),4132,0,4132,2694,153.4,4529
8291,2016,2,MCSP (MULE CREEK SP),2818,0,2818,2492,113.1,3599
8292,2016,2,"LAC (CA SP, LOS ANGELES COUNTY)",3520,0,3520,2300,153.0,3600
8293,2016,2,KVSP (KERN VALLEY SP),3927,0,3927,2448,160.4,3910
8294,2016,2,ISP (IRONWOOD SP),3377,0,3377,2200,153.5,3200
8295,2016,2,HDSP (HIGH DESERT SP),3623,0,3623,2324,155.9,3461
8296,2016,2,FOL (FOLSOM SP) (MALE),2428,0,2428,2066,117.5,2895
8297,2016,2,DVI (DEUEL VOCATIONAL INSTITUTION),2359,0,2359,1681,140.3,2580
8298,2016,2,CVSP (CHUCKAWALLA VALLEY SP),2409,0,2409,1738,138.6,2641
8299,2016,2,CTF (CORRECTIONAL TRAINING FAC),5029,0,5029,3312,151.8,5231
8300,2016,2,"CRC (CAL REHAB CTR, MEN)",2991,0,2991,2491,120.1,3487
8301,2016,2,"COR (CA SP, CORCORAN)",4131,0,4131,3116,132.6,4445
8302,2016,2,CMF (CA MEDICAL FAC),2533,0,2533,2361,107.3,2756
8303,2016,2,CMC (CA MEN'S COLONY),4064,1,4065,3838,105.9,4668
8304,2016,2,CIM (CA INSTITUTION FOR MEN),3501,0,3501,2976,117.6,4728
8305,2016,2,CHCF (CA HEALTH CARE FAC - STOCKTON),2198,0,2198,2951,74.5,2951
8306,2016,2,CEN (CENTINELA SP),3544,0,3544,2308,153.6,3433
8307,2016,2,CCI (CA CORRECTIONAL INSTITUTION),3421,0,3421,2783,122.9,4414
8308,2016,2,CCC (CA CORRECTIONAL CENTER),3891,0,3891,3883,100.2,4872
8309,2016,2,CAL (CALIPATRIA SP),3775,0,3775,2308,163.6,3883
8310,2016,2,ASP (AVENAL SP),3292,0,3292,2920,112.7,4727
8311,2016,3,FOL (FOLSOM SP) (FEMALE),504,0,504,403,125.1,483
8312,2016,3,CIW (CA INSTITUTION FOR WOMEN),1848,0,1848,1398,132.2,2042
8313,2016,3,CCWF (CENTRAL CA WOMEN'S FAC),2865,0,2865,2004,143.0,3513
8314,2016,3,WSP (WASCO SP),5012,0,5012,2984,168.0,4997
8315,2016,3,VSP (VALLEY SP),3466,0,3466,1980,175.1,3358
8316,2016,3,SVSP (SALINAS VALLEY SP),3681,0,3681,2452,150.1,3657
8317,2016,3,SQ (SAN QUENTIN SP),3986,0,3986,3082,129.3,3956
8318,2016,3,"SOL (CA SP, SOLANO)",3824,0,3824,2610,146.5,3890
8319,2016,3,SCC (SIERRA CONSERVATION CENTER),4384,0,4384,3936,111.4,4774
8320,2016,3,SATF (CA SUBSTANCE ABUSE TREAT FAC),5097,0,5097,3424,148.9,5449
8321,2016,3,"SAC (CA SP, SACRAMENTO)",2405,0,2405,1828,131.6,2312
8322,2016,3,RJD (RJ DONOVAN CORRECTIONAL FAC),3131,0,3131,2200,142.3,3305
8323,2016,3,PVSP (PLEASANT VALLEY SP),3222,0,3222,2308,139.6,3533
8324,2016,3,PBSP (PELICAN BAY SP),2211,0,2211,2380,92.9,3048
8325,2016,3,NKSP (NORTH KERN SP),4353,0,4353,2694,161.6,4529
8326,2016,3,MCSP (MULE CREEK SP),2822,0,2822,3284,85.9,3599
8327,2016,3,"LAC (CA SP, LOS ANGELES COUNTY)",3539,0,3539,2300,153.9,3650
8328,2016,3,KVSP (KERN VALLEY SP),3941,0,3941,2448,161.0,3910
8329,2016,3,ISP (IRONWOOD SP),3498,0,3498,2200,159.0,3200
8330,2016,3,HDSP (HIGH DESERT SP),3646,0,3646,2324,156.9,3461
8331,2016,3,FOL (FOLSOM SP) (MALE),2483,0,2483,2066,120.2,2895
8332,2016,3,DVI (DEUEL VOCATIONAL INSTITUTION),2056,0,2056,1681,122.3,2580
8333,2016,3,CVSP (CHUCKAWALLA VALLEY SP),2406,0,2406,1738,138.4,2641
8334,2016,3,CTF (CORRECTIONAL TRAINING FAC),5114,0,5114,3312,154.4,5231
8335,2016,3,"CRC (CAL REHAB CTR, MEN)",3100,0,3100,2491,124.4,3487
8336,2016,3,"COR (CA SP, CORCORAN)",4073,0,4073,3116,130.7,4445
8337,2016,3,CMF (CA MEDICAL FAC),2595,0,2595,2361,109.9,2756
8338,2016,3,CMC (CA MEN'S COLONY),4094,1,4095,3838,106.7,4668
8339,2016,3,CIM (CA INSTITUTION FOR MEN),3444,0,3444,2976,115.7,4728
8340,2016,3,CHCF (CA HEALTH CARE FAC - STOCKTON),2215,0,2215,2951,75.1,2951
8341,2016,3,CEN (CENTINELA SP),3627,0,3627,2308,157.1,3433
8342,2016,3,CCI (CA CORRECTIONAL INSTITUTION),3276,0,3276,2783,117.7,4414
8343,2016,3,CCC (CA CORRECTIONAL CENTER),3933,0,3933,3883,101.3,4872
8344,2016,3,CAL (CALIPATRIA SP),3695,0,3695,2308,160.1,3883
8345,2016,3,ASP (AVENAL SP),3205,0,3205,2920,109.8,4727
8346,2016,4,FOL (FOLSOM SP) (FEMALE),490,0,490,403,121.6,483
8347,2016,4,CIW (CA INSTITUTION FOR WOMEN),1837,0,1837,1398,131.4,2042
8348,2016,4,CCWF (CENTRAL CA WOMEN'S FAC),2891,0,2891,2004,144.3,3513
8349,2016,4,WSP (WASCO SP),5036,0,5036,2984,168.8,4997
8350,2016,4,VSP (VALLEY SP),3449,0,3449,1980,174.2,3358
8351,2016,4,SVSP (SALINAS VALLEY SP),3593,0,3593,2452,146.5,3657
8352,2016,4,SQ (SAN QUENTIN SP),3926,0,3926,3082,127.4,3956
8353,2016,4,"SOL (CA SP, SOLANO)",3798,0,3798,2610,145.5,3890
8354,2016,4,SCC (SIERRA CONSERVATION CENTER),4325,0,4325,3936,109.9,4774
8355,2016,4,SATF (CA SUBSTANCE ABUSE TREAT FAC),5060,0,5060,3424,147.8,5495
8356,2016,4,"SAC (CA SP, SACRAMENTO)",2404,0,2404,1828,131.5,2312
8357,2016,4,RJD (RJ DONOVAN CORRECTIONAL FAC),3163,0,3163,2200,143.8,3305
8358,2016,4,PVSP (PLEASANT VALLEY SP),3248,0,3248,2308,140.7,3533
8359,2016,4,PBSP (PELICAN BAY SP),2165,0,2165,2380,91.0,3048
8360,2016,4,NKSP (NORTH KERN SP),4408,0,4408,2694,163.6,4529
8361,2016,4,MCSP (MULE CREEK SP),2982,0,2982,3284,90.8,3599
8362,2016,4,"LAC (CA SP, LOS ANGELES COUNTY)",3549,0,3549,2300,154.3,3650
8363,2016,4,KVSP (KERN VALLEY SP),4017,0,4017,2448,164.1,3910
8364,2016,4,ISP (IRONWOOD SP),3379,0,3379,2200,153.6,3200
8365,2016,4,HDSP (HIGH DESERT SP),3664,0,3664,2324,157.7,3461
8366,2016,4,FOL (FOLSOM SP) (MALE),2567,0,2567,2066,124.2,2895
8367,2016,4,DVI (DEUEL VOCATIONAL INSTITUTION),2211,0,2211,1681,131.5,2580
8368,2016,4,CVSP (CHUCKAWALLA VALLEY SP),2435,0,2435,1738,140.1,2641
8369,2016,4,CTF (CORRECTIONAL TRAINING FAC),5222,0,5222,3312,157.7,5231
8370,2016,4,"CRC (CAL REHAB CTR, MEN)",3134,0,3134,2491,125.8,3487
8371,2016,4,"COR (CA SP, CORCORAN)",3870,0,3870,3116,124.2,4445
8372,2016,4,CMF (CA MEDICAL FAC),2605,0,2605,2361,110.3,2756
8373,2016,4,CMC (CA MEN'S COLONY),4128,1,4129,3838,107.6,4668
8374,2016,4,CIM (CA INSTITUTION FOR MEN),3534,0,3534,2976,118.8,4728
8375,2016,4,CHCF (CA HEALTH CARE FAC - STOCKTON),2223,0,2223,2951,75.3,2951
8376,2016,4,CEN (CENTINELA SP),3567,0,3567,2308,154.5,3433
8377,2016,4,CCI (CA CORRECTIONAL INSTITUTION),3202,0,3202,2783,115.1,4414
8378,2016,4,CCC (CA CORRECTIONAL CENTER),3880,0,3880,3883,99.9,4872
8379,2016,4,CAL (CALIPATRIA SP),3680,0,3680,2308,159.4,3883
8380,2016,4,ASP (AVENAL SP),3202,0,3202,2920,109.7,4727
8381,2016,5,FOL (FOLSOM SP) (FEMALE),493,0,493,403,122.3,483
8382,2016,5,CIW (CA INSTITUTION FOR WOMEN),1828,0,1828,1398,130.8,2042
8383,2016,5,CCWF (CENTRAL CA WOMEN'S FAC),2850,0,2850,2004,142.2,3513
8384,2016,5,WSP (WASCO SP),4768,0,4768,2984,159.8,4997
8385,2016,5,VSP (VALLEY SP),3403,0,3403,1980,171.9,3358
8386,2016,5,SVSP (SALINAS VALLEY SP),3740,0,3740,2452,152.5,3657
8387,2016,5,SQ (SAN QUENTIN SP),4031,0,4031,3082,130.8,3956
8388,2016,5,"SOL (CA SP, SOLANO)",3818,0,3818,2610,146.3,3890
8389,2016,5,SCC (SIERRA CONSERVATION CENTER),4344,0,4344,3936,110.4,4774
8390,2016,5,SATF (CA SUBSTANCE ABUSE TREAT FAC),5268,0,5268,3424,153.9,5495
8391,2016,5,"SAC (CA SP, SACRAMENTO)",2387,0,2387,1828,130.6,2312
8392,2016,5,RJD (RJ DONOVAN CORRECTIONAL FAC),3123,0,3123,2200,142.0,3305
8393,2016,5,PVSP (PLEASANT VALLEY SP),3234,0,3234,2308,140.1,3533
8394,2016,5,PBSP (PELICAN BAY SP),2170,0,2170,2380,91.2,3048
8395,2016,5,NKSP (NORTH KERN SP),4410,0,4410,2694,163.7,4529
8396,2016,5,MCSP (MULE CREEK SP),3129,0,3129,3284,95.3,3599
8397,2016,5,"LAC (CA SP, LOS ANGELES COUNTY)",3523,0,3523,2300,153.2,3650
8398,2016,5,KVSP (KERN VALLEY SP),4018,0,4018,2448,164.1,3910
8399,2016,5,ISP (IRONWOOD SP),3274,0,3274,2200,148.8,3200
8400,2016,5,HDSP (HIGH DESERT SP),3696,0,3696,2324,159.0,3461
8401,2016,5,FOL (FOLSOM SP) (MALE),2563,0,2563,2066,124.1,2895
8402,2016,5,DVI (DEUEL VOCATIONAL INSTITUTION),2301,0,2301,1681,136.9,2580
8403,2016,5,CVSP (CHUCKAWALLA VALLEY SP),2397,0,2397,1738,137.9,2641
8404,2016,5,CTF (CORRECTIONAL TRAINING FAC),5098,0,5098,3312,153.9,5231
8405,2016,5,"CRC (CAL REHAB CTR, MEN)",3140,0,3140,2491,126.1,3487
8406,2016,5,"COR (CA SP, CORCORAN)",3747,0,3747,3116,120.3,4445
8407,2016,5,CMF (CA MEDICAL FAC),2576,0,2576,2361,109.1,2774
8408,2016,5,CMC (CA MEN'S COLONY),4122,1,4123,3838,107.4,4668
8409,2016,5,CIM (CA INSTITUTION FOR MEN),3626,0,3626,2976,121.8,4728
8410,2016,5,CHCF (CA HEALTH CARE FAC - STOCKTON),2237,0,2237,2951,75.8,2951
8411,2016,5,CEN (CENTINELA SP),3576,0,3576,2308,154.9,3433
8412,2016,5,CCI (CA CORRECTIONAL INSTITUTION),3108,0,3108,2783,111.7,4414
8413,2016,5,CCC (CA CORRECTIONAL CENTER),3835,0,3835,3883,98.8,4872
8414,2016,5,CAL (CALIPATRIA SP),3778,0,3778,2308,163.7,3883
8415,2016,5,ASP (AVENAL SP),3242,0,3242,2920,111.0,4727
8416,2016,6,FOL (FOLSOM SP) (FEMALE),506,0,506,403,125.6,483
8417,2016,6,CIW (CA INSTITUTION FOR WOMEN),1882,0,1882,1398,134.6,2042
8418,2016,6,CCWF (CENTRAL CA WOMEN'S FAC),2814,0,2814,2004,140.4,3513
8419,2016,6,WSP (WASCO SP),5105,0,5105,2984,171.1,4997
8420,2016,6,VSP (VALLEY SP),3394,0,3394,1980,171.4,3358
8421,2016,6,SVSP (SALINAS VALLEY SP),3711,0,3711,2452,151.3,3657
8422,2016,6,SQ (SAN QUENTIN SP),4108,0,4108,3082,133.3,3956
8423,2016,6,"SOL (CA SP, SOLANO)",3845,0,3845,2610,147.3,3890
8424,2016,6,SCC (SIERRA CONSERVATION CENTER),4344,0,4344,3936,110.4,4774
8425,2016,6,SATF (CA SUBSTANCE ABUSE TREAT FAC),5274,1,5275,3424,154.1,5495
8426,2016,6,"SAC (CA SP, SACRAMENTO)",2387,0,2387,1828,130.6,2312
8427,2016,6,RJD (RJ DONOVAN CORRECTIONAL FAC),3078,0,3078,2200,139.9,3305
8428,2016,6,PVSP (PLEASANT VALLEY SP),3219,0,3219,2308,139.5,3533
8429,2016,6,PBSP (PELICAN BAY SP),2274,0,2274,2380,95.5,3048
8430,2016,6,NKSP (NORTH KERN SP),4235,0,4235,2694,157.2,4529
8431,2016,6,MCSP (MULE CREEK SP),3408,0,3408,3284,103.8,4391
8432,2016,6,"LAC (CA SP, LOS ANGELES COUNTY)",3529,0,3529,2300,153.4,3575
8433,2016,6,KVSP (KERN VALLEY SP),3960,0,3960,2448,161.8,3910
8434,2016,6,ISP (IRONWOOD SP),3246,0,3246,2200,147.5,3200
8435,2016,6,HDSP (HIGH DESERT SP),3701,0,3701,2324,159.3,3461
8436,2016,6,FOL (FOLSOM SP) (MALE),2588,0,2588,2066,125.3,2895
8437,2016,6,DVI (DEUEL VOCATIONAL INSTITUTION),2341,0,2341,1681,139.3,2580
8438,2016,6,CVSP (CHUCKAWALLA VALLEY SP),2349,0,2349,1738,135.2,2641
8439,2016,6,CTF (CORRECTIONAL TRAINING FAC),5042,0,5042,3312,152.2,5231
8440,2016,6,"CRC (CAL REHAB CTR, MEN)",3165,0,3165,2491,127.1,3487
8441,2016,6,"COR (CA SP, CORCORAN)",3607,0,3607,3116,115.8,4445
8442,2016,6,CMF (CA MEDICAL FAC),2588,0,2588,2361,109.6,2774
8443,2016,6,CMC (CA MEN'S COLONY),4117,1,4118,3838,107.3,4668
8444,2016,6,CIM (CA INSTITUTION FOR MEN),3640,0,3640,2976,122.3,4728
8445,2016,6,CHCF (CA HEALTH CARE FAC - STOCKTON),2230,0,2230,2951,75.6,2951
8446,2016,6,CEN (CENTINELA SP),3579,0,3579,2308,155.1,3433
8447,2016,6,CCI (CA CORRECTIONAL INSTITUTION),3150,0,3150,2783,113.2,4410
8448,2016,6,CCC (CA CORRECTIONAL CENTER),3799,0,3799,3883,97.8,4872
8449,2016,6,CAL (CALIPATRIA SP),3777,0,3777,2308,163.6,3883
8450,2016,6,ASP (AVENAL SP),3236,0,3236,2920,110.8,4727
8451,2016,7,FOL (FOLSOM SP) (FEMALE),475,0,475,403,117.9,483
8452,2016,7,CIW (CA INSTITUTION FOR WOMEN),1874,0,1874,1398,134.0,2038
8453,2016,7,CCWF (CENTRAL CA WOMEN'S FAC),2795,0,2795,2004,139.5,3513
8454,2016,7,WSP (WASCO SP),4853,0,4853,2984,162.6,4997
8455,2016,7,VSP (VALLEY SP),3405,0,3405,1980,172.0,3358
8456,2016,7,SVSP (SALINAS VALLEY SP),3759,0,3759,2452,153.3,3657
8457,2016,7,SQ (SAN QUENTIN SP),4106,0,4106,3082,133.2,3956
8458,2016,7,"SOL (CA SP, SOLANO)",3888,0,3888,2610,149.0,3866
8459,2016,7,SCC (SIERRA CONSERVATION CENTER),4277,0,4277,3936,108.7,4774
8460,2016,7,SATF (CA SUBSTANCE ABUSE TREAT FAC),5324,1,5325,3424,155.5,5495
8461,2016,7,"SAC (CA SP, SACRAMENTO)",2349,0,2349,1828,128.5,2312
8462,2016,7,RJD (RJ DONOVAN CORRECTIONAL FAC),3047,0,3047,2200,138.5,3305
8463,2016,7,PVSP (PLEASANT VALLEY SP),3249,0,3249,2308,140.8,3533
8464,2016,7,PBSP (PELICAN BAY SP),2343,0,2343,2380,98.4,3048
8465,2016,7,NKSP (NORTH KERN SP),4086,0,4086,2694,151.7,4529
8466,2016,7,MCSP (MULE CREEK SP),3486,0,3486,3284,106.2,4343
8467,2016,7,"LAC (CA SP, LOS ANGELES COUNTY)",3500,0,3500,2300,152.2,3575
8468,2016,7,KVSP (KERN VALLEY SP),3907,0,3907,2448,159.6,3910
8469,2016,7,ISP (IRONWOOD SP),3178,0,3178,2200,144.5,3200
8470,2016,7,HDSP (HIGH DESERT SP),3746,0,3746,2324,161.2,3461
8471,2016,7,FOL (FOLSOM SP) (MALE),2595,0,2595,2066,125.6,2895
8472,2016,7,DVI (DEUEL VOCATIONAL INSTITUTION),2375,0,2375,1681,141.3,2580
8473,2016,7,CVSP (CHUCKAWALLA VALLEY SP),2335,0,2335,1738,134.3,2641
8474,2016,7,CTF (CORRECTIONAL TRAINING FAC),5076,0,5076,3312,153.3,5231
8475,2016,7,"CRC (CAL REHAB CTR, MEN)",3179,0,3179,2491,127.6,3487
8476,2016,7,"COR (CA SP, CORCORAN)",3379,0,3379,3116,108.4,4483
8477,2016,7,CMF (CA MEDICAL FAC),2586,0,2586,2361,109.5,2774
8478,2016,7,CMC (CA MEN'S COLONY),4142,0,4142,3838,107.9,4660
8479,2016,7,CIM (CA INSTITUTION FOR MEN),3660,0,3660,2976,123.0,4728
8480,2016,7,CHCF (CA HEALTH CARE FAC - STOCKTON),2305,0,2305,2951,78.1,2951
8481,2016,7,CEN (CENTINELA SP),3661,0,3661,2308,158.6,3433
8482,2016,7,CCI (CA CORRECTIONAL INSTITUTION),3300,0,3300,2783,118.6,4406
8483,2016,7,CCC (CA CORRECTIONAL CENTER),3795,0,3795,3883,97.7,4872
8484,2016,7,CAL (CALIPATRIA SP),3772,0,3772,2308,163.4,3883
8485,2016,7,ASP (AVENAL SP),3221,0,3221,2920,110.3,4727
8486,2016,8,FOL (FOLSOM SP) (FEMALE),498,0,498,403,123.6,483
8487,2016,8,CIW (CA INSTITUTION FOR WOMEN),1855,0,1855,1398,132.7,2038
8488,2016,8,CCWF (CENTRAL CA WOMEN'S FAC),2847,0,2847,2004,142.1,3513
8489,2016,8,WSP (WASCO SP),4989,0,4989,2984,167.2,4997
8490,2016,8,VSP (VALLEY SP),3402,0,3402,1980,171.8,3358
8491,2016,8,SVSP (SALINAS VALLEY SP),3751,0,3751,2452,153.0,3657
8492,2016,8,SQ (SAN QUENTIN SP),3892,0,3892,3082,126.3,3956
8493,2016,8,"SOL (CA SP, SOLANO)",3986,0,3986,2610,152.7,3866
8494,2016,8,SCC (SIERRA CONSERVATION CENTER),4201,0,4201,3936,106.7,4774
8495,2016,8,SATF (CA SUBSTANCE ABUSE TREAT FAC),5333,1,5334,3424,155.8,5495
8496,2016,8,"SAC (CA SP, SACRAMENTO)",2311,0,2311,1828,126.4,2312
8497,2016,8,RJD (RJ DONOVAN CORRECTIONAL FAC),3015,0,3015,2200,137.0,3305
8498,2016,8,PVSP (PLEASANT VALLEY SP),3217,0,3217,2308,139.4,3533
8499,2016,8,PBSP (PELICAN BAY SP),2349,0,2349,2380,98.7,2477
8500,2016,8,NKSP (NORTH KERN SP),4412,0,4412,2694,163.8,4529
8501,2016,8,MCSP (MULE CREEK SP),3502,0,3502,3284,106.6,4343
8502,2016,8,"LAC (CA SP, LOS ANGELES COUNTY)",3444,0,3444,2300,149.7,3575
8503,2016,8,KVSP (KERN VALLEY SP),3890,0,3890,2448,158.9,3910
8504,2016,8,ISP (IRONWOOD SP),3161,0,3161,2200,143.7,3200
8505,2016,8,HDSP (HIGH DESERT SP),3814,0,3814,2324,164.1,3461
8506,2016,8,FOL (FOLSOM SP) (MALE),2543,0,2543,2066,123.1,2895
8507,2016,8,DVI (DEUEL VOCATIONAL INSTITUTION),2285,0,2285,1681,135.9,2580
8508,2016,8,CVSP (CHUCKAWALLA VALLEY SP),2346,0,2346,1738,135.0,2478
8509,2016,8,CTF (CORRECTIONAL TRAINING FAC),5170,0,5170,3312,156.1,5231
8510,2016,8,"CRC (CAL REHAB CTR, MEN)",3053,0,3053,2491,122.6,3487
8511,2016,8,"COR (CA SP, CORCORAN)",3275,0,3275,3116,105.1,3746
8512,2016,8,CMF (CA MEDICAL FAC),2548,0,2548,2361,107.9,2774
8513,2016,8,CMC (CA MEN'S COLONY),4107,0,4107,3838,107.0,4660
8514,2016,8,CIM (CA INSTITUTION FOR MEN),3667,0,3667,2976,123.2,4728
8515,2016,8,CHCF (CA HEALTH CARE FAC - STOCKTON),2423,0,2423,2951,82.1,2951
8516,2016,8,CEN (CENTINELA SP),3641,0,3641,2308,157.8,3433
8517,2016,8,CCI (CA CORRECTIONAL INSTITUTION),3430,0,3430,2783,123.2,4406
8518,2016,8,CCC (CA CORRECTIONAL CENTER),3988,0,3988,3883,102.7,4872
8519,2016,8,CAL (CALIPATRIA SP),3776,0,3776,2308,163.6,3883
8520,2016,8,ASP (AVENAL SP),3243,0,3243,2920,111.1,4727
8521,2016,9,FOL (FOLSOM SP) (FEMALE),500,0,500,403,124.1,483
8522,2016,9,CIW (CA INSTITUTION FOR WOMEN),1858,0,1858,1398,132.9,2038
8523,2016,9,CCWF (CENTRAL CA WOMEN'S FAC),2832,0,2832,2004,141.3,3513
8524,2016,9,WSP (WASCO SP),4889,0,4889,2984,163.8,4997
8525,2016,9,VSP (VALLEY SP),3506,0,3506,1980,177.1,3358
8526,2016,9,SVSP (SALINAS VALLEY SP),3742,0,3742,2452,152.6,3657
8527,2016,9,SQ (SAN QUENTIN SP),3813,0,3813,3082,123.7,3956
8528,2016,9,"SOL (CA SP, SOLANO)",4117,0,4117,2610,157.7,3866
8529,2016,9,SCC (SIERRA CONSERVATION CENTER),4188,0,4188,3936,106.4,4774
8530,2016,9,SATF (CA SUBSTANCE ABUSE TREAT FAC),5242,1,5243,3424,153.1,5495
8531,2016,9,"SAC (CA SP, SACRAMENTO)",2291,0,2291,1828,125.3,2312
8532,2016,9,RJD (RJ DONOVAN CORRECTIONAL FAC),3027,0,3027,2200,137.6,3305
8533,2016,9,PVSP (PLEASANT VALLEY SP),3194,0,3194,2308,138.4,3533
8534,2016,9,PBSP (PELICAN BAY SP),2254,0,2254,2380,94.7,2477
8535,2016,9,NKSP (NORTH KERN SP),4389,0,4389,2694,162.9,4529
8536,2016,9,MCSP (MULE CREEK SP),3522,0,3522,3284,107.2,4343
8537,2016,9,"LAC (CA SP, LOS ANGELES COUNTY)",3416,1,3417,2300,148.6,3575
8538,2016,9,KVSP (KERN VALLEY SP),3902,0,3902,2448,159.4,3910
8539,2016,9,ISP (IRONWOOD SP),3273,0,3273,2200,148.8,3200
8540,2016,9,HDSP (HIGH DESERT SP),3759,0,3759,2324,161.7,3461
8541,2016,9,FOL (FOLSOM SP) (MALE),2466,0,2466,2066,119.4,2895
8542,2016,9,DVI (DEUEL VOCATIONAL INSTITUTION),2292,0,2292,1681,136.3,2580
8543,2016,9,CVSP (CHUCKAWALLA VALLEY SP),2367,0,2367,1738,136.2,2478
8544,2016,9,CTF (CORRECTIONAL TRAINING FAC),5177,0,5177,3312,156.3,5231
8545,2016,9,"CRC (CAL REHAB CTR, MEN)",2925,0,2925,2491,117.4,3487
8546,2016,9,"COR (CA SP, CORCORAN)",3242,0,3242,3116,104.0,3750
8547,2016,9,CMF (CA MEDICAL FAC),2525,0,2525,2361,106.9,2774
8548,2016,9,CMC (CA MEN'S COLONY),4073,0,4073,3838,106.1,4660
8549,2016,9,CIM (CA INSTITUTION FOR MEN),3738,0,3738,2976,125.6,4728
8550,2016,9,CHCF (CA HEALTH CARE FAC - STOCKTON),2467,0,2467,2951,83.6,2951
8551,2016,9,CEN (CENTINELA SP),3629,0,3629,2308,157.2,3433
8552,2016,9,CCI (CA CORRECTIONAL INSTITUTION),3589,0,3589,2783,129.0,4406
8553,2016,9,CCC (CA CORRECTIONAL CENTER),4041,0,4041,3883,104.1,4872
8554,2016,9,CAL (CALIPATRIA SP),3866,0,3866,2308,167.5,3883
8555,2016,9,ASP (AVENAL SP),3262,0,3262,2920,111.7,4727
8556,2016,10,FOL (FOLSOM SP) (FEMALE),484,0,484,403,120.1,483
8557,2016,10,CIW (CA INSTITUTION FOR WOMEN),1875,0,1875,1398,134.1,2038
8558,2016,10,CCWF (CENTRAL CA WOMEN'S FAC),2833,0,2833,2004,141.4,3513
8559,2016,10,WSP (WASCO SP),4864,0,4864,2984,163.0,4997
8560,2016,10,VSP (VALLEY SP),3514,0,3514,1980,177.5,3358
8561,2016,10,SVSP (SALINAS VALLEY SP),3747,0,3747,2452,152.8,3657
8562,2016,10,SQ (SAN QUENTIN SP),3774,0,3774,3082,122.5,3956
8563,2016,10,"SOL (CA SP, SOLANO)",4198,0,4198,2610,160.8,3866
8564,2016,10,SCC (SIERRA CONSERVATION CENTER),4192,0,4192,3936,106.5,4774
8565,2016,10,SATF (CA SUBSTANCE ABUSE TREAT FAC),5348,0,5348,3424,156.2,5495
8566,2016,10,"SAC (CA SP, SACRAMENTO)",2315,0,2315,1828,126.6,2312
8567,2016,10,RJD (RJ DONOVAN CORRECTIONAL FAC),3040,0,3040,2200,138.2,3305
8568,2016,10,PVSP (PLEASANT VALLEY SP),3153,0,3153,2308,136.6,3533
8569,2016,10,PBSP (PELICAN BAY SP),2244,0,2244,2380,94.3,2477
8570,2016,10,NKSP (NORTH KERN SP),4459,0,4459,2694,165.5,4529
8571,2016,10,MCSP (MULE CREEK SP),3515,0,3515,3284,107.0,4343
8572,2016,10,"LAC (CA SP, LOS ANGELES COUNTY)",3236,1,3237,2300,140.7,3550
8573,2016,10,KVSP (KERN VALLEY SP),3834,0,3834,2448,156.6,3910
8574,2016,10,ISP (IRONWOOD SP),3128,0,3128,2200,142.2,3200
8575,2016,10,HDSP (HIGH DESERT SP),3742,0,3742,2324,161.0,3461
8576,2016,10,FOL (FOLSOM SP) (MALE),2335,0,2335,2066,113.0,2895
8577,2016,10,DVI (DEUEL VOCATIONAL INSTITUTION),2253,0,2253,1681,134.0,2580
8578,2016,10,CVSP (CHUCKAWALLA VALLEY SP),2464,0,2464,1738,141.8,2478
8579,2016,10,CTF (CORRECTIONAL TRAINING FAC),5272,0,5272,3312,159.2,5231
8580,2016,10,"CRC (CAL REHAB CTR, MEN)",2828,0,2828,2491,113.5,3487
8581,2016,10,"COR (CA SP, CORCORAN)",3311,0,3311,3116,106.3,3750
8582,2016,10,CMF (CA MEDICAL FAC),2540,0,2540,2361,107.6,2774
8583,2016,10,CMC (CA MEN'S COLONY),4039,0,4039,3838,105.2,4660
8584,2016,10,CIM (CA INSTITUTION FOR MEN),3670,0,3670,2976,123.3,4667
8585,2016,10,CHCF (CA HEALTH CARE FAC - STOCKTON),2454,0,2454,2951,83.2,2951
8586,2016,10,CEN (CENTINELA SP),3676,0,3676,2308,159.3,3433
8587,2016,10,CCI (CA CORRECTIONAL INSTITUTION),3629,0,3629,2783,130.4,4406
8588,2016,10,CCC (CA CORRECTIONAL CENTER),4124,0,4124,3883,106.2,4872
8589,2016,10,CAL (CALIPATRIA SP),3886,0,3886,2308,168.4,3333
8590,2016,10,ASP (AVENAL SP),3261,0,3261,2920,111.7,4370
8591,2016,11,FOL (FOLSOM SP) (FEMALE),445,0,445,403,110.4,483
8592,2016,11,CIW (CA INSTITUTION FOR WOMEN),1879,0,1879,1398,134.4,2038
8593,2016,11,CCWF (CENTRAL CA WOMEN'S FAC),2908,0,2908,2004,145.1,3513
8594,2016,11,WSP (WASCO SP),4880,0,4880,2984,163.5,4997
8595,2016,11,VSP (VALLEY SP),3564,0,3564,1980,180.0,3358
8596,2016,11,SVSP (SALINAS VALLEY SP),3634,0,3634,2452,148.2,3657
8597,2016,11,SQ (SAN QUENTIN SP),3816,0,3816,3082,123.8,3956
8598,2016,11,"SOL (CA SP, SOLANO)",4227,0,4227,2610,162.0,3866
8599,2016,11,SCC (SIERRA CONSERVATION CENTER),4286,0,4286,3936,108.9,4774
8600,2016,11,SATF (CA SUBSTANCE ABUSE TREAT FAC),5315,0,5315,3424,155.2,5495
8601,2016,11,"SAC (CA SP, SACRAMENTO)",2267,0,2267,1828,124.0,2338
8602,2016,11,RJD (RJ DONOVAN CORRECTIONAL FAC),3046,0,3046,2200,138.5,3305
8603,2016,11,PVSP (PLEASANT VALLEY SP),3157,0,3157,2308,136.8,3533
8604,2016,11,PBSP (PELICAN BAY SP),2209,0,2209,2380,92.8,2477
8605,2016,11,NKSP (NORTH KERN SP),4319,0,4319,2694,160.3,4529
8606,2016,11,MCSP (MULE CREEK SP),3522,0,3522,3284,107.2,4343
8607,2016,11,"LAC (CA SP, LOS ANGELES COUNTY)",3310,1,3311,2300,144.0,3550
8608,2016,11,KVSP (KERN VALLEY SP),3752,0,3752,2448,153.3,3910
8609,2016,11,ISP (IRONWOOD SP),3022,0,3022,2200,137.4,3200
8610,2016,11,HDSP (HIGH DESERT SP),3735,0,3735,2324,160.7,3461
8611,2016,11,FOL (FOLSOM SP) (MALE),2351,0,2351,2066,113.8,2893
8612,2016,11,DVI (DEUEL VOCATIONAL INSTITUTION),2242,0,2242,1681,133.4,2580
8613,2016,11,CVSP (CHUCKAWALLA VALLEY SP),2548,0,2548,1738,146.6,2478
8614,2016,11,CTF (CORRECTIONAL TRAINING FAC),5423,0,5423,3312,163.7,5231
8615,2016,11,"CRC (CAL REHAB CTR, MEN)",2771,0,2771,2491,111.2,3487
8616,2016,11,"COR (CA SP, CORCORAN)",3346,0,3346,3116,107.4,3750
8617,2016,11,CMF (CA MEDICAL FAC),2479,0,2479,2361,105.0,2774
8618,2016,11,CMC (CA MEN'S COLONY),4042,0,4042,3838,105.3,4660
8619,2016,11,CIM (CA INSTITUTION FOR MEN),3639,0,3639,2976,122.3,4637
8620,2016,11,CHCF (CA HEALTH CARE FAC - STOCKTON),2478,0,2478,2951,84.0,2951
8621,2016,11,CEN (CENTINELA SP),3646,0,3646,2308,158.0,3433
8622,2016,11,CCI (CA CORRECTIONAL INSTITUTION),3653,0,3653,2783,131.3,4445
8623,2016,11,CCC (CA CORRECTIONAL CENTER),4172,0,4172,3883,107.4,4872
8624,2016,11,CAL (CALIPATRIA SP),3880,0,3880,2308,168.1,3333
8625,2016,11,ASP (AVENAL SP),3355,0,3355,2920,114.9,4370
8626,2016,12,FOL (FOLSOM SP) (FEMALE),433,0,433,403,107.4,483
8627,2016,12,CIW (CA INSTITUTION FOR WOMEN),1928,0,1928,1398,137.9,2038
8628,2016,12,CCWF (CENTRAL CA WOMEN'S FAC),2905,0,2905,2004,145.0,3513
8629,2016,12,WSP (WASCO SP),4879,0,4879,2984,163.5,4997
8630,2016,12,VSP (VALLEY SP),3524,0,3524,1980,178.0,3358
8631,2016,12,SVSP (SALINAS VALLEY SP),3693,0,3693,2452,150.6,3657
8632,2016,12,SQ (SAN QUENTIN SP),3774,0,3774,3082,122.5,3956
8633,2016,12,"SOL (CA SP, SOLANO)",4206,0,4206,2610,161.1,3866
8634,2016,12,SCC (SIERRA CONSERVATION CENTER),4285,0,4285,3936,108.9,4774
8635,2016,12,SATF (CA SUBSTANCE ABUSE TREAT FAC),5421,0,5421,3424,158.3,5407
8636,2016,12,"SAC (CA SP, SACRAMENTO)",2243,0,2243,1828,122.7,2338
8637,2016,12,RJD (RJ DONOVAN CORRECTIONAL FAC),3060,0,3060,2992,102.3,4097
8638,2016,12,PVSP (PLEASANT VALLEY SP),3184,0,3184,2308,138.0,3533
8639,2016,12,PBSP (PELICAN BAY SP),2145,0,2145,2380,90.1,2477
8640,2016,12,NKSP (NORTH KERN SP),4532,0,4532,2694,168.2,4529
8641,2016,12,MCSP (MULE CREEK SP),3545,0,3545,3284,107.9,4343
8642,2016,12,"LAC (CA SP, LOS ANGELES COUNTY)",3362,1,3363,2300,146.2,3550
8643,2016,12,KVSP (KERN VALLEY SP),3701,0,3701,2448,151.2,3910
8644,2016,12,ISP (IRONWOOD SP),3039,0,3039,2200,138.1,3200
8645,2016,12,HDSP (HIGH DESERT SP),3712,0,3712,2324,159.7,3461
8646,2016,12,FOL (FOLSOM SP) (MALE),2460,0,2460,2066,119.1,2893
8647,2016,12,DVI (DEUEL VOCATIONAL INSTITUTION),2276,0,2276,1681,135.4,2580
8648,2016,12,CVSP (CHUCKAWALLA VALLEY SP),2572,0,2572,1738,148.0,2478
8649,2016,12,CTF (CORRECTIONAL TRAINING FAC),5345,0,5345,3312,161.4,5231
8650,2016,12,"CRC (CAL REHAB CTR, MEN)",2713,0,2713,2491,108.9,3487
8651,2016,12,"COR (CA SP, CORCORAN)",3383,0,3383,3116,108.6,3750
8652,2016,12,CMF (CA MEDICAL FAC),2506,0,2506,2361,106.1,2774
8653,2016,12,CMC (CA MEN'S COLONY),4044,0,4044,3838,105.4,4660
8654,2016,12,CIM (CA INSTITUTION FOR MEN),3537,0,3537,2976,118.9,4637
8655,2016,12,CHCF (CA HEALTH CARE FAC - STOCKTON),2475,0,2475,2951,83.9,2951
8656,2016,12,CEN (CENTINELA SP),3604,0,3604,2308,156.2,3433
8657,2016,12,CCI (CA CORRECTIONAL INSTITUTION),3698,0,3698,2783,132.9,4120
8658,2016,12,CCC (CA CORRECTIONAL CENTER),4157,0,4157,3883,107.1,4648
8659,2016,12,CAL (CALIPATRIA SP),3859,0,3859,2308,167.2,3333
8660,2016,12,ASP (AVENAL SP),3356,0,3356,2920,114.9,4370
8661,2017,1,FOL (FOLSOM SP) (FEMALE),408,0,408,403,101.2,483
8662,2017,1,CIW (CA INSTITUTION FOR WOMEN),1944,0,1944,1398,139.1,2038
8663,2017,1,CCWF (CENTRAL CA WOMEN'S FAC),2930,0,2930,2004,146.2,3513
8664,2017,1,WSP (WASCO SP),4995,0,4995,2984,167.4,4997
8665,2017,1,VSP (VALLEY SP),3448,0,3448,1980,174.1,3358
8666,2017,1,SVSP (SALINAS VALLEY SP),3407,0,3407,2452,138.9,3657
8667,2017,1,SQ (SAN QUENTIN SP),3908,0,3908,3082,126.8,3956
8668,2017,1,"SOL (CA SP, SOLANO)",4185,0,4185,2610,160.3,3866
8669,2017,1,SCC (SIERRA CONSERVATION CENTER),4231,0,4231,3936,107.5,4774
8670,2017,1,SATF (CA SUBSTANCE ABUSE TREAT FAC),5494,0,5494,3424,160.5,5407
8671,2017,1,"SAC (CA SP, SACRAMENTO)",2231,0,2231,1828,122.0,2338
8672,2017,1,RJD (RJ DONOVAN CORRECTIONAL FAC),3246,0,3246,2992,108.5,4097
8673,2017,1,PVSP (PLEASANT VALLEY SP),3179,0,3179,2308,137.7,3533
8674,2017,1,PBSP (PELICAN BAY SP),2112,0,2112,2380,88.7,2519
8675,2017,1,NKSP (NORTH KERN SP),4430,0,4430,2694,164.4,4529
8676,2017,1,MCSP (MULE CREEK SP),3592,0,3592,3284,109.4,4343
8677,2017,1,"LAC (CA SP, LOS ANGELES COUNTY)",3413,1,3414,2300,148.4,3550
8678,2017,1,KVSP (KERN VALLEY SP),3741,0,3741,2448,152.8,3884
8679,2017,1,ISP (IRONWOOD SP),3025,0,3025,2200,137.5,3200
8680,2017,1,HDSP (HIGH DESERT SP),3692,0,3692,2324,158.9,3461
8681,2017,1,FOL (FOLSOM SP) (MALE),2456,0,2456,2066,118.9,2893
8682,2017,1,DVI (DEUEL VOCATIONAL INSTITUTION),2182,0,2182,1681,129.8,2580
8683,2017,1,CVSP (CHUCKAWALLA VALLEY SP),2542,0,2542,1738,146.3,2478
8684,2017,1,CTF (CORRECTIONAL TRAINING FAC),5276,0,5276,3312,159.3,5231
8685,2017,1,"CRC (CAL REHAB CTR, MEN)",2687,0,2687,2491,107.9,3487
8686,2017,1,"COR (CA SP, CORCORAN)",3466,0,3466,3116,111.2,3769
8687,2017,1,CMF (CA MEDICAL FAC),2474,0,2474,2361,104.8,2774
8688,2017,1,CMC (CA MEN'S COLONY),3944,0,3944,3838,102.8,4660
8689,2017,1,CIM (CA INSTITUTION FOR MEN),3506,0,3506,2976,117.8,4504
8690,2017,1,CHCF (CA HEALTH CARE FAC - STOCKTON),2486,0,2486,2951,84.2,2951
8691,2017,1,CEN (CENTINELA SP),3584,0,3584,2308,155.3,3433
8692,2017,1,CCI (CA CORRECTIONAL INSTITUTION),3697,0,3697,2783,132.8,4120
8693,2017,1,CCC (CA CORRECTIONAL CENTER),4186,0,4186,3883,107.8,4667
8694,2017,1,CAL (CALIPATRIA SP),3813,0,3813,2308,165.2,3333
8695,2017,1,ASP (AVENAL SP),3346,0,3346,2920,114.6,4370
8696,2017,2,FOL (FOLSOM SP) (FEMALE),405,0,405,403,100.5,483
8697,2017,2,CIW (CA INSTITUTION FOR WOMEN),1933,0,1933,1398,138.3,2038
8698,2017,2,CCWF (CENTRAL CA WOMEN'S FAC),2889,0,2889,2004,144.2,3513
8699,2017,2,WSP (WASCO SP),5059,0,5059,2984,169.5,4997
8700,2017,2,VSP (VALLEY SP),3396,0,3396,1980,171.5,3358
8701,2017,2,SVSP (SALINAS VALLEY SP),3372,1,3373,2452,137.6,3657
8702,2017,2,SQ (SAN QUENTIN SP),3714,0,3714,3082,120.5,3956
8703,2017,2,"SOL (CA SP, SOLANO)",4135,0,4135,2610,158.4,3866
8704,2017,2,SCC (SIERRA CONSERVATION CENTER),4161,0,4161,3936,105.7,4774
8705,2017,2,SATF (CA SUBSTANCE ABUSE TREAT FAC),5544,0,5544,3424,161.9,5407
8706,2017,2,"SAC (CA SP, SACRAMENTO)",2197,0,2197,1828,120.2,2338
8707,2017,2,RJD (RJ DONOVAN CORRECTIONAL FAC),3501,0,3501,2992,117.0,4097
8708,2017,2,PVSP (PLEASANT VALLEY SP),3188,0,3188,2308,138.1,3533
8709,2017,2,PBSP (PELICAN BAY SP),2106,0,2106,2380,88.5,2519
8710,2017,2,NKSP (NORTH KERN SP),4650,0,4650,2694,172.6,4529
8711,2017,2,MCSP (MULE CREEK SP),3631,0,3631,3284,110.6,4343
8712,2017,2,"LAC (CA SP, LOS ANGELES COUNTY)",3395,1,3396,2300,147.7,3550
8713,2017,2,KVSP (KERN VALLEY SP),3738,0,3738,2448,152.7,3884
8714,2017,2,ISP (IRONWOOD SP),3066,0,3066,2200,139.4,3200
8715,2017,2,HDSP (HIGH DESERT SP),3692,0,3692,2324,158.9,3461
8716,2017,2,FOL (FOLSOM SP) (MALE),2431,0,2431,2066,117.7,2893
8717,2017,2,DVI (DEUEL VOCATIONAL INSTITUTION),2160,0,2160,1681,128.5,2580
8718,2017,2,CVSP (CHUCKAWALLA VALLEY SP),2586,0,2586,1738,148.8,2478
8719,2017,2,CTF (CORRECTIONAL TRAINING FAC),5250,0,5250,3312,158.5,5231
8720,2017,2,"CRC (CAL REHAB CTR, MEN)",2724,0,2724,2491,109.4,3487
8721,2017,2,"COR (CA SP, CORCORAN)",3442,0,3442,3116,110.5,3769
8722,2017,2,CMF (CA MEDICAL FAC),2550,0,2550,2361,108.0,2774
8723,2017,2,CMC (CA MEN'S COLONY),3871,0,3871,3838,100.9,4660
8724,2017,2,CIM (CA INSTITUTION FOR MEN),3531,0,3531,2976,118.6,4504
8725,2017,2,CHCF (CA HEALTH CARE FAC - STOCKTON),2437,0,2437,2951,82.6,2951
8726,2017,2,CEN (CENTINELA SP),3609,0,3609,2308,156.4,3433
8727,2017,2,CCI (CA CORRECTIONAL INSTITUTION),3812,0,3812,2783,137.0,4120
8728,2017,2,CCC (CA CORRECTIONAL CENTER),4305,0,4305,3883,110.9,4667
8729,2017,2,CAL (CALIPATRIA SP),3793,0,3793,2308,164.3,3333
8730,2017,2,ASP (AVENAL SP),3419,0,3419,2920,117.1,4370
8731,2017,3,FOL (FOLSOM SP) (FEMALE),413,0,413,403,102.5,483
8732,2017,3,CIW (CA INSTITUTION FOR WOMEN),1941,0,1941,1398,138.8,2038
8733,2017,3,CCWF (CENTRAL CA WOMEN'S FAC),2902,0,2902,2004,144.8,2966
8734,2017,3,WSP (WASCO SP),5149,0,5149,2984,172.6,4997
8735,2017,3,VSP (VALLEY SP),3382,0,3382,1980,170.8,3358
8736,2017,3,SVSP (SALINAS VALLEY SP),3476,0,3476,2452,141.8,3657
8737,2017,3,SQ (SAN QUENTIN SP),3811,0,3811,3082,123.7,3956
8738,2017,3,"SOL (CA SP, SOLANO)",4073,0,4073,2610,156.1,3866
8739,2017,3,SCC (SIERRA CONSERVATION CENTER),4134,0,4134,3936,105.0,4774
8740,2017,3,SATF (CA SUBSTANCE ABUSE TREAT FAC),5644,0,5644,3424,164.8,5407
8741,2017,3,"SAC (CA SP, SACRAMENTO)",2284,0,2284,1828,124.9,2393
8742,2017,3,RJD (RJ DONOVAN CORRECTIONAL FAC),3681,0,3681,2992,123.0,4097
8743,2017,3,PVSP (PLEASANT VALLEY SP),3154,0,3154,2308,136.7,3533
8744,2017,3,PBSP (PELICAN BAY SP),2068,0,2068,2380,86.9,2519
8745,2017,3,NKSP (NORTH KERN SP),4703,0,4703,2694,174.6,4529
8746,2017,3,MCSP (MULE CREEK SP),3648,0,3648,3284,111.1,4343
8747,2017,3,"LAC (CA SP, LOS ANGELES COUNTY)",3423,0,3423,2300,148.8,3550
8748,2017,3,KVSP (KERN VALLEY SP),3684,0,3684,2448,150.5,3884
8749,2017,3,ISP (IRONWOOD SP),3023,0,3023,2200,137.4,3200
8750,2017,3,HDSP (HIGH DESERT SP),3647,0,3647,2324,156.9,3461
8751,2017,3,FOL (FOLSOM SP) (MALE),2464,0,2464,2066,119.3,2893
8752,2017,3,DVI (DEUEL VOCATIONAL INSTITUTION),2272,0,2272,1681,135.2,2579
8753,2017,3,CVSP (CHUCKAWALLA VALLEY SP),2640,0,2640,1738,151.9,2478
8754,2017,3,CTF (CORRECTIONAL TRAINING FAC),5216,0,5216,3312,157.5,5231
8755,2017,3,"CRC (CAL REHAB CTR, MEN)",2735,0,2735,2491,109.8,3487
8756,2017,3,"COR (CA SP, CORCORAN)",3324,0,3324,3116,106.7,3769
8757,2017,3,CMF (CA MEDICAL FAC),2566,0,2566,2361,108.7,2774
8758,2017,3,CMC (CA MEN'S COLONY),3855,0,3855,3838,100.4,4660
8759,2017,3,CIM (CA INSTITUTION FOR MEN),3525,0,3525,2976,118.4,4254
8760,2017,3,CHCF (CA HEALTH CARE FAC - STOCKTON),2403,1,2404,2951,81.5,2951
8761,2017,3,CEN (CENTINELA SP),3631,0,3631,2308,157.3,3333
8762,2017,3,CCI (CA CORRECTIONAL INSTITUTION),3875,0,3875,2783,139.2,4120
8763,2017,3,CCC (CA CORRECTIONAL CENTER),4277,0,4277,3883,110.1,4667
8764,2017,3,CAL (CALIPATRIA SP),3819,0,3819,2308,165.5,3333
8765,2017,3,ASP (AVENAL SP),3629,0,3629,2920,124.3,4370
8766,2017,4,FOL (FOLSOM SP) (FEMALE),447,0,447,403,110.9,483
8767,2017,4,CIW (CA INSTITUTION FOR WOMEN),1904,0,1904,1398,136.2,1858
8768,2017,4,CCWF (CENTRAL CA WOMEN'S FAC),2871,0,2871,2004,143.3,2966
8769,2017,4,WSP (WASCO SP),5233,0,5233,2984,175.4,4351
8770,2017,4,VSP (VALLEY SP),3470,0,3470,1980,175.3,2954
8771,2017,4,SVSP (SALINAS VALLEY SP),3612,0,3612,2452,147.3,3409
8772,2017,4,SQ (SAN QUENTIN SP),3805,0,3805,3082,123.5,3956
8773,2017,4,"SOL (CA SP, SOLANO)",4005,0,4005,2610,153.4,3882
8774,2017,4,SCC (SIERRA CONSERVATION CENTER),4223,0,4223,3936,107.3,4660
8775,2017,4,SATF (CA SUBSTANCE ABUSE TREAT FAC),5571,0,5571,3424,162.7,4979
8776,2017,4,"SAC (CA SP, SACRAMENTO)",2301,0,2301,1828,125.9,2393
8777,2017,4,RJD (RJ DONOVAN CORRECTIONAL FAC),3746,0,3746,2992,125.2,3942
8778,2017,4,PVSP (PLEASANT VALLEY SP),3146,0,3146,2308,136.3,3333
8779,2017,4,PBSP (PELICAN BAY SP),2032,0,2032,2380,85.4,2519
8780,2017,4,NKSP (NORTH KERN SP),4633,0,4633,2694,172.0,3911
8781,2017,4,MCSP (MULE CREEK SP),3611,0,3611,3284,110.0,4001
8782,2017,4,"LAC (CA SP, LOS ANGELES COUNTY)",3298,0,3298,2300,143.4,3300
8783,2017,4,KVSP (KERN VALLEY SP),3674,0,3674,2448,150.1,3458
8784,2017,4,ISP (IRONWOOD SP),3021,0,3021,2200,137.3,3200
8785,2017,4,HDSP (HIGH DESERT SP),3691,0,3691,2324,158.8,3361
8786,2017,4,FOL (FOLSOM SP) (MALE),2571,0,2571,2066,124.4,2893
8787,2017,4,DVI (DEUEL VOCATIONAL INSTITUTION),2313,0,2313,1681,137.6,2579
8788,2017,4,CVSP (CHUCKAWALLA VALLEY SP),2651,0,2651,1738,152.5,2478
8789,2017,4,CTF (CORRECTIONAL TRAINING FAC),5128,0,5128,3312,154.8,5231
8790,2017,4,"CRC (CAL REHAB CTR, MEN)",2691,0,2691,2491,108.0,3210
8791,2017,4,"COR (CA SP, CORCORAN)",3259,0,3259,3116,104.6,4537
8792,2017,4,CMF (CA MEDICAL FAC),2526,0,2526,2361,107.0,2774
8793,2017,4,CMC (CA MEN'S COLONY),3867,0,3867,3838,100.8,4660
8794,2017,4,CIM (CA INSTITUTION FOR MEN),3514,0,3514,2976,118.1,4186
8795,2017,4,CHCF (CA HEALTH CARE FAC - STOCKTON),2360,1,2361,2951,80.0,2951
8796,2017,4,CEN (CENTINELA SP),3571,0,3571,2308,154.7,3333
8797,2017,4,CCI (CA CORRECTIONAL INSTITUTION),3867,0,3867,2783,139.0,4120
8798,2017,4,CCC (CA CORRECTIONAL CENTER),4272,0,4272,3883,110.0,4667
8799,2017,4,CAL (CALIPATRIA SP),3850,0,3850,2308,166.8,3333
8800,2017,4,ASP (AVENAL SP),3649,0,3649,2920,125.0,4370
8801,2017,5,FOL (FOLSOM SP) (FEMALE),442,0,442,403,109.7,530
8802,2017,5,CIW (CA INSTITUTION FOR WOMEN),1860,0,1860,1398,133.0,1858
8803,2017,5,CCWF (CENTRAL CA WOMEN'S FAC),2972,0,2972,2004,148.3,2966
8804,2017,5,WSP (WASCO SP),5281,0,5281,2984,177.0,4351
8805,2017,5,VSP (VALLEY SP),3543,0,3543,1980,178.9,2954
8806,2017,5,SVSP (SALINAS VALLEY SP),3619,0,3619,2452,147.6,3409
8807,2017,5,SQ (SAN QUENTIN SP),3954,0,3954,3082,128.3,4038
8808,2017,5,"SOL (CA SP, SOLANO)",3916,0,3916,2610,150.0,3882
8809,2017,5,SCC (SIERRA CONSERVATION CENTER),4150,0,4150,3936,105.4,4660
8810,2017,5,SATF (CA SUBSTANCE ABUSE TREAT FAC),5654,0,5654,3424,165.1,4979
8811,2017,5,"SAC (CA SP, SACRAMENTO)",2322,0,2322,1828,127.0,2393
8812,2017,5,RJD (RJ DONOVAN CORRECTIONAL FAC),3826,0,3826,2992,127.9,3942
8813,2017,5,PVSP (PLEASANT VALLEY SP),3192,0,3192,2308,138.3,3333
8814,2017,5,PBSP (PELICAN BAY SP),2023,0,2023,2380,85.0,2530
8815,2017,5,NKSP (NORTH KERN SP),4618,0,4618,2694,171.4,3911
8816,2017,5,MCSP (MULE CREEK SP),3597,0,3597,3284,109.5,4001
8817,2017,5,"LAC (CA SP, LOS ANGELES COUNTY)",3320,0,3320,2300,144.3,3300
8818,2017,5,KVSP (KERN VALLEY SP),3713,0,3713,2448,151.7,3458
8819,2017,5,ISP (IRONWOOD SP),3030,0,3030,2200,137.7,3200
8820,2017,5,HDSP (HIGH DESERT SP),3791,0,3791,2324,163.1,3361
8821,2017,5,FOL (FOLSOM SP) (MALE),2612,0,2612,2066,126.4,2895
8822,2017,5,DVI (DEUEL VOCATIONAL INSTITUTION),2416,0,2416,1681,143.7,2353
8823,2017,5,CVSP (CHUCKAWALLA VALLEY SP),2734,0,2734,1738,157.3,2478
8824,2017,5,CTF (CORRECTIONAL TRAINING FAC),5081,0,5081,3312,153.4,4887
8825,2017,5,"CRC (CAL REHAB CTR, MEN)",2648,0,2648,2491,106.3,3210
8826,2017,5,"COR (CA SP, CORCORAN)",3028,0,3028,3116,97.2,4264
8827,2017,5,CMF (CA MEDICAL FAC),2520,0,2520,2361,106.7,2810
8828,2017,5,CMC (CA MEN'S COLONY),3882,0,3882,3838,101.1,4440
8829,2017,5,CIM (CA INSTITUTION FOR MEN),3532,0,3532,2976,118.7,4186
8830,2017,5,CHCF (CA HEALTH CARE FAC - STOCKTON),2378,1,2379,2951,80.6,2951
8831,2017,5,CEN (CENTINELA SP),3536,0,3536,2308,153.2,3333
8832,2017,5,CCI (CA CORRECTIONAL INSTITUTION),3771,0,3771,2783,135.5,4120
8833,2017,5,CCC (CA CORRECTIONAL CENTER),4247,0,4247,3883,109.4,4667
8834,2017,5,CAL (CALIPATRIA SP),3877,0,3877,2308,168.0,3333
8835,2017,5,ASP (AVENAL SP),3675,0,3675,2920,125.9,4370
8836,2017,6,FOL (FOLSOM SP) (FEMALE),445,0,445,403,110.4,530
8837,2017,6,CIW (CA INSTITUTION FOR WOMEN),1894,0,1894,1398,135.5,1858
8838,2017,6,CCWF (CENTRAL CA WOMEN'S FAC),2957,0,2957,2004,147.6,2966
8839,2017,6,WSP (WASCO SP),5237,0,5237,2984,175.5,4351
8840,2017,6,VSP (VALLEY SP),3557,0,3557,1980,179.6,2954
8841,2017,6,SVSP (SALINAS VALLEY SP),3592,0,3592,2452,146.5,3409
8842,2017,6,SQ (SAN QUENTIN SP),4004,0,4004,3082,129.9,4038
8843,2017,6,"SOL (CA SP, SOLANO)",3879,0,3879,2610,148.6,3882
8844,2017,6,SCC (SIERRA CONSERVATION CENTER),4219,0,4219,3936,107.2,4660
8845,2017,6,SATF (CA SUBSTANCE ABUSE TREAT FAC),5650,0,5650,3424,165.0,5111
8846,2017,6,"SAC (CA SP, SACRAMENTO)",2305,0,2305,1828,126.1,2393
8847,2017,6,RJD (RJ DONOVAN CORRECTIONAL FAC),3840,0,3840,2992,128.3,3942
8848,2017,6,PVSP (PLEASANT VALLEY SP),3087,0,3087,2308,133.8,3333
8849,2017,6,PBSP (PELICAN BAY SP),2047,0,2047,2380,86.0,2530
8850,2017,6,NKSP (NORTH KERN SP),4654,0,4654,2694,172.8,3911
8851,2017,6,MCSP (MULE CREEK SP),3626,0,3626,3284,110.4,4001
8852,2017,6,"LAC (CA SP, LOS ANGELES COUNTY)",3379,0,3379,2300,146.9,3300
8853,2017,6,KVSP (KERN VALLEY SP),3661,0,3661,2448,149.6,3458
8854,2017,6,ISP (IRONWOOD SP),3075,0,3075,2200,139.8,3200
8855,2017,6,HDSP (HIGH DESERT SP),3729,0,3729,2324,160.5,3361
8856,2017,6,FOL (FOLSOM SP) (MALE),2645,0,2645,2066,128.0,2895
8857,2017,6,DVI (DEUEL VOCATIONAL INSTITUTION),2400,0,2400,1681,142.8,2353
8858,2017,6,CVSP (CHUCKAWALLA VALLEY SP),2789,0,2789,1738,160.5,2478
8859,2017,6,CTF (CORRECTIONAL TRAINING FAC),5078,0,5078,3312,153.3,4887
8860,2017,6,"CRC (CAL REHAB CTR, MEN)",2664,0,2664,2491,106.9,3210
8861,2017,6,"COR (CA SP, CORCORAN)",3069,0,3069,3116,98.5,4264
8862,2017,6,CMF (CA MEDICAL FAC),2518,0,2518,2361,106.6,2789
8863,2017,6,CMC (CA MEN'S COLONY),4020,0,4020,3838,104.7,4401
8864,2017,6,CIM (CA INSTITUTION FOR MEN),3642,0,3642,2976,122.4,4186
8865,2017,6,CHCF (CA HEALTH CARE FAC - STOCKTON),2414,0,2414,2951,81.8,2951
8866,2017,6,CEN (CENTINELA SP),3557,0,3557,2308,154.1,3333
8867,2017,6,CCI (CA CORRECTIONAL INSTITUTION),3806,0,3806,2783,136.8,4120
8868,2017,6,CCC (CA CORRECTIONAL CENTER),4122,0,4122,3883,106.2,4667
8869,2017,6,CAL (CALIPATRIA SP),3823,0,3823,2308,165.6,3333
8870,2017,6,ASP (AVENAL SP),3724,0,3724,2920,127.5,4370
8871,2017,7,FOL (FOLSOM SP) (FEMALE),430,0,430,403,106.7,530
8872,2017,7,CIW (CA INSTITUTION FOR WOMEN),1883,0,1883,1398,134.7,1858
8873,2017,7,CCWF (CENTRAL CA WOMEN'S FAC),2963,0,2963,2004,147.9,2966
8874,2017,7,WSP (WASCO SP),5283,0,5283,2984,177.0,4351
8875,2017,7,VSP (VALLEY SP),3496,0,3496,1980,176.6,2954
8876,2017,7,SVSP (SALINAS VALLEY SP),3535,0,3535,2452,144.2,3409
8877,2017,7,SQ (SAN QUENTIN SP),4102,0,4102,3082,133.1,4038
8878,2017,7,"SOL (CA SP, SOLANO)",3818,0,3818,2610,146.3,3882
8879,2017,7,SCC (SIERRA CONSERVATION CENTER),4181,0,4181,3936,106.2,4660
8880,2017,7,SATF (CA SUBSTANCE ABUSE TREAT FAC),5708,0,5708,3424,166.7,5111
8881,2017,7,"SAC (CA SP, SACRAMENTO)",2302,0,2302,1828,125.9,2457
8882,2017,7,RJD (RJ DONOVAN CORRECTIONAL FAC),3813,0,3813,2992,127.4,3942
8883,2017,7,PVSP (PLEASANT VALLEY SP),2987,0,2987,2308,129.4,3333
8884,2017,7,PBSP (PELICAN BAY SP),2068,0,2068,2380,86.9,3250
8885,2017,7,NKSP (NORTH KERN SP),4614,0,4614,2694,171.3,3911
8886,2017,7,MCSP (MULE CREEK SP),3628,0,3628,3284,110.5,4001
8887,2017,7,"LAC (CA SP, LOS ANGELES COUNTY)",3366,0,3366,2300,146.3,3300
8888,2017,7,KVSP (KERN VALLEY SP),3626,0,3626,2448,148.1,3458
8889,2017,7,ISP (IRONWOOD SP),3138,0,3138,2200,142.6,3200
8890,2017,7,HDSP (HIGH DESERT SP),3579,0,3579,2324,154.0,3361
8891,2017,7,FOL (FOLSOM SP) (MALE),2613,0,2613,2066,126.5,2895
8892,2017,7,DVI (DEUEL VOCATIONAL INSTITUTION),2487,0,2487,1681,147.9,2353
8893,2017,7,CVSP (CHUCKAWALLA VALLEY SP),2812,0,2812,1738,161.8,2478
8894,2017,7,CTF (CORRECTIONAL TRAINING FAC),5086,0,5086,3312,153.6,4887
8895,2017,7,"CRC (CAL REHAB CTR, MEN)",2654,0,2654,2491,106.5,3210
8896,2017,7,"COR (CA SP, CORCORAN)",3208,0,3208,3116,103.0,4264
8897,2017,7,CMF (CA MEDICAL FAC),2517,0,2517,2361,106.6,2789
8898,2017,7,CMC (CA MEN'S COLONY),4081,0,4081,3838,106.3,4401
8899,2017,7,CIM (CA INSTITUTION FOR MEN),3687,0,3687,2976,123.9,4186
8900,2017,7,CHCF (CA HEALTH CARE FAC - STOCKTON),2401,0,2401,2951,81.4,2951
8901,2017,7,CEN (CENTINELA SP),3423,0,3423,2308,148.3,3333
8902,2017,7,CCI (CA CORRECTIONAL INSTITUTION),3798,0,3798,2783,136.5,4120
8903,2017,7,CCC (CA CORRECTIONAL CENTER),4081,0,4081,3883,105.1,4667
8904,2017,7,CAL (CALIPATRIA SP),3759,0,3759,2308,162.9,3333
8905,2017,7,ASP (AVENAL SP),3706,0,3706,2920,126.9,4370
8906,2017,8,FOL (FOLSOM SP) (FEMALE),434,0,434,403,107.7,530
8907,2017,8,CIW (CA INSTITUTION FOR WOMEN),1881,0,1881,1398,134.5,1856
8908,2017,8,CCWF (CENTRAL CA WOMEN'S FAC),2964,0,2964,2004,147.9,2966
8909,2017,8,WSP (WASCO SP),5097,0,5097,2984,170.8,4351
8910,2017,8,VSP (VALLEY SP),3474,0,3474,1980,175.5,2954
8911,2017,8,SVSP (SALINAS VALLEY SP),3546,0,3546,2452,144.6,3409
8912,2017,8,SQ (SAN QUENTIN SP),4087,0,4087,3082,132.6,4038
8913,2017,8,"SOL (CA SP, SOLANO)",3773,0,3773,2610,144.6,3882
8914,2017,8,SCC (SIERRA CONSERVATION CENTER),4358,0,4358,3936,110.7,4780
8915,2017,8,SATF (CA SUBSTANCE ABUSE TREAT FAC),5662,0,5662,3424,165.4,5111
8916,2017,8,"SAC (CA SP, SACRAMENTO)",2200,0,2200,1828,120.4,2457
8917,2017,8,RJD (RJ DONOVAN CORRECTIONAL FAC),3876,0,3876,2992,129.5,3942
8918,2017,8,PVSP (PLEASANT VALLEY SP),2966,0,2966,2308,128.5,3333
8919,2017,8,PBSP (PELICAN BAY SP),2182,0,2182,2380,91.7,3250
8920,2017,8,NKSP (NORTH KERN SP),4541,0,4541,2694,168.6,3911
8921,2017,8,MCSP (MULE CREEK SP),3681,0,3681,3284,112.1,4001
8922,2017,8,"LAC (CA SP, LOS ANGELES COUNTY)",3437,0,3437,2300,149.4,3300
8923,2017,8,KVSP (KERN VALLEY SP),3612,0,3612,2448,147.5,3458
8924,2017,8,ISP (IRONWOOD SP),3192,0,3192,2200,145.1,3200
8925,2017,8,HDSP (HIGH DESERT SP),3548,0,3548,2324,152.7,3361
8926,2017,8,FOL (FOLSOM SP) (MALE),2576,0,2576,2066,124.7,2895
8927,2017,8,DVI (DEUEL VOCATIONAL INSTITUTION),2430,0,2430,1681,144.6,2353
8928,2017,8,CVSP (CHUCKAWALLA VALLEY SP),2807,0,2807,1738,161.5,2478
8929,2017,8,CTF (CORRECTIONAL TRAINING FAC),5117,0,5117,3312,154.5,4887
8930,2017,8,"CRC (CAL REHAB CTR, MEN)",2641,0,2641,2491,106.0,3210
8931,2017,8,"COR (CA SP, CORCORAN)",3227,0,3227,3116,103.6,4264
8932,2017,8,CMF (CA MEDICAL FAC),2557,0,2557,2361,108.3,2789
8933,2017,8,CMC (CA MEN'S COLONY),4181,0,4181,3838,108.9,4401
8934,2017,8,CIM (CA INSTITUTION FOR MEN),3643,0,3643,2976,122.4,4186
8935,2017,8,CHCF (CA HEALTH CARE FAC - STOCKTON),2374,0,2374,2951,80.4,2951
8936,2017,8,CEN (CENTINELA SP),3453,0,3453,2308,149.6,3333
8937,2017,8,CCI (CA CORRECTIONAL INSTITUTION),3846,0,3846,2783,138.2,4120
8938,2017,8,CCC (CA CORRECTIONAL CENTER),4179,0,4179,3883,107.6,4667
8939,2017,8,CAL (CALIPATRIA SP),3728,0,3728,2308,161.5,3333
8940,2017,8,ASP (AVENAL SP),3833,0,3833,2920,131.3,4370
8941,2017,9,FOL (FOLSOM SP) (FEMALE),421,0,421,403,104.5,530
8942,2017,9,CIW (CA INSTITUTION FOR WOMEN),1878,0,1878,1398,134.3,1856
8943,2017,9,CCWF (CENTRAL CA WOMEN'S FAC),2963,0,2963,2004,147.9,2966
8944,2017,9,WSP (WASCO SP),5114,0,5114,2984,171.4,4351
8945,2017,9,VSP (VALLEY SP),3554,0,3554,1980,179.5,2954
8946,2017,9,SVSP (SALINAS VALLEY SP),3552,0,3552,2452,144.9,3409
8947,2017,9,SQ (SAN QUENTIN SP),4060,0,4060,3082,131.7,4038
8948,2017,9,"SOL (CA SP, SOLANO)",3700,0,3700,2610,141.8,3882
8949,2017,9,SCC (SIERRA CONSERVATION CENTER),4470,0,4470,3936,113.6,4660
8950,2017,9,SATF (CA SUBSTANCE ABUSE TREAT FAC),5748,0,5748,3424,167.9,5111
8951,2017,9,"SAC (CA SP, SACRAMENTO)",2176,0,2176,1828,119.0,2457
8952,2017,9,RJD (RJ DONOVAN CORRECTIONAL FAC),3921,0,3921,2992,131.0,3942
8953,2017,9,PVSP (PLEASANT VALLEY SP),2924,0,2924,2308,126.7,3333
8954,2017,9,PBSP (PELICAN BAY SP),2304,0,2304,2380,96.8,3250
8955,2017,9,NKSP (NORTH KERN SP),4525,0,4525,2694,168.0,3911
8956,2017,9,MCSP (MULE CREEK SP),3700,0,3700,3284,112.7,4001
8957,2017,9,"LAC (CA SP, LOS ANGELES COUNTY)",3462,0,3462,2300,150.5,3300
8958,2017,9,KVSP (KERN VALLEY SP),3680,0,3680,2448,150.3,3458
8959,2017,9,ISP (IRONWOOD SP),3150,0,3150,2200,143.2,3200
8960,2017,9,HDSP (HIGH DESERT SP),3581,0,3581,2324,154.1,3361
8961,2017,9,FOL (FOLSOM SP) (MALE),2554,0,2554,2066,123.6,2895
8962,2017,9,DVI (DEUEL VOCATIONAL INSTITUTION),2433,0,2433,1681,144.7,2353
8963,2017,9,CVSP (CHUCKAWALLA VALLEY SP),2802,0,2802,1738,161.2,2478
8964,2017,9,CTF (CORRECTIONAL TRAINING FAC),4987,0,4987,3312,150.6,4887
8965,2017,9,"CRC (CAL REHAB CTR, MEN)",2662,0,2662,2491,106.9,3210
8966,2017,9,"COR (CA SP, CORCORAN)",3148,0,3148,3116,101.0,3496
8967,2017,9,CMF (CA MEDICAL FAC),2537,0,2537,2361,107.5,2789
8968,2017,9,CMC (CA MEN'S COLONY),4066,0,4066,3838,105.9,4401
8969,2017,9,CIM (CA INSTITUTION FOR MEN),3653,0,3653,2976,122.7,4186
8970,2017,9,CHCF (CA HEALTH CARE FAC - STOCKTON),2320,0,2320,2951,78.6,2951
8971,2017,9,CEN (CENTINELA SP),3479,0,3479,2308,150.7,3333
8972,2017,9,CCI (CA CORRECTIONAL INSTITUTION),3843,0,3843,2783,138.1,4120
8973,2017,9,CCC (CA CORRECTIONAL CENTER),4270,0,4270,3883,110.0,4667
8974,2017,9,CAL (CALIPATRIA SP),3738,0,3738,2308,162.0,3333
8975,2017,9,ASP (AVENAL SP),3878,0,3878,2920,132.8,4370
8976,2017,10,FOL (FOLSOM SP) (FEMALE),400,0,400,403,99.3,530
8977,2017,10,CIW (CA INSTITUTION FOR WOMEN),1839,0,1839,1398,131.5,1856
8978,2017,10,CCWF (CENTRAL CA WOMEN'S FAC),2973,0,2973,2004,148.4,2966
8979,2017,10,WSP (WASCO SP),5074,0,5074,2984,170.0,4351
8980,2017,10,VSP (VALLEY SP),3549,0,3549,1980,179.2,2954
8981,2017,10,SVSP (SALINAS VALLEY SP),3508,0,3508,2452,143.1,3409
8982,2017,10,SQ (SAN QUENTIN SP),4075,0,4075,3082,132.2,4038
8983,2017,10,"SOL (CA SP, SOLANO)",3716,0,3716,2610,142.4,3882
8984,2017,10,SCC (SIERRA CONSERVATION CENTER),4449,0,4449,3936,113.0,4660
8985,2017,10,SATF (CA SUBSTANCE ABUSE TREAT FAC),5773,0,5773,3424,168.6,5111
8986,2017,10,"SAC (CA SP, SACRAMENTO)",2148,0,2148,1828,117.5,2457
8987,2017,10,RJD (RJ DONOVAN CORRECTIONAL FAC),3948,0,3948,2992,132.0,3942
8988,2017,10,PVSP (PLEASANT VALLEY SP),2840,0,2840,2308,123.1,3333
8989,2017,10,PBSP (PELICAN BAY SP),2444,0,2444,2380,102.7,3250
8990,2017,10,NKSP (NORTH KERN SP),4555,0,4555,2694,169.1,3911
8991,2017,10,MCSP (MULE CREEK SP),3737,0,3737,3284,113.8,4001
8992,2017,10,"LAC (CA SP, LOS ANGELES COUNTY)",3429,0,3429,2300,149.1,3300
8993,2017,10,KVSP (KERN VALLEY SP),3692,0,3692,2448,150.8,3458
8994,2017,10,ISP (IRONWOOD SP),3018,0,3018,2200,137.2,3200
8995,2017,10,HDSP (HIGH DESERT SP),3490,0,3490,2324,150.2,3361
8996,2017,10,FOL (FOLSOM SP) (MALE),2462,0,2462,2066,119.2,2895
8997,2017,10,DVI (DEUEL VOCATIONAL INSTITUTION),2283,0,2283,1681,135.8,2353
8998,2017,10,CVSP (CHUCKAWALLA VALLEY SP),2814,0,2814,1738,161.9,2478
8999,2017,10,CTF (CORRECTIONAL TRAINING FAC),4990,0,4990,3312,150.7,4887
9000,2017,10,"CRC (CAL REHAB CTR, MEN)",2552,0,2552,2491,102.4,3210
9001,2017,10,"COR (CA SP, CORCORAN)",3109,0,3109,3116,99.8,3496
9002,2017,10,CMF (CA MEDICAL FAC),2592,0,2592,2361,109.8,2789
9003,2017,10,CMC (CA MEN'S COLONY),4133,0,4133,3838,107.7,4401
9004,2017,10,CIM (CA INSTITUTION FOR MEN),3589,0,3589,2976,120.6,4186
9005,2017,10,CHCF (CA HEALTH CARE FAC - STOCKTON),2317,0,2317,2951,78.5,2951
9006,2017,10,CEN (CENTINELA SP),3506,0,3506,2308,151.9,3333
9007,2017,10,CCI (CA CORRECTIONAL INSTITUTION),3788,0,3788,2783,136.1,4120
9008,2017,10,CCC (CA CORRECTIONAL CENTER),4336,0,4336,3883,111.7,4667
9009,2017,10,CAL (CALIPATRIA SP),3748,0,3748,2308,162.4,3333
9010,2017,10,ASP (AVENAL SP),3862,0,3862,2920,132.3,4370
9011,2017,11,FOL (FOLSOM SP) (FEMALE),420,0,420,403,104.2,530
9012,2017,11,CIW (CA INSTITUTION FOR WOMEN),1848,0,1848,1398,132.2,1856
9013,2017,11,CCWF (CENTRAL CA WOMEN'S FAC),2924,0,2924,2004,145.9,2966
9014,2017,11,WSP (WASCO SP),5000,0,5000,2984,167.6,4351
9015,2017,11,VSP (VALLEY SP),3582,0,3582,1980,180.9,2954
9016,2017,11,SVSP (SALINAS VALLEY SP),3568,0,3568,2452,145.5,3409
9017,2017,11,SQ (SAN QUENTIN SP),4035,0,4035,3082,130.9,3988
9018,2017,11,"SOL (CA SP, SOLANO)",3754,0,3754,2610,143.8,3882
9019,2017,11,SCC (SIERRA CONSERVATION CENTER),4381,0,4381,3936,111.3,4660
9020,2017,11,SATF (CA SUBSTANCE ABUSE TREAT FAC),5687,0,5687,3424,166.1,5111
9021,2017,11,"SAC (CA SP, SACRAMENTO)",2091,0,2091,1828,114.4,2449
9022,2017,11,RJD (RJ DONOVAN CORRECTIONAL FAC),3918,0,3918,2992,130.9,3942
9023,2017,11,PVSP (PLEASANT VALLEY SP),2826,0,2826,2308,122.4,3333
9024,2017,11,PBSP (PELICAN BAY SP),2519,0,2519,2380,105.8,3250
9025,2017,11,NKSP (NORTH KERN SP),4377,0,4377,2694,162.5,3911
9026,2017,11,MCSP (MULE CREEK SP),3885,0,3885,3284,118.3,4001
9027,2017,11,"LAC (CA SP, LOS ANGELES COUNTY)",3379,0,3379,2300,146.9,3300
9028,2017,11,KVSP (KERN VALLEY SP),3719,0,3719,2448,151.9,3458
9029,2017,11,ISP (IRONWOOD SP),2990,0,2990,2200,135.9,3200
9030,2017,11,HDSP (HIGH DESERT SP),3446,0,3446,2324,148.3,3361
9031,2017,11,FOL (FOLSOM SP) (MALE),2467,0,2467,2066,119.4,2895
9032,2017,11,DVI (DEUEL VOCATIONAL INSTITUTION),2184,0,2184,1681,129.9,2353
9033,2017,11,CVSP (CHUCKAWALLA VALLEY SP),2858,0,2858,1738,164.4,2478
9034,2017,11,CTF (CORRECTIONAL TRAINING FAC),5058,0,5058,3312,152.7,4887
9035,2017,11,"CRC (CAL REHAB CTR, MEN)",2621,0,2621,2491,105.2,3210
9036,2017,11,"COR (CA SP, CORCORAN)",3034,0,3034,3116,97.4,3499
9037,2017,11,CMF (CA MEDICAL FAC),2569,0,2569,2361,108.8,2789
9038,2017,11,CMC (CA MEN'S COLONY),4098,0,4098,3838,106.8,4401
9039,2017,11,CIM (CA INSTITUTION FOR MEN),3517,0,3517,2976,118.2,4186
9040,2017,11,CHCF (CA HEALTH CARE FAC - STOCKTON),2383,0,2383,2951,80.8,2951
9041,2017,11,CEN (CENTINELA SP),3480,0,3480,2308,150.8,3333
9042,2017,11,CCI (CA CORRECTIONAL INSTITUTION),3824,0,3824,2783,137.4,4120
9043,2017,11,CCC (CA CORRECTIONAL CENTER),4430,0,4430,3883,114.1,4787
9044,2017,11,CAL (CALIPATRIA SP),3732,0,3732,2308,161.7,3333
9045,2017,11,ASP (AVENAL SP),3882,0,3882,2920,132.9,4370
9046,2017,12,FOL (FOLSOM SP) (FEMALE),407,0,407,403,101.0,530
9047,2017,12,CIW (CA INSTITUTION FOR WOMEN),1848,0,1848,1398,132.2,1856
9048,2017,12,CCWF (CENTRAL CA WOMEN'S FAC),2942,0,2942,2004,146.8,2966
9049,2017,12,WSP (WASCO SP),4991,0,4991,2984,167.3,4351
9050,2017,12,VSP (VALLEY SP),3604,0,3604,1980,182.0,2954
9051,2017,12,SVSP (SALINAS VALLEY SP),3597,0,3597,2452,146.7,3409
9052,2017,12,SQ (SAN QUENTIN SP),3921,0,3921,3082,127.2,3988
9053,2017,12,"SOL (CA SP, SOLANO)",3716,0,3716,2610,142.4,3882
9054,2017,12,SCC (SIERRA CONSERVATION CENTER),4322,0,4322,3936,109.8,4660
9055,2017,12,SATF (CA SUBSTANCE ABUSE TREAT FAC),5667,0,5667,3424,165.5,5111
9056,2017,12,"SAC (CA SP, SACRAMENTO)",2069,0,2069,1828,113.2,2449
9057,2017,12,RJD (RJ DONOVAN CORRECTIONAL FAC),3887,0,3887,2992,129.9,3942
9058,2017,12,PVSP (PLEASANT VALLEY SP),2877,0,2877,2308,124.7,3333
9059,2017,12,PBSP (PELICAN BAY SP),2572,0,2572,2380,108.1,3250
9060,2017,12,NKSP (NORTH KERN SP),4365,0,4365,2694,162.0,3911
9061,2017,12,MCSP (MULE CREEK SP),4024,0,4024,3284,122.5,4001
9062,2017,12,"LAC (CA SP, LOS ANGELES COUNTY)",3383,0,3383,2300,147.1,3300
9063,2017,12,KVSP (KERN VALLEY SP),3677,0,3677,2448,150.2,3458
9064,2017,12,ISP (IRONWOOD SP),2960,0,2960,2200,134.5,3200
9065,2017,12,HDSP (HIGH DESERT SP),3422,0,3422,2324,147.2,3361
9066,2017,12,FOL (FOLSOM SP) (MALE),2450,0,2450,2066,118.6,2895
9067,2017,12,DVI (DEUEL VOCATIONAL INSTITUTION),2180,0,2180,1681,129.7,2353
9068,2017,12,CVSP (CHUCKAWALLA VALLEY SP),2864,0,2864,1738,164.8,2478
9069,2017,12,CTF (CORRECTIONAL TRAINING FAC),5090,0,5090,3312,153.7,4887
9070,2017,12,"CRC (CAL REHAB CTR, MEN)",2578,0,2578,2491,103.5,3210
9071,2017,12,"COR (CA SP, CORCORAN)",2965,0,2965,3116,95.2,4267
9072,2017,12,CMF (CA MEDICAL FAC),2553,0,2553,2361,108.1,2789
9073,2017,12,CMC (CA MEN'S COLONY),3989,0,3989,3838,103.9,4401
9074,2017,12,CIM (CA INSTITUTION FOR MEN),3553,0,3553,2976,119.4,4186
9075,2017,12,CHCF (CA HEALTH CARE FAC - STOCKTON),2436,0,2436,2951,82.5,2951
9076,2017,12,CEN (CENTINELA SP),3426,0,3426,2308,148.4,3333
9077,2017,12,CCI (CA CORRECTIONAL INSTITUTION),3495,0,3495,2783,125.6,4120
9078,2017,12,CCC (CA CORRECTIONAL CENTER),4381,0,4381,3883,112.8,4667
9079,2017,12,CAL (CALIPATRIA SP),3744,0,3744,2308,162.2,3333
9080,2017,12,ASP (AVENAL SP),4103,0,4103,2920,140.5,3644
9081,2018,1,FOL (FOLSOM SP) (FEMALE),378,0,378,403,93.8,530
9082,2018,1,CIW (CA INSTITUTION FOR WOMEN),1837,0,1837,1398,131.4,1856
9083,2018,1,CCWF (CENTRAL CA WOMEN'S FAC),2941,0,2941,2004,146.8,2966
9084,2018,1,WSP (WASCO SP),4971,0,4971,2984,166.6,4351
9085,2018,1,VSP (VALLEY SP),3565,0,3565,1980,180.1,2954
9086,2018,1,SVSP (SALINAS VALLEY SP),3547,0,3547,2452,144.7,3409
9087,2018,1,SQ (SAN QUENTIN SP),3837,0,3837,3082,124.5,3988
9088,2018,1,"SOL (CA SP, SOLANO)",3765,0,3765,2610,144.3,3882
9089,2018,1,SCC (SIERRA CONSERVATION CENTER),4275,0,4275,3936,108.6,4660
9090,2018,1,SATF (CA SUBSTANCE ABUSE TREAT FAC),5621,0,5621,3424,164.2,5111
9091,2018,1,"SAC (CA SP, SACRAMENTO)",2122,0,2122,1828,116.1,2449
9092,2018,1,RJD (RJ DONOVAN CORRECTIONAL FAC),3874,0,3874,2992,129.5,3942
9093,2018,1,PVSP (PLEASANT VALLEY SP),2867,0,2867,2308,124.2,3333
9094,2018,1,PBSP (PELICAN BAY SP),2617,0,2617,2380,110.0,3250
9095,2018,1,NKSP (NORTH KERN SP),4320,0,4320,2694,160.4,3911
9096,2018,1,MCSP (MULE CREEK SP),4082,0,4082,3284,124.3,4001
9097,2018,1,"LAC (CA SP, LOS ANGELES COUNTY)",3344,0,3344,2300,145.4,3300
9098,2018,1,KVSP (KERN VALLEY SP),3592,0,3592,2448,146.7,3458
9099,2018,1,ISP (IRONWOOD SP),2805,0,2805,2200,127.5,3200
9100,2018,1,HDSP (HIGH DESERT SP),3415,0,3415,2324,146.9,3361
9101,2018,1,FOL (FOLSOM SP) (MALE),2426,0,2426,2066,117.4,2895
9102,2018,1,DVI (DEUEL VOCATIONAL INSTITUTION),2166,0,2166,1681,128.9,2353
9103,2018,1,CVSP (CHUCKAWALLA VALLEY SP),2885,0,2885,1738,166.0,2478
9104,2018,1,CTF (CORRECTIONAL TRAINING FAC),5139,0,5139,3312,155.2,4887
9105,2018,1,"CRC (CAL REHAB CTR, MEN)",2547,0,2547,2491,102.2,3210
9106,2018,1,"COR (CA SP, CORCORAN)",3069,0,3069,3116,98.5,4267
9107,2018,1,CMF (CA MEDICAL FAC),2475,0,2475,2361,104.8,2789
9108,2018,1,CMC (CA MEN'S COLONY),3936,0,3936,3838,102.6,4401
9109,2018,1,CIM (CA INSTITUTION FOR MEN),3503,0,3503,2976,117.7,4186
9110,2018,1,CHCF (CA HEALTH CARE FAC - STOCKTON),2480,0,2480,2951,84.0,2951
9111,2018,1,CEN (CENTINELA SP),3346,0,3346,2308,145.0,3333
9112,2018,1,CCI (CA CORRECTIONAL INSTITUTION),3381,0,3381,2783,121.5,4120
9113,2018,1,CCC (CA CORRECTIONAL CENTER),4443,0,4443,3883,114.4,4667
9114,2018,1,CAL (CALIPATRIA SP),3699,0,3699,2308,160.3,3333
9115,2018,1,ASP (AVENAL SP),4157,0,4157,2920,142.4,4370
9116,2018,2,FOL (FOLSOM SP) (FEMALE),399,0,399,403,99.0,530
9117,2018,2,CIW (CA INSTITUTION FOR WOMEN),1819,0,1819,1398,130.1,1856
9118,2018,2,CCWF (CENTRAL CA WOMEN'S FAC),2927,0,2927,2004,146.1,2966
9119,2018,2,WSP (WASCO SP),4969,0,4969,2984,166.5,4351
9120,2018,2,VSP (VALLEY SP),3517,0,3517,1980,177.6,2954
9121,2018,2,SVSP (SALINAS VALLEY SP),3490,0,3490,2452,142.3,3409
9122,2018,2,SQ (SAN QUENTIN SP),3746,0,3746,3082,121.5,3988
9123,2018,2,"SOL (CA SP, SOLANO)",3766,0,3766,2610,144.3,3882
9124,2018,2,SCC (SIERRA CONSERVATION CENTER),4269,0,4269,3936,108.5,4660
9125,2018,2,SATF (CA SUBSTANCE ABUSE TREAT FAC),5743,0,5743,3424,167.7,5111
9126,2018,2,"SAC (CA SP, SACRAMENTO)",2163,0,2163,1828,118.3,2449
9127,2018,2,RJD (RJ DONOVAN CORRECTIONAL FAC),3885,0,3885,2992,129.8,3942
9128,2018,2,PVSP (PLEASANT VALLEY SP),2887,0,2887,2308,125.1,3333
9129,2018,2,PBSP (PELICAN BAY SP),2657,0,2657,2380,111.6,3250
9130,2018,2,NKSP (NORTH KERN SP),4261,0,4261,2694,158.2,3911
9131,2018,2,MCSP (MULE CREEK SP),4127,0,4127,3284,125.7,4001
9132,2018,2,"LAC (CA SP, LOS ANGELES COUNTY)",3273,0,3273,2300,142.3,3300
9133,2018,2,KVSP (KERN VALLEY SP),3439,0,3439,2448,140.5,3522
9134,2018,2,ISP (IRONWOOD SP),2822,0,2822,2200,128.3,3200
9135,2018,2,HDSP (HIGH DESERT SP),3477,0,3477,2324,149.6,3361
9136,2018,2,FOL (FOLSOM SP) (MALE),2396,0,2396,2066,116.0,2895
9137,2018,2,DVI (DEUEL VOCATIONAL INSTITUTION),2219,0,2219,1681,132.0,2353
9138,2018,2,CVSP (CHUCKAWALLA VALLEY SP),2902,0,2902,1738,167.0,2478
9139,2018,2,CTF (CORRECTIONAL TRAINING FAC),5235,0,5235,3312,158.1,4887
9140,2018,2,"CRC (CAL REHAB CTR, MEN)",2502,0,2502,2491,100.4,3210
9141,2018,2,"COR (CA SP, CORCORAN)",3112,0,3112,3116,99.9,4267
9142,2018,2,CMF (CA MEDICAL FAC),2400,0,2400,2361,101.7,2789
9143,2018,2,CMC (CA MEN'S COLONY),3894,0,3894,3838,101.5,4401
9144,2018,2,CIM (CA INSTITUTION FOR MEN),3547,0,3547,2976,119.2,4186
9145,2018,2,CHCF (CA HEALTH CARE FAC - STOCKTON),2562,0,2562,2951,86.8,2951
9146,2018,2,CEN (CENTINELA SP),3318,0,3318,2308,143.8,3333
9147,2018,2,CCI (CA CORRECTIONAL INSTITUTION),3350,0,3350,2783,120.4,4120
9148,2018,2,CCC (CA CORRECTIONAL CENTER),4468,0,4468,3883,115.1,4667
9149,2018,2,CAL (CALIPATRIA SP),3685,0,3685,2308,159.7,3333
9150,2018,2,ASP (AVENAL SP),4237,0,4237,2920,145.1,4370
9151,2018,3,FOL (FOLSOM SP) (FEMALE),415,0,415,403,103.0,530
9152,2018,3,CIW (CA INSTITUTION FOR WOMEN),1802,0,1802,1398,128.9,1856
9153,2018,3,CCWF (CENTRAL CA WOMEN'S FAC),2944,0,2944,2004,146.9,2966
9154,2018,3,WSP (WASCO SP),5090,0,5090,2984,170.6,4351
9155,2018,3,VSP (VALLEY SP),3500,0,3500,1980,176.8,2954
9156,2018,3,SVSP (SALINAS VALLEY SP),3439,0,3439,2452,140.3,3409
9157,2018,3,SQ (SAN QUENTIN SP),3619,0,3619,3082,117.4,3988
9158,2018,3,"SOL (CA SP, SOLANO)",3865,0,3865,2610,148.1,3882
9159,2018,3,SCC (SIERRA CONSERVATION CENTER),4289,0,4289,3936,109.0,4660
9160,2018,3,SATF (CA SUBSTANCE ABUSE TREAT FAC),5842,0,5842,3424,170.6,5111
9161,2018,3,"SAC (CA SP, SACRAMENTO)",2169,0,2169,1828,118.7,2449
9162,2018,3,RJD (RJ DONOVAN CORRECTIONAL FAC),3905,0,3905,2992,130.5,3942
9163,2018,3,PVSP (PLEASANT VALLEY SP),2877,0,2877,2308,124.7,3333
9164,2018,3,PBSP (PELICAN BAY SP),2682,0,2682,2380,112.7,3250
9165,2018,3,NKSP (NORTH KERN SP),4230,0,4230,2694,157.0,3911
9166,2018,3,MCSP (MULE CREEK SP),4185,0,4185,3284,127.4,4001
9167,2018,3,"LAC (CA SP, LOS ANGELES COUNTY)",3234,0,3234,2300,140.6,3300
9168,2018,3,KVSP (KERN VALLEY SP),3416,0,3416,2448,139.5,3522
9169,2018,3,ISP (IRONWOOD SP),2825,0,2825,2200,128.4,3200
9170,2018,3,HDSP (HIGH DESERT SP),3480,0,3480,2324,149.7,3361
9171,2018,3,FOL (FOLSOM SP) (MALE),2392,0,2392,2066,115.8,2895
9172,2018,3,DVI (DEUEL VOCATIONAL INSTITUTION),2244,0,2244,1681,133.5,2353
9173,2018,3,CVSP (CHUCKAWALLA VALLEY SP),3009,0,3009,1738,173.1,2478
9174,2018,3,CTF (CORRECTIONAL TRAINING FAC),5333,0,5333,3312,161.0,4887
9175,2018,3,"CRC (CAL REHAB CTR, MEN)",2502,0,2502,2491,100.4,3210
9176,2018,3,"COR (CA SP, CORCORAN)",3140,0,3140,3116,100.8,4267
9177,2018,3,CMF (CA MEDICAL FAC),2365,0,2365,2361,100.2,2789
9178,2018,3,CMC (CA MEN'S COLONY),3845,0,3845,3838,100.2,4401
9179,2018,3,CIM (CA INSTITUTION FOR MEN),3608,0,3608,2976,121.2,4186
9180,2018,3,CHCF (CA HEALTH CARE FAC - STOCKTON),2616,0,2616,2951,88.6,2951
9181,2018,3,CEN (CENTINELA SP),3377,0,3377,2308,146.3,3333
9182,2018,3,CCI (CA CORRECTIONAL INSTITUTION),3292,0,3292,2783,118.3,4120
9183,2018,3,CCC (CA CORRECTIONAL CENTER),4530,0,4530,3883,116.7,4667
9184,2018,3,CAL (CALIPATRIA SP),3659,0,3659,2308,158.5,3333
9185,2018,3,ASP (AVENAL SP),4281,0,4281,2920,146.6,4370
9186,2018,4,FOL (FOLSOM SP) (FEMALE),417,0,417,403,103.5,530
9187,2018,4,CIW (CA INSTITUTION FOR WOMEN),1849,0,1849,1398,132.3,1856
9188,2018,4,CCWF (CENTRAL CA WOMEN'S FAC),2876,0,2876,2004,143.5,2966
9189,2018,4,WSP (WASCO SP),4848,0,4848,2984,162.5,4351
9190,2018,4,VSP (VALLEY SP),3511,0,3511,1980,177.3,2954
9191,2018,4,SVSP (SALINAS VALLEY SP),3353,0,3353,2452,136.7,3409
9192,2018,4,SQ (SAN QUENTIN SP),3543,0,3543,3082,115.0,3988
9193,2018,4,"SOL (CA SP, SOLANO)",3929,0,3929,2610,150.5,3882
9194,2018,4,SCC (SIERRA CONSERVATION CENTER),4207,0,4207,3936,106.9,4660
9195,2018,4,SATF (CA SUBSTANCE ABUSE TREAT FAC),5980,0,5980,3424,174.6,5111
9196,2018,4,"SAC (CA SP, SACRAMENTO)",2148,0,2148,1828,117.5,2449
9197,2018,4,RJD (RJ DONOVAN CORRECTIONAL FAC),3903,0,3903,2992,130.4,3942
9198,2018,4,PVSP (PLEASANT VALLEY SP),2889,0,2889,2308,125.2,3333
9199,2018,4,PBSP (PELICAN BAY SP),2678,0,2678,2380,112.5,3250
9200,2018,4,NKSP (NORTH KERN SP),4546,0,4546,2694,168.7,3911
9201,2018,4,MCSP (MULE CREEK SP),4223,0,4223,3284,128.6,4009
9202,2018,4,"LAC (CA SP, LOS ANGELES COUNTY)",3206,0,3206,2300,139.4,3300
9203,2018,4,KVSP (KERN VALLEY SP),3394,0,3394,2448,138.6,3522
9204,2018,4,ISP (IRONWOOD SP),2887,0,2887,2200,131.2,3200
9205,2018,4,HDSP (HIGH DESERT SP),3460,0,3460,2324,148.9,3361
9206,2018,4,FOL (FOLSOM SP) (MALE),2378,0,2378,2066,115.1,2895
9207,2018,4,DVI (DEUEL VOCATIONAL INSTITUTION),2319,0,2319,1681,138.0,2353
9208,2018,4,CVSP (CHUCKAWALLA VALLEY SP),3018,0,3018,1738,173.6,2478
9209,2018,4,CTF (CORRECTIONAL TRAINING FAC),5289,0,5289,3312,159.7,4887
9210,2018,4,"CRC (CAL REHAB CTR, MEN)",2452,0,2452,2491,98.4,3210
9211,2018,4,"COR (CA SP, CORCORAN)",3172,0,3172,3116,101.8,4270
9212,2018,4,CMF (CA MEDICAL FAC),2401,0,2401,2361,101.7,2789
9213,2018,4,CMC (CA MEN'S COLONY),3807,0,3807,3838,99.2,4401
9214,2018,4,CIM (CA INSTITUTION FOR MEN),3492,0,3492,2976,117.3,4186
9215,2018,4,CHCF (CA HEALTH CARE FAC - STOCKTON),2631,0,2631,2951,89.2,2951
9216,2018,4,CEN (CENTINELA SP),3388,0,3388,2308,146.8,3333
9217,2018,4,CCI (CA CORRECTIONAL INSTITUTION),3232,0,3232,2783,116.1,4120
9218,2018,4,CCC (CA CORRECTIONAL CENTER),4536,0,4536,3883,116.8,4667
9219,2018,4,CAL (CALIPATRIA SP),3637,0,3637,2308,157.6,3333
9220,2018,4,ASP (AVENAL SP),4251,0,4251,2920,145.6,4370
9221,2018,5,FOL (FOLSOM SP) (FEMALE),414,0,414,403,102.7,530
9222,2018,5,CIW (CA INSTITUTION FOR WOMEN),1824,0,1824,1398,130.5,1856
9223,2018,5,CCWF (CENTRAL CA WOMEN'S FAC),2904,0,2904,2004,144.9,2966
9224,2018,5,WSP (WASCO SP),4938,0,4938,2984,165.5,4351
9225,2018,5,VSP (VALLEY SP),3507,0,3507,1980,177.1,2954
9226,2018,5,SVSP (SALINAS VALLEY SP),3264,0,3264,2452,133.1,3409
9227,2018,5,SQ (SAN QUENTIN SP),3905,0,3905,3082,126.7,3988
9228,2018,5,"SOL (CA SP, SOLANO)",3952,0,3952,2610,151.4,3882
9229,2018,5,SCC (SIERRA CONSERVATION CENTER),4266,0,4266,3936,108.4,4660
9230,2018,5,SATF (CA SUBSTANCE ABUSE TREAT FAC),6006,0,6006,3424,175.4,5111
9231,2018,5,"SAC (CA SP, SACRAMENTO)",2182,0,2182,1828,119.4,2449
9232,2018,5,RJD (RJ DONOVAN CORRECTIONAL FAC),3873,0,3873,2992,129.4,3942
9233,2018,5,PVSP (PLEASANT VALLEY SP),2898,0,2898,2308,125.6,3333
9234,2018,5,PBSP (PELICAN BAY SP),2664,0,2664,2380,111.9,3250
9235,2018,5,NKSP (NORTH KERN SP),4511,0,4511,2694,167.4,3911
9236,2018,5,MCSP (MULE CREEK SP),4256,0,4256,3284,129.6,4009
9237,2018,5,"LAC (CA SP, LOS ANGELES COUNTY)",3205,0,3205,2300,139.3,3300
9238,2018,5,KVSP (KERN VALLEY SP),3445,0,3445,2448,140.7,3522
9239,2018,5,ISP (IRONWOOD SP),2944,0,2944,2200,133.8,3200
9240,2018,5,HDSP (HIGH DESERT SP),3429,0,3429,2324,147.5,3361
9241,2018,5,FOL (FOLSOM SP) (MALE),2351,0,2351,2066,113.8,2895
9242,2018,5,DVI (DEUEL VOCATIONAL INSTITUTION),2198,0,2198,1681,130.8,2353
9243,2018,5,CVSP (CHUCKAWALLA VALLEY SP),2980,0,2980,1738,171.5,2478
9244,2018,5,CTF (CORRECTIONAL TRAINING FAC),5306,0,5306,3312,160.2,4887
9245,2018,5,"CRC (CAL REHAB CTR, MEN)",2391,0,2391,2491,96.0,3210
9246,2018,5,"COR (CA SP, CORCORAN)",3152,0,3152,3116,101.2,4270
9247,2018,5,CMF (CA MEDICAL FAC),2450,0,2450,2361,103.8,2789
9248,2018,5,CMC (CA MEN'S COLONY),3807,0,3807,3838,99.2,4379
9249,2018,5,CIM (CA INSTITUTION FOR MEN),3580,0,3580,2976,120.3,4186
9250,2018,5,CHCF (CA HEALTH CARE FAC - STOCKTON),2664,0,2664,2951,90.3,2951
9251,2018,5,CEN (CENTINELA SP),3398,0,3398,2308,147.2,3333
9252,2018,5,CCI (CA CORRECTIONAL INSTITUTION),3252,0,3252,2783,116.9,4120
9253,2018,5,CCC (CA CORRECTIONAL CENTER),4608,0,4608,3883,118.7,4667
9254,2018,5,CAL (CALIPATRIA SP),3629,0,3629,2308,157.2,3333
9255,2018,5,ASP (AVENAL SP),4321,0,4321,2920,148.0,4370
9256,2018,6,FOL (FOLSOM SP) (FEMALE),432,0,432,403,107.2,530
9257,2018,6,CIW (CA INSTITUTION FOR WOMEN),1828,0,1828,1398,130.8,1856
9258,2018,6,CCWF (CENTRAL CA WOMEN'S FAC),2911,0,2911,2004,145.3,2966
9259,2018,6,WSP (WASCO SP),5030,0,5030,2984,168.6,4351
9260,2018,6,VSP (VALLEY SP),3487,0,3487,1980,176.1,2954
9261,2018,6,SVSP (SALINAS VALLEY SP),3190,0,3190,2452,130.1,3409
9262,2018,6,SQ (SAN QUENTIN SP),4134,0,4134,3082,134.1,3988
9263,2018,6,"SOL (CA SP, SOLANO)",3993,0,3993,2610,153.0,3882
9264,2018,6,SCC (SIERRA CONSERVATION CENTER),4252,0,4252,3936,108.0,4660
9265,2018,6,SATF (CA SUBSTANCE ABUSE TREAT FAC),5926,0,5926,3424,173.1,5111
9266,2018,6,"SAC (CA SP, SACRAMENTO)",2155,0,2155,1828,117.9,2449
9267,2018,6,RJD (RJ DONOVAN CORRECTIONAL FAC),3915,0,3915,2992,130.8,3942
9268,2018,6,PVSP (PLEASANT VALLEY SP),2966,0,2966,2308,128.5,3333
9269,2018,6,PBSP (PELICAN BAY SP),2641,0,2641,2380,111.0,3250
9270,2018,6,NKSP (NORTH KERN SP),4310,0,4310,2694,160.0,3911
9271,2018,6,MCSP (MULE CREEK SP),4301,0,4301,3284,131.0,4009
9272,2018,6,"LAC (CA SP, LOS ANGELES COUNTY)",3122,0,3122,2300,135.7,3300
9273,2018,6,KVSP (KERN VALLEY SP),3526,0,3526,2448,144.0,3522
9274,2018,6,ISP (IRONWOOD SP),2904,0,2904,2200,132.0,3200
9275,2018,6,HDSP (HIGH DESERT SP),3420,0,3420,2324,147.2,3361
9276,2018,6,FOL (FOLSOM SP) (MALE),2301,0,2301,2066,111.4,2895
9277,2018,6,DVI (DEUEL VOCATIONAL INSTITUTION),2206,0,2206,1681,131.2,2353
9278,2018,6,CVSP (CHUCKAWALLA VALLEY SP),2946,0,2946,1738,169.5,2478
9279,2018,6,CTF (CORRECTIONAL TRAINING FAC),5310,0,5310,3312,160.3,4887
9280,2018,6,"CRC (CAL REHAB CTR, MEN)",2420,0,2420,2491,97.1,3210
9281,2018,6,"COR (CA SP, CORCORAN)",3199,0,3199,3116,102.7,4270
9282,2018,6,CMF (CA MEDICAL FAC),2448,0,2448,2361,103.7,2789
9283,2018,6,CMC (CA MEN'S COLONY),3911,0,3911,3838,101.9,4379
9284,2018,6,CIM (CA INSTITUTION FOR MEN),3633,0,3633,2976,122.1,4186
9285,2018,6,CHCF (CA HEALTH CARE FAC - STOCKTON),2683,0,2683,2951,90.9,2951
9286,2018,6,CEN (CENTINELA SP),3379,0,3379,2308,146.4,3333
9287,2018,6,CCI (CA CORRECTIONAL INSTITUTION),3331,0,3331,2783,119.7,4120
9288,2018,6,CCC (CA CORRECTIONAL CENTER),4711,0,4711,3883,121.3,4667
9289,2018,6,CAL (CALIPATRIA SP),3618,0,3618,2308,156.8,3333
9290,2018,6,ASP (AVENAL SP),4326,0,4326,2920,148.2,4370
9291,2018,7,FOL (FOLSOM SP) (FEMALE),448,0,448,403,111.2,530
9292,2018,7,CIW (CA INSTITUTION FOR WOMEN),1840,0,1840,1398,131.6,1856
9293,2018,7,CCWF (CENTRAL CA WOMEN'S FAC),2886,0,2886,2004,144.0,2966
9294,2018,7,WSP (WASCO SP),4994,0,4994,2984,167.4,4351
9295,2018,7,VSP (VALLEY SP),3459,0,3459,1980,174.7,2954
9296,2018,7,SVSP (SALINAS VALLEY SP),3166,0,3166,2452,129.1,3409
9297,2018,7,SQ (SAN QUENTIN SP),4408,0,4408,3082,143.0,3988
9298,2018,7,"SOL (CA SP, SOLANO)",4044,0,4044,2610,154.9,3882
9299,2018,7,SCC (SIERRA CONSERVATION CENTER),4253,0,4253,3936,108.1,4660
9300,2018,7,SATF (CA SUBSTANCE ABUSE TREAT FAC),5853,0,5853,3424,170.9,5111
9301,2018,7,"SAC (CA SP, SACRAMENTO)",2156,0,2156,1828,117.9,2449
9302,2018,7,RJD (RJ DONOVAN CORRECTIONAL FAC),3895,0,3895,2992,130.2,3942
9303,2018,7,PVSP (PLEASANT VALLEY SP),3028,0,3028,2308,131.2,3333
9304,2018,7,PBSP (PELICAN BAY SP),2624,0,2624,2380,110.3,3250
9305,2018,7,NKSP (NORTH KERN SP),4378,0,4378,2694,162.5,3911
9306,2018,7,MCSP (MULE CREEK SP),4208,0,4208,3284,128.1,4009
9307,2018,7,"LAC (CA SP, LOS ANGELES COUNTY)",3172,0,3172,2300,137.9,3300
9308,2018,7,KVSP (KERN VALLEY SP),3555,0,3555,2448,145.2,3522
9309,2018,7,ISP (IRONWOOD SP),3065,0,3065,2200,139.3,3200
9310,2018,7,HDSP (HIGH DESERT SP),3464,0,3464,2324,149.1,3361
9311,2018,7,FOL (FOLSOM SP) (MALE),2371,0,2371,2066,114.8,2895
9312,2018,7,DVI (DEUEL VOCATIONAL INSTITUTION),2037,0,2037,1681,121.2,2353
9313,2018,7,CVSP (CHUCKAWALLA VALLEY SP),2904,0,2904,1738,167.1,2478
9314,2018,7,CTF (CORRECTIONAL TRAINING FAC),5335,0,5335,3312,161.1,4887
9315,2018,7,"CRC (CAL REHAB CTR, MEN)",2469,0,2469,2491,99.1,3210
9316,2018,7,"COR (CA SP, CORCORAN)",3232,0,3232,3116,103.7,4270
9317,2018,7,CMF (CA MEDICAL FAC),2400,0,2400,2361,101.7,2789
9318,2018,7,CMC (CA MEN'S COLONY),3894,0,3894,3838,101.5,4379
9319,2018,7,CIM (CA INSTITUTION FOR MEN),3730,0,3730,2976,125.3,4186
9320,2018,7,CHCF (CA HEALTH CARE FAC - STOCKTON),2719,0,2719,2951,92.1,2951
9321,2018,7,CEN (CENTINELA SP),3346,0,3346,2308,145.0,3333
9322,2018,7,CCI (CA CORRECTIONAL INSTITUTION),3339,0,3339,2783,120.0,4120
9323,2018,7,CCC (CA CORRECTIONAL CENTER),4727,0,4727,3883,121.7,4667
9324,2018,7,CAL (CALIPATRIA SP),3566,0,3566,2308,154.5,3333
9325,2018,7,ASP (AVENAL SP),4326,0,4326,2920,148.2,4370
9326,2018,8,FOL (FOLSOM SP) (FEMALE),449,0,449,403,111.4,530
9327,2018,8,CIW (CA INSTITUTION FOR WOMEN),1882,0,1882,1398,134.6,1856
9328,2018,8,CCWF (CENTRAL CA WOMEN'S FAC),2890,0,2890,2004,144.2,2966
9329,2018,8,WSP (WASCO SP),4804,0,4804,2984,161.0,4351
9330,2018,8,VSP (VALLEY SP),3572,0,3572,1980,180.4,2954
9331,2018,8,SVSP (SALINAS VALLEY SP),3244,0,3244,2452,132.3,3409
9332,2018,8,SQ (SAN QUENTIN SP),4406,0,4406,3082,143.0,3988
9333,2018,8,"SOL (CA SP, SOLANO)",4073,0,4073,2610,156.1,3882
9334,2018,8,SCC (SIERRA CONSERVATION CENTER),4290,0,4290,3936,109.0,4660
9335,2018,8,SATF (CA SUBSTANCE ABUSE TREAT FAC),5852,0,5852,3424,170.9,5111
9336,2018,8,"SAC (CA SP, SACRAMENTO)",2138,0,2138,1828,117.0,2449
9337,2018,8,RJD (RJ DONOVAN CORRECTIONAL FAC),3983,0,3983,2992,133.1,3942
9338,2018,8,PVSP (PLEASANT VALLEY SP),3123,0,3123,2308,135.3,3333
9339,2018,8,PBSP (PELICAN BAY SP),2611,0,2611,2380,109.7,3250
9340,2018,8,NKSP (NORTH KERN SP),4139,0,4139,2694,153.6,3911
9341,2018,8,MCSP (MULE CREEK SP),4161,0,4161,3284,126.7,4009
9342,2018,8,"LAC (CA SP, LOS ANGELES COUNTY)",3164,0,3164,2300,137.6,3300
9343,2018,8,KVSP (KERN VALLEY SP),3652,0,3652,2448,149.2,3522
9344,2018,8,ISP (IRONWOOD SP),3114,0,3114,2200,141.5,3200
9345,2018,8,HDSP (HIGH DESERT SP),3396,0,3396,2324,146.1,3361
9346,2018,8,FOL (FOLSOM SP) (MALE),2432,0,2432,2066,117.7,2895
9347,2018,8,DVI (DEUEL VOCATIONAL INSTITUTION),1929,0,1929,1681,114.8,2353
9348,2018,8,CVSP (CHUCKAWALLA VALLEY SP),2927,0,2927,1738,168.4,2478
9349,2018,8,CTF (CORRECTIONAL TRAINING FAC),5287,0,5287,3312,159.6,4887
9350,2018,8,"CRC (CAL REHAB CTR, MEN)",2491,0,2491,2491,100.0,3210
9351,2018,8,"COR (CA SP, CORCORAN)",3171,0,3171,3116,101.8,4270
9352,2018,8,CMF (CA MEDICAL FAC),2384,0,2384,2361,101.0,2789
9353,2018,8,CMC (CA MEN'S COLONY),4021,0,4021,3838,104.8,4379
9354,2018,8,CIM (CA INSTITUTION FOR MEN),3815,0,3815,2976,128.2,4186
9355,2018,8,CHCF (CA HEALTH CARE FAC - STOCKTON),2704,0,2704,2951,91.6,2951
9356,2018,8,CEN (CENTINELA SP),3354,0,3354,2308,145.3,3333
9357,2018,8,CCI (CA CORRECTIONAL INSTITUTION),3410,0,3410,2783,122.5,4120
9358,2018,8,CCC (CA CORRECTIONAL CENTER),4888,0,4888,3883,125.9,4667
9359,2018,8,CAL (CALIPATRIA SP),3457,0,3457,2308,149.8,3333
9360,2018,8,ASP (AVENAL SP),4346,0,4346,2920,148.8,4370
9361,2018,9,FOL (FOLSOM SP) (FEMALE),401,0,401,403,99.5,530
9362,2018,9,CIW (CA INSTITUTION FOR WOMEN),1886,0,1886,1398,134.9,1877
9363,2018,9,CCWF (CENTRAL CA WOMEN'S FAC),2873,0,2873,2004,143.4,2966
9364,2018,9,WSP (WASCO SP),4702,0,4702,2984,157.6,4351
9365,2018,9,VSP (VALLEY SP),3578,0,3578,1980,180.7,2954
9366,2018,9,SVSP (SALINAS VALLEY SP),3313,0,3313,2452,135.1,3409
9367,2018,9,SQ (SAN QUENTIN SP),4365,0,4365,3082,141.6,3988
9368,2018,9,"SOL (CA SP, SOLANO)",4110,0,4110,2610,157.5,3882
9369,2018,9,SCC (SIERRA CONSERVATION CENTER),4291,0,4291,3936,109.0,4560
9370,2018,9,SATF (CA SUBSTANCE ABUSE TREAT FAC),5819,0,5819,3424,169.9,5111
9371,2018,9,"SAC (CA SP, SACRAMENTO)",2075,0,2075,1828,113.5,2449
9372,2018,9,RJD (RJ DONOVAN CORRECTIONAL FAC),3951,0,3951,2992,132.1,3942
9373,2018,9,PVSP (PLEASANT VALLEY SP),3249,0,3249,2308,140.8,3333
9374,2018,9,PBSP (PELICAN BAY SP),2576,0,2576,2380,108.2,3250
9375,2018,9,NKSP (NORTH KERN SP),4003,0,4003,2694,148.6,3911
9376,2018,9,MCSP (MULE CREEK SP),4111,0,4111,3284,125.2,4009
9377,2018,9,"LAC (CA SP, LOS ANGELES COUNTY)",3162,0,3162,2300,137.5,3300
9378,2018,9,KVSP (KERN VALLEY SP),3653,0,3653,2448,149.2,3522
9379,2018,9,ISP (IRONWOOD SP),3047,0,3047,2200,138.5,3200
9380,2018,9,HDSP (HIGH DESERT SP),3343,0,3343,2324,143.8,3361
9381,2018,9,FOL (FOLSOM SP) (MALE),2552,0,2552,2066,123.5,2895
9382,2018,9,DVI (DEUEL VOCATIONAL INSTITUTION),1847,0,1847,1681,109.9,2353
9383,2018,9,CVSP (CHUCKAWALLA VALLEY SP),2910,0,2910,1738,167.4,2478
9384,2018,9,CTF (CORRECTIONAL TRAINING FAC),5317,0,5317,3312,160.5,4887
9385,2018,9,"CRC (CAL REHAB CTR, MEN)",2437,0,2437,2491,97.8,3210
9386,2018,9,"COR (CA SP, CORCORAN)",3193,0,3193,3116,102.5,4270
9387,2018,9,CMF (CA MEDICAL FAC),2393,0,2393,2361,101.4,2789
9388,2018,9,CMC (CA MEN'S COLONY),3948,0,3948,3838,102.9,4379
9389,2018,9,CIM (CA INSTITUTION FOR MEN),3781,0,3781,2976,127.0,4186
9390,2018,9,CHCF (CA HEALTH CARE FAC - STOCKTON),2700,0,2700,2951,91.5,2951
9391,2018,9,CEN (CENTINELA SP),3408,0,3408,2308,147.7,3333
9392,2018,9,CCI (CA CORRECTIONAL INSTITUTION),3600,0,3600,2783,129.4,4120
9393,2018,9,CCC (CA CORRECTIONAL CENTER),4886,0,4886,3883,125.8,4667
9394,2018,9,CAL (CALIPATRIA SP),3447,0,3447,2308,149.4,3333
9395,2018,9,ASP (AVENAL SP),4294,0,4294,2920,147.1,4370
9396,2018,10,FOL (FOLSOM SP) (FEMALE),439,0,439,403,108.9,530
9397,2018,10,CIW (CA INSTITUTION FOR WOMEN),1863,0,1863,1398,133.3,1856
9398,2018,10,CCWF (CENTRAL CA WOMEN'S FAC),2888,0,2888,2004,144.1,2966
9399,2018,10,WSP (WASCO SP),4982,0,4982,2984,167.0,4351
9400,2018,10,VSP (VALLEY SP),3481,0,3481,1980,175.8,2954
9401,2018,10,SVSP (SALINAS VALLEY SP),3328,0,3328,2452,135.7,3409
9402,2018,10,SQ (SAN QUENTIN SP),4432,0,4432,3082,143.8,3988
9403,2018,10,"SOL (CA SP, SOLANO)",4055,0,4055,2610,155.4,3882
9404,2018,10,SCC (SIERRA CONSERVATION CENTER),4308,0,4308,3936,109.5,4560
9405,2018,10,SATF (CA SUBSTANCE ABUSE TREAT FAC),5678,0,5678,3424,165.8,5111
9406,2018,10,"SAC (CA SP, SACRAMENTO)",2039,0,2039,1828,111.5,2449
9407,2018,10,RJD (RJ DONOVAN CORRECTIONAL FAC),3912,0,3912,2992,130.7,3942
9408,2018,10,PVSP (PLEASANT VALLEY SP),3266,0,3266,2308,141.5,3333
9409,2018,10,PBSP (PELICAN BAY SP),2548,0,2548,2380,107.1,3250
9410,2018,10,NKSP (NORTH KERN SP),4105,0,4105,2694,152.4,3911
9411,2018,10,MCSP (MULE CREEK SP),4025,0,4025,3284,122.6,4009
9412,2018,10,"LAC (CA SP, LOS ANGELES COUNTY)",3172,0,3172,2300,137.9,3300
9413,2018,10,KVSP (KERN VALLEY SP),3681,0,3681,2448,150.4,3522
9414,2018,10,ISP (IRONWOOD SP),3062,0,3062,2200,139.2,3200
9415,2018,10,HDSP (HIGH DESERT SP),3301,0,3301,2324,142.0,3361
9416,2018,10,FOL (FOLSOM SP) (MALE),2685,0,2685,2066,130.0,2895
9417,2018,10,DVI (DEUEL VOCATIONAL INSTITUTION),1926,0,1926,1681,114.6,2353
9418,2018,10,CVSP (CHUCKAWALLA VALLEY SP),2759,0,2759,1738,158.7,2478
9419,2018,10,CTF (CORRECTIONAL TRAINING FAC),5329,0,5329,3312,160.9,4887
9420,2018,10,"CRC (CAL REHAB CTR, MEN)",2113,0,2113,2491,84.8,3210
9421,2018,10,"COR (CA SP, CORCORAN)",3231,0,3231,3116,103.7,4270
9422,2018,10,CMF (CA MEDICAL FAC),2367,0,2367,2361,100.3,2789
9423,2018,10,CMC (CA MEN'S COLONY),3853,0,3853,3838,100.4,4379
9424,2018,10,CIM (CA INSTITUTION FOR MEN),3529,0,3529,2976,118.6,4186
9425,2018,10,CHCF (CA HEALTH CARE FAC - STOCKTON),2685,0,2685,2951,91.0,2951
9426,2018,10,CEN (CENTINELA SP),3420,0,3420,2308,148.2,3333
9427,2018,10,CCI (CA CORRECTIONAL INSTITUTION),3797,0,3797,2783,136.4,4120
9428,2018,10,CCC (CA CORRECTIONAL CENTER),4787,0,4787,3883,123.3,4667
9429,2018,10,CAL (CALIPATRIA SP),3440,0,3440,2308,149.0,3333
9430,2018,10,ASP (AVENAL SP),4306,0,4306,2920,147.5,4370
9431,2018,11,FOL (FOLSOM SP) (FEMALE),421,0,421,403,104.5,530
9432,2018,11,CIW (CA INSTITUTION FOR WOMEN),1910,0,1910,1398,136.6,1756
9433,2018,11,CCWF (CENTRAL CA WOMEN'S FAC),2857,0,2857,2004,142.6,2966
9434,2018,11,WSP (WASCO SP),4721,0,4721,2984,158.2,4351
9435,2018,11,VSP (VALLEY SP),3297,0,3297,1980,166.5,2954
9436,2018,11,SVSP (SALINAS VALLEY SP),3388,0,3388,2452,138.2,3409
9437,2018,11,SQ (SAN QUENTIN SP),4247,0,4247,3082,137.8,3988
9438,2018,11,"SOL (CA SP, SOLANO)",4159,0,4159,2610,159.3,3882
9439,2018,11,SCC (SIERRA CONSERVATION CENTER),4255,0,4255,3936,108.1,4560
9440,2018,11,SATF (CA SUBSTANCE ABUSE TREAT FAC),5631,0,5631,3424,164.5,5111
9441,2018,11,"SAC (CA SP, SACRAMENTO)",2051,0,2051,1828,112.2,2449
9442,2018,11,RJD (RJ DONOVAN CORRECTIONAL FAC),3917,0,3917,2992,130.9,3942
9443,2018,11,PVSP (PLEASANT VALLEY SP),3232,0,3232,2308,140.0,3333
9444,2018,11,PBSP (PELICAN BAY SP),2570,0,2570,2380,108.0,3250
9445,2018,11,NKSP (NORTH KERN SP),4066,0,4066,2694,150.9,3911
9446,2018,11,MCSP (MULE CREEK SP),3995,0,3995,3284,121.7,4009
9447,2018,11,"LAC (CA SP, LOS ANGELES COUNTY)",3150,0,3150,2300,137.0,3300
9448,2018,11,KVSP (KERN VALLEY SP),3703,0,3703,2448,151.3,3522
9449,2018,11,ISP (IRONWOOD SP),2987,0,2987,2200,135.8,3200
9450,2018,11,HDSP (HIGH DESERT SP),3325,0,3325,2324,143.1,3361
9451,2018,11,FOL (FOLSOM SP) (MALE),2831,0,2831,2066,137.0,2895
9452,2018,11,DVI (DEUEL VOCATIONAL INSTITUTION),2102,0,2102,1681,125.0,2353
9453,2018,11,CVSP (CHUCKAWALLA VALLEY SP),2732,0,2732,1738,157.2,2478
9454,2018,11,CTF (CORRECTIONAL TRAINING FAC),5167,0,5167,3312,156.0,4887
9455,2018,11,"CRC (CAL REHAB CTR, MEN)",2262,0,2262,2491,90.8,3210
9456,2018,11,"COR (CA SP, CORCORAN)",3332,0,3332,3116,106.9,4270
9457,2018,11,CMF (CA MEDICAL FAC),2357,0,2357,2361,99.8,2789
9458,2018,11,CMC (CA MEN'S COLONY),3731,0,3731,3838,97.2,4401
9459,2018,11,CIM (CA INSTITUTION FOR MEN),3572,0,3572,2976,120.0,4186
9460,2018,11,CHCF (CA HEALTH CARE FAC - STOCKTON),2667,0,2667,2951,90.4,2951
9461,2018,11,CEN (CENTINELA SP),3428,0,3428,2308,148.5,3333
9462,2018,11,CCI (CA CORRECTIONAL INSTITUTION),4000,0,4000,2783,143.7,4120
9463,2018,11,CCC (CA CORRECTIONAL CENTER),4607,0,4607,3883,118.6,4667
9464,2018,11,CAL (CALIPATRIA SP),3490,0,3490,2308,151.2,3333
9465,2018,11,ASP (AVENAL SP),4247,0,4247,2920,145.4,4370
9466,2018,12,FOL (FOLSOM SP) (FEMALE),406,0,406,403,100.7,530
9467,2018,12,CIW (CA INSTITUTION FOR WOMEN),1898,0,1898,1398,135.8,1877
9468,2018,12,CCWF (CENTRAL CA WOMEN'S FAC),2814,0,2814,2004,140.4,2964
9469,2018,12,WSP (WASCO SP),4735,0,4735,2984,158.7,4351
9470,2018,12,VSP (VALLEY SP),3238,0,3238,1980,163.5,2954
9471,2018,12,SVSP (SALINAS VALLEY SP),3362,0,3362,2452,137.1,3409
9472,2018,12,SQ (SAN QUENTIN SP),4023,0,4023,3082,130.5,3984
9473,2018,12,"SOL (CA SP, SOLANO)",4205,0,4205,2610,161.1,3882
9474,2018,12,SCC (SIERRA CONSERVATION CENTER),4255,0,4255,3936,108.1,4570
9475,2018,12,SATF (CA SUBSTANCE ABUSE TREAT FAC),5614,0,5614,3424,164.0,5111
9476,2018,12,"SAC (CA SP, SACRAMENTO)",2064,0,2064,1828,112.9,2449
9477,2018,12,RJD (RJ DONOVAN CORRECTIONAL FAC),3854,0,3854,2992,128.8,3942
9478,2018,12,PVSP (PLEASANT VALLEY SP),3116,0,3116,2308,135.0,3333
9479,2018,12,PBSP (PELICAN BAY SP),2555,0,2555,2380,107.4,3250
9480,2018,12,NKSP (NORTH KERN SP),4092,0,4092,2694,151.9,3911
9481,2018,12,MCSP (MULE CREEK SP),3963,0,3963,3284,120.7,4009
9482,2018,12,"LAC (CA SP, LOS ANGELES COUNTY)",3160,0,3160,2300,137.4,3300
9483,2018,12,KVSP (KERN VALLEY SP),3729,0,3729,2448,152.3,3522
9484,2018,12,ISP (IRONWOOD SP),2838,0,2838,2200,129.0,3200
9485,2018,12,HDSP (HIGH DESERT SP),3328,0,3328,2324,143.2,3361
9486,2018,12,FOL (FOLSOM SP) (MALE),2886,0,2886,2066,139.7,2895
9487,2018,12,DVI (DEUEL VOCATIONAL INSTITUTION),2333,0,2333,1681,138.8,2353
9488,2018,12,CVSP (CHUCKAWALLA VALLEY SP),2708,0,2708,1738,155.8,2478
9489,2018,12,CTF (CORRECTIONAL TRAINING FAC),5155,0,5155,3312,155.6,4887
9490,2018,12,"CRC (CAL REHAB CTR, MEN)",2420,0,2420,2491,97.1,3210
9491,2018,12,"COR (CA SP, CORCORAN)",3241,0,3241,3116,104.0,4270
9492,2018,12,CMF (CA MEDICAL FAC),2352,0,2352,2361,99.6,2847
9493,2018,12,CMC (CA MEN'S COLONY),3706,0,3706,3838,96.6,4398
9494,2018,12,CIM (CA INSTITUTION FOR MEN),3691,0,3691,2976,124.0,4186
9495,2018,12,CHCF (CA HEALTH CARE FAC - STOCKTON),2673,0,2673,2951,90.6,2951
9496,2018,12,CEN (CENTINELA SP),3374,0,3374,2308,146.2,3333
9497,2018,12,CCI (CA CORRECTIONAL INSTITUTION),4074,0,4074,2783,146.4,4120
9498,2018,12,CCC (CA CORRECTIONAL CENTER),4411,0,4411,3883,113.6,4762
9499,2018,12,CAL (CALIPATRIA SP),3472,0,3472,2308,150.4,3333
9500,2018,12,ASP (AVENAL SP),4192,0,4192,2920,143.6,4370
